BRANCH_COUNT,LOC_CODE_AND_COMMENT,LOC_COMMENTS,CYCLOMATIC_COMPLEXITY,DESIGN_COMPLEXITY,ESSENTIAL_COMPLEXITY,LOC_EXECUTABLE,HALSTEAD_CONTENT,HALSTEAD_DIFFICULTY,HALSTEAD_EFFORT,HALSTEAD_ERROR_EST,HALSTEAD_LENGTH,HALSTEAD_LEVEL,HALSTEAD_PROG_TIME,NUM_OPERANDS,NUM_OPERATORS,NUM_UNIQUE_OPERANDS,NUM_UNIQUE_OPERATORS,LOC_TOTAL,Bugs
11,3,0,6,3,1,23,41.87,14.17,8403.03,0.2,110,0.07,466.83,51,59,27,15,26,0
3,1,3,2,2,1,3,12.18,3,109.62,0.01,11,0.33,6.09,4,7,4,6,4,0
19,5,12,11,9,3,34,37.31,23.86,21248.49,0.3,152,0.04,1180.47,63,89,33,25,39,0
17,3,12,10,3,3,36,31.44,19.3,11716.29,0.2,107,0.05,650.91,47,60,28,23,39,0
3,1,0,2,2,1,10,31.9,6.9,1518.54,0.07,48,0.14,84.36,23,25,15,9,11,1
7,4,7,4,4,1,16,46.83,14.48,9823.41,0.23,125,0.07,545.75,60,65,29,14,20,0
5,2,4,3,3,1,8,17.81,11.08,2188.05,0.07,42,0.09,121.56,19,23,12,14,10,0
5,1,0,3,2,1,10,32.98,6.18,1260.48,0.07,48,0.16,70.03,17,31,11,8,11,0
11,7,6,6,1,4,23,36.79,15.58,8933.27,0.19,107,0.06,496.29,44,63,24,17,30,0
11,8,15,6,3,1,40,56.47,17.4,17102.11,0.33,180,0.06,950.12,83,97,31,13,48,0
5,0,0,3,3,1,13,23.44,7.33,1260.57,0.06,38,0.14,70.03,16,22,12,11,13,0
8,0,1,6,6,1,39,55.83,18.8,19738.62,0.35,186,0.05,1096.59,73,113,33,17,39,0
7,1,3,4,4,4,28,45.13,11.11,5572.06,0.17,93,0.09,309.56,40,53,27,15,29,0
3,4,9,2,1,1,41,135.48,9.97,13474.88,0.45,249,0.1,748.6,123,126,37,6,45,0
3,0,0,2,2,1,8,18.53,9,1501.17,0.06,40,0.11,83.4,18,22,9,9,8,0
3,0,5,2,2,1,16,57.32,10.19,5954.36,0.19,113,0.1,330.8,53,60,26,10,16,0
3,0,0,2,2,1,8,18.53,9,1501.17,0.06,40,0.11,83.4,18,22,9,9,8,0
3,0,0,2,2,1,8,18.53,9,1501.17,0.06,40,0.11,83.4,18,22,9,9,8,0
3,0,0,2,2,1,8,18.53,9,1501.17,0.06,40,0.11,83.4,18,22,9,9,8,0
5,1,1,3,2,1,12,25.16,11.2,3155.74,0.09,58,0.09,175.32,24,34,15,14,13,0
25,4,16,13,10,5,71,70.93,18.61,24562.78,0.44,210,0.05,1364.6,89,121,55,23,75,1
5,1,9,3,2,1,13,30.78,10.5,3393.02,0.11,63,0.1,188.5,28,35,20,15,14,0
7,0,2,4,1,1,397,1535.48,11.07,188118.17,5.67,1916,0.09,10451.01,1129,787,459,9,397,0
55,0,51,28,27,27,817,1349.98,39.94,2153049.88,17.97,5580,0.03,119613.86,2733,2847,787,23,817,0
5,0,0,3,3,1,8,9.42,17,2723.1,0.05,41,0.06,151.28,17,24,5,10,8,0
3,0,0,2,2,1,5,13.67,5.71,446.5,0.03,20,0.18,24.81,10,10,7,8,5,0
5,1,13,3,2,1,20,50.44,8.5,3644.57,0.14,85,0.12,202.48,34,51,22,11,21,1
5,1,10,3,3,1,16,54.41,6.07,2001.52,0.11,66,0.16,111.2,31,35,23,9,17,1
17,17,0,9,1,1,2,76.91,15.85,19327.77,0.41,222,0.06,1073.76,98,124,34,11,19,1
5,10,0,3,1,1,2,59.38,12.02,8577.83,0.24,136,0.08,476.55,59,77,27,11,12,0
17,14,0,9,1,1,2,85.3,11,10321.01,0.31,168,0.09,573.39,74,94,37,11,16,1
9,5,0,5,1,1,2,39.02,5.33,1109.78,0.07,46,0.19,61.65,20,26,15,8,7,0
65,0,1,33,4,1,56,212.2,33.39,236652.5,2.36,1045,0.03,13147.36,423,622,95,15,56,1
27,2,1,14,3,1,22,99.64,24.6,60297.15,0.82,407,0.04,3349.84,164,243,50,15,24,1
89,6,1,45,3,1,68,318.29,36.8,430930.48,3.9,1588,0.03,23940.58,645,943,149,17,74,1
35,0,0,18,1,1,39,162.87,24.2,95404.28,1.31,600,0.04,5300.24,239,361,79,16,39,1
51,6,1,26,3,1,42,189.65,36.5,252667.13,2.31,1031,0.03,14037.06,438,593,90,15,48,1
27,1,4,14,1,9,21,15.66,31.95,15993.34,0.17,102,0.03,888.52,37,65,11,19,22,0
9,2,24,5,5,1,49,72.48,20.68,31004.8,0.5,257,0.05,1722.49,106,151,41,16,51,1
3,0,0,2,1,1,9,17.71,14,3472,0.08,62,0.07,192.89,28,34,8,8,9,0
7,1,2,4,2,1,27,49.99,17.26,14890.23,0.29,160,0.06,827.24,77,83,29,13,28,0
13,4,1,7,4,5,20,24.63,17.41,7465.7,0.14,85,0.06,414.76,37,48,17,16,24,0
7,2,8,4,2,1,14,31.34,10.33,3346.5,0.11,66,0.1,185.92,31,35,18,12,16,0
5,7,2,3,1,1,17,20.45,15.17,4705.14,0.1,66,0.07,261.39,26,40,12,14,24,0
3,0,0,2,1,1,5,9.87,5.63,312.22,0.02,15,0.18,17.35,5,10,4,9,5,0
3,2,5,2,2,1,21,55.64,8.27,3804.87,0.15,89,0.12,211.38,43,46,26,10,23,0
7,1,3,4,1,1,16,34.78,14.04,6856.63,0.16,90,0.07,380.92,39,51,25,18,17,0
33,3,16,17,4,8,57,81.83,29.21,69838.03,0.8,375,0.03,3879.89,162,213,61,22,60,0
17,4,8,9,4,7,29,58.4,14.93,13015,0.29,147,0.07,723.06,66,81,42,19,33,0
5,4,4,3,3,1,18,23.37,9.15,1958.65,0.07,45,0.11,108.81,17,28,13,14,22,0
29,5,14,15,6,10,59,46.09,53.79,133379.57,0.83,390,0.02,7409.98,177,213,51,31,64,1
7,1,4,4,3,1,33,85.6,21.6,39935.53,0.62,307,0.05,2218.64,144,163,50,15,34,1
3,1,3,2,1,1,13,34.95,18.36,11781.35,0.21,119,0.05,654.52,54,65,25,17,14,0
37,0,0,19,6,11,36,33.88,39.58,53092.15,0.45,232,0.03,2949.56,95,137,30,25,36,0
13,0,0,7,6,6,17,44.6,12.75,7250.82,0.19,110,0.08,402.82,51,59,24,12,17,0
21,0,1,11,3,5,29,26.43,34.72,31867.04,0.31,161,0.03,1770.39,75,86,27,25,29,0
17,0,0,9,1,9,19,19.04,26.67,13541.31,0.17,99,0.04,752.29,40,59,15,20,19,0
15,1,1,8,2,4,20,15.74,26.13,10742.56,0.14,83,0.04,596.81,33,50,12,19,21,0
15,1,1,8,2,4,20,15.74,26.13,10742.56,0.14,83,0.04,596.81,33,50,12,19,21,0
7,3,13,4,1,1,39,98.24,22.84,51227.3,0.75,350,0.04,2845.96,170,180,67,18,42,1
29,6,10,15,4,1,29,63.05,32.2,65351.13,0.68,348,0.03,3630.62,165,183,41,16,35,0
11,4,7,6,3,6,18,36.66,13.45,6637.2,0.16,94,0.07,368.73,37,57,22,16,22,1
13,4,7,7,4,1,27,55.22,19.68,21394.68,0.36,188,0.05,1188.59,88,100,38,17,31,1
3,0,3,2,2,1,20,52.01,14.66,11171.75,0.25,138,0.07,620.65,67,71,32,14,20,1
11,3,7,6,3,1,15,37.77,12.29,5701.61,0.15,92,0.08,316.76,43,49,21,12,18,0
15,6,14,8,6,1,24,55.87,16.21,14703.33,0.3,159,0.06,816.85,73,86,36,16,30,0
13,4,11,7,4,4,21,47.71,15.97,12167.64,0.25,135,0.06,675.98,62,73,33,17,25,1
7,0,9,4,1,1,13,24,22.5,12150,0.18,108,0.04,675,51,57,17,15,13,0
3,0,0,2,1,1,4,11.42,6.67,507.65,0.03,20,0.15,28.2,10,10,6,8,4,0
5,0,0,3,1,1,7,7.53,10,752.84,0.03,21,0.1,41.82,10,11,4,8,7,0
13,4,11,7,4,4,20,47.71,15.97,12167.64,0.25,135,0.06,675.98,62,73,33,17,24,1
11,4,19,6,3,1,20,32.36,31.53,32175.94,0.34,179,0.03,1787.55,86,93,30,22,24,0
13,4,11,7,2,4,14,33.36,14.26,6783.7,0.16,90,0.07,376.87,41,49,23,16,18,1
23,4,19,12,6,4,23,50.37,18.03,16367.05,0.3,155,0.06,909.28,74,81,39,19,27,1
3,1,14,2,2,1,9,33.92,9.38,2981.4,0.11,62,0.11,165.63,25,37,20,15,10,0
3,0,8,2,2,1,5,28.99,5.54,889.14,0.05,36,0.18,49.4,16,20,13,9,5,0
11,4,17,6,5,1,15,55.47,8.07,3611.37,0.15,83,0.12,200.63,36,47,29,13,19,1
5,2,8,3,2,1,10,18.53,11.67,2522.57,0.07,46,0.09,140.14,20,26,12,14,12,0
3,0,0,2,2,1,6,23.63,6,850.66,0.05,34,0.17,47.26,15,19,10,8,6,0
7,0,0,4,1,1,10,8.55,23.4,4683.66,0.07,48,0.04,260.2,18,30,5,13,10,0
3,0,0,2,2,1,15,25.27,11.39,3280.22,0.1,62,0.09,182.23,29,33,14,11,15,0
3,1,0,2,1,1,11,19.12,6,688.28,0.04,31,0.17,38.24,14,17,7,6,12,0
3,0,0,2,2,1,11,22.15,6.4,907.38,0.05,34,0.16,50.41,16,18,10,8,11,0
3,0,0,2,2,1,10,38.09,6.5,1609.32,0.08,54,0.15,89.41,26,28,16,8,10,0
13,0,0,7,3,6,21,20,16.25,5282.39,0.11,70,0.06,293.47,30,40,12,13,21,0
5,3,0,3,1,1,17,27.46,13.36,4903.83,0.12,88,0.07,272.44,42,46,11,7,20,0
3,0,0,2,1,1,7,8.22,9,666.08,0.02,20,0.11,37,8,12,4,9,7,0
3,0,0,2,2,1,8,11.6,10,1160,0.04,29,0.1,64.44,12,17,6,10,8,0
3,0,0,2,1,1,13,26.51,7.13,1345.7,0.06,43,0.14,74.76,19,24,12,9,13,0
3,0,0,2,1,1,6,14.8,8.56,1083.64,0.04,28,0.12,60.2,11,17,9,14,6,0
9,0,0,5,4,3,28,21.3,21.76,10091.02,0.15,89,0.05,560.61,37,52,17,20,28,0
5,0,0,3,1,1,7,11.62,9.75,1104.67,0.04,29,0.1,61.37,13,16,6,9,7,0
8,4,32,6,6,1,38,44.55,25.33,28593.41,0.38,198,0.04,1588.52,88,110,33,19,42,1
33,5,23,17,11,17,49,56.67,17.49,17327.12,0.33,173,0.06,962.62,68,105,35,18,54,0
9,5,23,5,5,1,32,99.95,11.96,14297.65,0.4,200,0.08,794.31,92,108,50,13,37,1
3,3,24,2,2,1,16,24.8,12.19,3683.14,0.1,61,0.08,204.62,26,35,16,15,19,1
15,4,13,9,6,5,35,39.96,20.3,16466.48,0.27,143,0.05,914.8,58,85,30,21,39,0
3,2,13,2,1,1,19,54.15,14.62,11582.56,0.26,157,0.07,643.48,78,79,24,9,21,1
5,3,21,3,2,1,15,38.86,14.28,7924.93,0.18,105,0.07,440.27,51,54,25,14,18,0
7,4,27,4,2,3,19,42.56,14.44,8879.35,0.2,114,0.07,493.3,52,62,27,15,23,0
9,8,18,5,5,1,28,36.37,18.27,12140.16,0.22,121,0.05,674.45,50,71,26,19,36,0
9,5,37,5,4,4,19,33.28,15.94,8459.67,0.18,95,0.06,469.98,41,54,27,21,24,1
5,4,19,3,2,3,13,34.91,12.87,5781.77,0.15,85,0.08,321.21,37,48,23,16,17,1
3,8,34,2,2,1,23,74.64,13.81,14241.04,0.34,180,0.07,791.17,85,95,40,13,31,1
16,12,23,10,8,5,33,48.11,16.19,12617.28,0.26,133,0.06,700.96,53,80,36,22,45,0
21,7,27,11,5,7,46,58.55,21.92,28134.83,0.43,222,0.05,1563.05,98,124,38,17,53,1
7,4,3,4,3,1,21,38.31,13.54,7020.93,0.17,95,0.07,390.05,43,52,27,17,25,1
7,1,13,4,4,1,14,29.18,7.86,1801.24,0.08,50,0.13,100.07,22,28,14,10,15,1
23,1,20,12,3,11,64,80.39,13.95,15650.31,0.37,183,0.07,869.46,87,96,53,17,65,1
45,8,46,23,7,19,55,65.12,36.85,88450.77,0.8,389,0.03,4913.93,179,210,51,21,63,1
5,6,42,3,2,1,7,23.64,9.31,2048.42,0.07,48,0.11,113.8,22,26,13,11,13,1
5,0,0,3,2,3,12,27.43,7.86,1693.16,0.07,47,0.13,94.06,22,25,14,10,12,0
3,0,0,2,1,1,6,13.83,11.25,1750.38,0.05,36,0.09,97.24,15,21,8,12,6,0
5,2,0,3,2,3,16,26.3,10.45,2872.09,0.09,52,0.1,159.56,22,30,20,19,18,0
31,7,12,16,6,11,28,33.74,35.21,41834.57,0.4,198,0.03,2324.14,85,113,35,29,35,0
5,0,0,3,2,1,8,12.1,13.93,2347.73,0.06,39,0.07,130.43,15,24,7,13,8,0
15,0,50,8,1,1,190,175.59,53.22,497406.05,3.12,1309,0.02,27633.67,644,665,121,20,190,0
9,3,10,5,2,3,12,22.72,18.75,7988.64,0.14,86,0.05,443.81,40,46,16,15,15,0
3,2,0,2,2,1,6,22.46,9,1819.07,0.07,43,0.11,101.06,18,25,13,13,8,0
3,2,0,2,2,1,6,22.46,9,1819.07,0.07,43,0.11,101.06,18,25,13,13,8,0
3,1,6,2,2,1,5,20.84,3.94,323.05,0.03,21,0.25,17.95,9,12,8,7,6,0
25,12,24,13,8,6,44,75.71,19.73,29480.66,0.5,237,0.05,1637.81,109,128,58,21,56,1
9,5,10,5,4,1,18,37.97,14.77,8282.6,0.19,104,0.07,460.14,48,56,26,16,23,0
19,17,0,10,1,8,31,31.42,46.06,66661.35,0.48,246,0.02,3703.41,102,144,31,28,48,0
5,1,0,3,1,1,10,13.96,11.67,1899.9,0.05,36,0.09,105.55,15,21,9,14,11,0
15,0,0,8,6,6,29,25.81,30.07,23331.58,0.26,143,0.03,1296.2,63,80,22,21,29,0
13,0,0,7,7,4,13,14.04,29.36,12103.07,0.14,84,0.03,672.39,34,50,11,19,13,0
3,0,0,2,2,1,24,30.78,18,9971.33,0.18,108,0.06,553.96,48,60,20,15,24,0
17,0,0,10,10,1,43,38.43,28.04,30219.56,0.36,181,0.04,1678.86,83,98,37,25,43,0
9,0,0,5,5,4,20,23.94,16.5,6517.5,0.13,79,0.06,362.08,33,46,16,16,20,0
5,0,0,3,3,1,10,14.62,9.17,1228.15,0.04,31,0.11,68.23,15,16,9,11,10,0
33,0,0,17,10,10,33,90.42,13,15281.13,0.39,199,0.08,848.95,94,105,47,13,33,0
5,0,0,3,3,1,9,24,4.67,522.66,0.04,28,0.21,29.04,12,16,9,7,9,0
53,0,0,27,23,19,62,88.96,33,96874.9,0.98,450,0.03,5381.94,210,240,70,22,62,0
41,0,0,21,20,1,55,95.28,25.67,62771.57,0.82,374,0.04,3487.31,176,198,72,21,55,0
19,0,0,10,10,5,30,43.84,22.75,22691.4,0.33,171,0.04,1260.63,78,93,36,21,30,0
55,2,0,34,15,17,87,69.02,44.68,137758.8,1.03,448,0.02,7653.27,181,267,79,39,89,0
37,0,2,20,7,12,49,25.89,66.86,115710.92,0.58,293,0.01,6428.38,117,176,28,32,49,0
21,0,0,11,6,1,21,24.3,27,17711.76,0.22,125,0.04,983.99,60,65,20,18,21,0
67,1,1,34,30,17,90,179.17,21.38,81861.96,1.28,548,0.05,4547.89,243,305,108,19,91,0
25,0,0,14,8,6,45,57.83,26.49,40578.75,0.51,243,0.04,2254.37,108,135,53,26,45,0
59,0,1,34,22,15,88,71.79,42,126638.31,1.01,450,0.02,7035.46,189,261,72,32,88,0
19,0,0,10,8,3,45,48.13,38.75,72273.89,0.62,291,0.03,4015.22,135,156,54,31,45,0
45,2,0,23,19,19,69,63.43,34.98,77622.82,0.74,350,0.03,4312.38,148,202,55,26,71,0
11,0,0,7,4,4,23,29.43,18.57,10146.96,0.18,102,0.05,563.72,43,59,22,19,23,0
49,2,1,25,22,19,142,135.53,37.53,190890.99,1.7,729,0.03,10605.06,319,410,102,24,144,0
7,1,3,4,1,1,14,28.72,9.38,2523.86,0.09,56,0.11,140.21,25,31,16,12,15,0
5,4,6,3,2,1,19,48.79,19.21,18005.58,0.31,160,0.05,1000.31,73,87,38,20,23,0
33,6,6,17,7,9,57,95.6,21.1,42542.23,0.67,313,0.05,2363.46,151,162,68,19,63,1
5,0,0,3,1,1,10,9.15,16.25,2416.01,0.05,35,0.06,134.22,15,20,6,13,10,0
11,2,16,6,3,1,40,41.91,27.61,31948.87,0.39,204,0.04,1774.94,93,111,32,19,42,0
21,12,22,11,8,4,73,132.29,22.53,67179.31,0.99,444,0.04,3732.18,204,240,86,19,85,1
11,3,19,6,4,5,28,25.75,23.98,14801.55,0.21,116,0.04,822.31,53,63,21,19,31,0
11,4,21,6,4,5,27,25.75,23.98,14801.55,0.21,116,0.04,822.31,53,63,21,19,31,0
37,18,38,19,10,9,103,182.27,15.56,44121.9,0.95,419,0.06,2451.22,195,224,94,15,121,0
11,5,19,6,4,5,26,27.15,22.89,14223.33,0.21,116,0.04,790.18,53,63,22,19,31,0
7,0,0,4,1,1,10,6.98,22.1,3409.75,0.05,37,0.05,189.43,17,20,5,13,10,0
11,1,7,8,5,1,45,42.42,24.2,24843.45,0.34,176,0.04,1380.19,77,99,35,22,46,1
37,5,4,19,2,18,77,60.94,26.48,42724.78,0.54,266,0.04,2373.6,116,150,46,21,82,0
39,3,26,20,4,13,60,69.45,23.14,37185.01,0.54,258,0.04,2065.83,119,139,54,21,63,0
31,3,22,16,6,3,73,90.21,25.16,57086.39,0.76,355,0.04,3171.47,161,194,64,20,76,0
69,4,38,35,4,3,117,126.88,26.71,90551.52,1.13,497,0.04,5030.64,221,276,91,22,121,1
7,3,5,4,4,1,5,23.69,4.5,479.73,0.04,28,0.22,26.65,12,16,8,6,8,0
64,15,13,35,17,22,166,144.78,33.72,164651.23,1.63,666,0.03,9147.29,307,359,132,29,181,0
5,2,26,3,2,3,51,173.7,9.4,15334.09,0.54,256,0.11,851.89,123,133,72,11,53,1
18,6,11,10,7,7,40,49.69,15.32,11670.05,0.25,130,0.07,648.34,54,76,37,21,46,0
5,1,8,3,1,1,6,17.75,9.9,1739.36,0.06,40,0.1,96.63,18,22,10,11,7,0
3,1,7,2,1,1,5,16.12,7.5,906.96,0.04,29,0.13,50.39,12,17,8,10,6,0
27,4,7,14,1,14,25,46.65,17.11,13659.38,0.27,149,0.06,758.85,66,83,27,14,29,0
59,0,31,30,3,1,206,239.03,36.2,313287.38,2.88,1172,0.03,17404.85,564,608,148,19,206,0
59,0,29,30,3,1,208,242.69,36.29,319607.72,2.94,1190,0.03,17755.98,573,617,150,19,208,0
87,0,35,44,14,13,255,249.73,43.13,464447.49,3.59,1405,0.02,25802.64,675,730,180,23,255,0
57,0,35,29,2,1,209,233.67,37.57,329746.68,2.93,1182,0.03,18319.26,571,611,152,20,209,0
17,0,28,9,2,1,137,154.38,37.66,218997.95,1.94,832,0.03,12166.55,403,429,107,20,137,0
9,0,0,5,3,5,21,24.76,24.5,14864.15,0.2,114,0.04,825.79,49,65,20,20,21,0
5,0,0,3,3,1,12,18.39,19.2,6779.67,0.12,70,0.05,376.65,32,38,15,18,12,0
3,0,0,2,2,1,8,14.6,11.59,1961.37,0.06,36,0.09,108.96,17,19,11,15,8,0
13,2,0,8,8,5,37,38,20.84,16509.21,0.26,137,0.05,917.18,58,79,32,23,39,0
15,0,3,8,8,1,39,39.25,24.9,24336.47,0.33,175,0.04,1352.03,83,92,30,18,39,0
19,0,0,10,6,1,36,54.39,16.69,15143.75,0.3,160,0.06,841.32,73,87,35,16,36,0
19,0,0,13,9,3,43,47.44,23.4,25974,0.37,185,0.04,1443,78,107,40,24,43,0
5,3,10,3,2,1,17,37.06,22.6,18935.91,0.28,150,0.04,1052,69,81,29,19,20,0
5,1,0,3,1,1,11,17.39,26.25,11982.32,0.15,96,0.04,665.68,42,54,12,15,12,1
9,3,0,5,4,3,21,56.3,11,6811.81,0.21,118,0.09,378.43,54,64,27,11,24,0
21,10,11,11,3,1,31,51.67,21.46,23803.95,0.37,187,0.05,1322.44,88,99,41,20,41,0
11,2,6,6,2,5,18,25.18,18,8158,0.15,87,0.06,453.22,38,49,19,18,20,0
3,1,0,2,2,1,10,26.99,6.97,1309.86,0.06,40,0.14,72.77,19,21,15,11,11,0
15,5,29,8,7,1,35,61.99,27.4,46526.99,0.57,271,0.04,2584.83,121,150,53,24,40,1
7,1,3,4,3,1,11,23.9,19.68,9260.7,0.16,91,0.05,514.48,44,47,19,17,12,1
13,5,26,7,7,1,33,60.18,27.5,45509.93,0.55,270,0.04,2528.33,120,150,48,22,38,1
17,5,12,9,2,1,20,32.02,26.93,23220.17,0.29,152,0.04,1290.01,71,81,29,22,25,0
5,2,7,3,2,3,11,22.96,13.5,4185,0.1,62,0.07,232.5,27,35,16,16,13,0
5,2,7,3,2,3,12,23.74,10.21,2476.96,0.08,51,0.1,137.61,22,29,14,13,14,0
17,5,12,9,2,1,21,33.47,24.62,20287.52,0.27,146,0.04,1127.08,68,78,29,21,26,1
7,4,57,4,2,1,42,77.69,36.83,105400.45,0.95,458,0.03,5855.58,221,237,57,19,46,1
3,0,0,2,1,1,14,41.25,14.67,8873.33,0.2,121,0.07,492.96,56,65,21,11,14,1
3,0,0,2,2,1,7,10.34,8.1,678.47,0.03,22,0.12,37.69,9,13,5,9,7,0
5,1,0,3,1,1,13,18.91,10.45,2065.48,0.07,45,0.1,114.75,19,26,10,11,14,0
3,0,0,2,1,1,5,6.5,6,234,0.01,13,0.17,13,4,9,2,6,5,0
29,4,2,15,2,8,48,16.05,54,46843.61,0.29,163,0.02,2602.42,72,91,16,24,52,0
25,0,1,13,9,8,47,57.88,31.53,57542.56,0.61,293,0.03,3196.81,134,159,51,24,47,0
52,20,2,37,17,1,100,62.85,77.19,374495.12,1.62,700,0.01,20805.28,305,395,81,41,120,0
9,0,0,5,3,3,11,25.83,12,3720,0.1,62,0.08,206.67,24,38,16,16,11,0
15,3,0,8,4,1,34,23.86,46,50477.9,0.37,201,0.02,2804.33,92,109,22,22,37,0
15,0,0,8,5,3,16,29,17.43,8805.15,0.17,97,0.06,489.17,41,56,20,17,16,0
13,3,0,7,4,1,30,34.65,30.14,31475.69,0.35,187,0.03,1748.65,92,95,29,19,33,0
11,1,0,6,5,3,17,36.89,9.89,3605.18,0.12,70,0.1,200.29,29,41,22,15,18,0
3,0,0,2,1,1,12,16.65,4.67,362.64,0.03,21,0.21,20.15,8,13,6,7,12,0
13,0,0,7,3,1,27,18.92,19.63,7291.52,0.12,73,0.05,405.08,31,42,15,19,27,0
3,0,0,2,1,1,7,14.51,4.2,255.97,0.02,17,0.24,14.22,6,11,5,7,7,0
9,0,4,5,5,1,48,59.96,20.2,24477.25,0.4,197,0.05,1359.85,90,107,49,22,48,0
3,0,0,2,2,1,17,27.97,23.08,14896.06,0.22,139,0.04,827.56,50,89,13,12,17,0
5,0,0,3,1,1,17,21.5,7.15,1099.18,0.05,35,0.14,61.07,13,22,10,11,17,0
3,0,0,2,1,1,8,17.2,6.67,764.63,0.04,27,0.15,42.48,12,15,9,10,8,0
11,0,0,8,1,1,17,16.16,19.2,5956.4,0.1,66,0.05,330.91,24,42,10,16,17,0
3,0,0,2,1,1,17,19.85,16.82,5614.18,0.11,76,0.06,311.9,37,39,11,10,17,0
52,0,7,28,17,22,66,50.5,42.41,90808.6,0.71,335,0.02,5044.92,145,190,53,31,66,0
7,0,0,4,3,3,12,18.68,12.83,3076.44,0.08,51,0.08,170.91,22,29,12,14,12,0
11,3,6,6,5,1,59,66.95,25.45,43359.38,0.57,268,0.04,2408.85,123,145,58,24,62,0
3,0,0,2,1,1,8,17.2,6.67,764.63,0.04,27,0.15,42.48,12,15,9,10,8,0
9,2,5,5,5,1,45,71.31,24.66,43378.78,0.59,286,0.04,2409.93,135,151,52,19,47,0
15,8,11,8,3,1,37,56.27,20,22506.86,0.38,189,0.05,1250.38,84,105,42,20,45,0
5,0,12,3,1,1,36,49.13,19.76,19184.32,0.32,185,0.05,1065.8,76,109,25,13,36,0
3,0,0,2,1,1,7,8.4,7,411.67,0.02,17,0.14,22.87,8,9,4,7,7,0
5,1,4,3,2,1,14,27.81,13.36,4964.52,0.12,75,0.07,275.81,37,38,18,13,15,0
3,0,2,2,1,1,29,62.76,21.36,28626.92,0.45,240,0.05,1590.38,115,125,35,13,29,0
3,0,0,2,1,1,16,39.81,13.88,7671.65,0.18,119,0.07,426.2,59,60,17,8,16,0
3,0,0,2,1,1,12,26.25,13.67,4902.51,0.12,83,0.07,272.36,41,42,12,8,12,0
3,0,1,2,1,1,12,29.04,8.92,2312.39,0.09,59,0.11,128.47,29,30,13,8,12,0
5,1,2,3,1,1,20,51.47,13.89,9932.28,0.24,143,0.07,551.79,71,72,23,9,21,0
7,3,15,4,3,1,34,88.1,8.83,6873.97,0.26,134,0.11,381.89,53,81,42,14,37,0
29,2,11,15,3,8,64,95.22,32.39,99926.73,1.03,474,0.03,5551.48,230,244,71,20,66,0
19,6,10,10,5,3,45,59.99,23.54,33237.05,0.47,226,0.04,1846.5,102,124,52,24,51,0
37,6,21,19,10,13,85,103.85,30.93,99359.89,1.07,471,0.03,5519.99,207,264,87,26,91,0
3,1,2,2,2,1,9,21.15,4.5,428.33,0.03,25,0.22,23.8,9,16,7,7,10,0
3,0,11,2,1,1,33,56.88,16.48,15453.19,0.31,175,0.06,858.51,71,104,28,13,33,0
11,2,3,6,4,5,19,28.9,10.82,3385.09,0.1,62,0.09,188.06,23,39,17,16,21,0
11,4,8,6,2,1,26,56.04,22.34,27977.56,0.42,228,0.04,1554.31,110,118,32,13,30,0
13,6,11,7,3,6,23,36.88,23.03,19562.81,0.28,149,0.04,1086.82,68,81,31,21,29,0
13,0,10,7,4,1,41,59.59,22.8,30993.01,0.45,232,0.04,1721.83,110,122,41,17,41,0
33,6,23,17,9,5,65,93.54,34.45,111016.34,1.07,478,0.03,6167.57,226,252,82,25,71,1
29,9,20,15,8,3,52,80.65,25.1,50799.32,0.67,306,0.04,2822.18,139,167,72,26,61,0
19,2,20,10,5,6,60,86.23,31.88,87614.7,0.92,430,0.03,4867.48,204,226,64,20,62,1
13,4,8,7,3,1,28,34.49,37.44,48341.41,0.43,241,0.03,2685.63,117,124,25,16,32,0
19,3,9,10,5,7,29,53.13,18.65,18483.6,0.33,173,0.05,1026.86,79,94,36,17,32,0
9,1,4,5,4,3,21,45.13,14.93,10063.19,0.22,122,0.07,559.07,56,66,30,16,22,0
39,10,27,20,5,18,64,44.71,96.49,416248.39,1.44,719,0.01,23124.91,344,375,41,23,74,0
15,2,12,8,3,5,24,29.28,26.67,20818.63,0.26,143,0.04,1156.59,64,79,24,20,26,0
7,2,3,4,2,1,11,19.24,17.68,6011.75,0.11,70,0.06,333.99,33,37,14,15,13,0
5,2,2,3,2,1,10,17.16,15.82,4293.27,0.09,60,0.06,238.52,29,31,11,12,12,0
15,1,5,8,6,5,38,59.63,25.26,38050.55,0.5,252,0.04,2113.92,117,135,44,19,39,0
9,2,6,5,3,4,25,33.97,22.5,17197.21,0.25,140,0.04,955.4,65,75,26,18,27,0
3,1,1,2,1,1,6,14.14,5.25,389.71,0.02,19,0.19,21.65,7,12,6,9,7,0
13,5,8,7,3,6,26,43.02,27.35,32179.65,0.39,200,0.04,1787.76,92,108,37,22,31,0
9,1,6,5,3,5,18,36.97,15.36,8722.95,0.19,106,0.07,484.61,48,58,25,16,19,0
15,2,6,8,7,3,45,63.61,27.76,48997.85,0.59,289,0.04,2722.1,136,153,49,20,47,0
17,6,11,9,6,1,33,48.39,35.46,60838.51,0.57,301,0.03,3379.92,146,155,35,17,39,0
7,3,6,4,4,1,10,29.06,6.54,1242.24,0.06,42,0.15,69.01,17,25,13,10,13,0
3,1,1,2,2,1,14,23.73,21.92,11404.6,0.17,115,0.05,633.59,57,58,13,10,15,0
15,7,14,8,7,4,54,75.27,22.24,37216.01,0.56,274,0.04,2067.56,126,148,51,18,61,0
9,1,9,5,1,4,18,30.88,8.25,2102.02,0.08,53,0.12,116.78,22,31,16,12,19,0
9,5,12,5,2,5,12,24.99,11.61,3366.63,0.1,61,0.09,187.04,25,36,14,13,17,1
5,2,2,3,1,1,18,45.06,12.52,7065.03,0.19,110,0.08,392.5,48,62,23,12,20,1
13,1,4,7,2,6,29,62.47,19.9,24732.36,0.41,215,0.05,1374.02,97,118,39,16,30,1
3,1,3,2,1,1,7,9.86,6.67,438.19,0.02,19,0.15,24.34,5,14,3,8,8,0
11,6,12,6,6,1,19,58.69,11.32,7525.74,0.22,119,0.09,418.1,55,64,34,14,25,0
10,2,3,7,2,3,28,29.63,16.28,7847.47,0.16,90,0.06,435.97,31,59,20,21,30,0
9,2,11,5,2,1,24,36.88,24.87,22810.72,0.31,168,0.04,1267.26,79,89,27,17,26,0
5,0,1,3,2,3,12,20.31,10.77,2355.5,0.07,46,0.09,130.86,20,26,13,14,12,0
7,0,3,4,3,3,17,29.9,16.61,8254.12,0.17,94,0.06,458.56,43,51,22,17,17,0
15,3,9,8,4,1,23,40.2,22.79,20877.45,0.31,171,0.04,1159.86,79,92,26,15,26,0
9,3,4,5,4,1,24,24.93,20.24,10207.48,0.17,100,0.05,567.08,43,57,17,16,27,0
7,0,1,4,4,1,16,25.4,12.79,4158.09,0.11,65,0.08,231,29,36,17,15,16,0
27,3,17,14,5,6,30,39.94,25.45,25867.91,0.34,183,0.04,1437.11,82,101,29,18,33,0
5,2,6,3,2,3,13,27.86,14.03,5479.69,0.13,75,0.07,304.43,33,42,20,17,15,1
3,0,0,2,1,1,8,24.33,8.4,1716.73,0.07,50,0.12,95.37,24,26,10,7,8,0
3,0,2,2,1,1,12,26.46,9.23,2254.82,0.08,54,0.11,125.27,24,30,13,10,12,0
3,0,4,2,1,1,10,26.09,6.67,1159.45,0.06,39,0.15,64.41,16,23,12,10,10,0
3,0,3,2,1,1,10,20.54,7.7,1217.55,0.05,36,0.13,67.64,14,22,10,11,10,0
3,0,2,2,1,1,8,17.13,4.67,373.12,0.03,21,0.21,20.73,7,14,6,8,8,0
3,0,0,2,1,1,7,13.74,10.63,1550.69,0.05,35,0.09,86.15,17,18,8,10,7,0
5,2,1,3,1,3,7,14.31,8.57,1051.06,0.04,30,0.12,58.39,12,18,7,10,9,0
3,0,1,2,1,1,5,10.41,6.4,426.29,0.02,18,0.16,23.68,8,10,5,8,5,0
3,0,4,2,1,1,10,24.53,5.91,856.5,0.05,33,0.17,47.58,13,20,11,10,10,0
13,0,0,7,4,1,19,32.59,13.12,5614.09,0.14,91,0.08,311.89,42,49,16,10,19,0
3,1,6,2,1,1,13,22.92,11,2773.9,0.08,55,0.09,154.11,26,29,13,11,14,0
9,0,3,5,4,5,17,25.03,8.36,1748.44,0.07,44,0.12,97.14,18,26,14,13,17,0
9,1,19,5,4,1,19,20.51,12.8,3360.93,0.09,53,0.08,186.72,24,29,15,16,20,0
11,3,0,6,3,1,23,41.87,14.17,8403.03,0.2,110,0.07,466.83,51,59,27,15,26,0
3,1,3,2,2,1,3,12.18,3,109.62,0.01,11,0.33,6.09,4,7,4,6,4,0
19,5,12,11,9,3,34,38.45,22.91,20177.56,0.29,151,0.04,1120.98,63,88,33,24,39,0
17,3,12,10,3,3,36,31.44,19.3,11716.29,0.2,107,0.05,650.91,47,60,28,23,39,0
3,1,0,2,2,1,10,31.9,6.9,1518.54,0.07,48,0.14,84.36,23,25,15,9,11,1
3,1,1,2,2,1,9,24.89,7,1219.6,0.06,38,0.14,67.76,14,24,12,12,10,0
11,0,6,6,4,5,24,34.84,19.8,13657.11,0.23,121,0.05,758.73,54,67,30,22,24,0
5,2,13,3,2,1,27,33.66,44.54,66768.32,0.5,278,0.02,3709.35,131,147,25,17,29,1
11,0,4,6,6,5,19,28.88,30.38,26642.14,0.29,171,0.03,1480.12,81,90,20,15,19,1
5,2,0,3,3,1,9,44.41,4.71,983.4,0.07,45,0.21,54.63,20,25,17,8,11,0
5,1,25,3,3,1,14,49.71,9.92,4895.11,0.16,94,0.1,271.95,43,51,26,12,15,0
15,6,27,8,8,1,35,122.69,12.57,19373.39,0.51,256,0.08,1076.3,111,145,53,12,41,1
5,2,3,3,2,1,6,12.89,11,1559.55,0.05,34,0.09,86.64,14,20,7,11,8,0
3,2,0,2,2,1,10,21.48,7.79,1304.11,0.06,37,0.13,72.45,17,20,12,11,12,0
5,0,12,3,3,1,24,52.14,12.54,8193.61,0.22,122,0.08,455.2,54,68,28,13,24,0
1,0,9,1,1,1,19,69.53,16.72,19441.83,0.39,206,0.06,1080.1,86,120,36,14,19,0
3,1,9,2,2,1,6,15.02,5.71,490.5,0.03,21,0.18,27.25,8,13,7,10,7,0
3,2,8,2,2,1,12,40.92,6.47,1712.28,0.09,57,0.15,95.13,23,34,16,9,14,0
3,1,5,2,2,1,9,19.66,7.15,1004.96,0.05,32,0.14,55.83,13,19,10,11,10,0
3,1,6,2,2,1,8,19.72,4,315.48,0.03,22,0.25,17.53,8,14,6,6,9,0
3,2,9,2,2,1,10,40.52,5.75,1339.69,0.08,49,0.17,74.43,23,26,18,9,12,1
3,0,0,2,2,1,4,9.51,3,85.59,0.01,9,0.33,4.75,3,6,3,6,4,0
7,0,19,4,1,1,59,98.29,21.87,47030.93,0.72,357,0.05,2612.83,175,182,52,13,59,0
5,0,11,3,1,1,49,47.82,55,144649.1,0.88,457,0.02,8036.06,220,237,36,18,49,0
5,0,11,3,1,1,43,51.66,44.29,101338.65,0.76,394,0.02,5629.92,187,207,38,18,43,0
7,4,0,4,3,1,20,34.63,21.2,15568.03,0.24,127,0.05,864.89,59,68,32,23,24,0
15,5,0,8,3,3,25,31.29,24.39,18610.76,0.25,132,0.04,1033.93,63,69,31,24,30,0
5,2,8,3,2,1,11,31.59,11.45,4145.3,0.12,68,0.09,230.29,28,40,22,18,13,0
3,1,7,2,2,1,7,24.81,8.5,1792.72,0.07,46,0.12,99.6,17,29,12,12,8,0
7,3,0,4,1,1,10,22.96,13.59,4242.8,0.1,63,0.07,235.71,29,34,16,15,13,0
3,0,0,2,2,1,4,12.17,8.4,858.37,0.03,25,0.12,47.69,7,18,5,12,4,0
11,0,1,6,2,4,14,16.12,22.73,8332.05,0.12,74,0.04,462.89,25,49,11,20,14,0
3,0,0,2,2,1,7,8.41,10.13,861.74,0.03,23,0.1,47.87,9,14,4,9,7,0
3,0,2,2,2,1,7,15.23,5,380.74,0.03,20,0.2,21.15,10,10,7,7,7,0
9,0,0,5,4,1,17,24.55,23.68,13769.86,0.19,110,0.04,764.99,45,65,19,20,17,0
11,0,58,6,1,1,195,355.66,18.58,122751.71,2.2,919,0.05,6819.54,456,463,135,11,195,0
5,0,8,3,1,1,46,99.6,16.93,28538.58,0.56,276,0.06,1585.48,133,143,55,14,46,0
5,0,8,3,1,1,46,99.6,16.93,28538.58,0.56,276,0.06,1585.48,133,143,55,14,46,0
5,0,8,3,1,1,46,99.6,16.93,28538.58,0.56,276,0.06,1585.48,133,143,55,14,46,0
5,0,8,3,1,1,46,99.6,16.93,28538.58,0.56,276,0.06,1585.48,133,143,55,14,46,0
5,0,8,3,1,1,46,99.6,16.93,28538.58,0.56,276,0.06,1585.48,133,143,55,14,46,0
5,0,8,3,1,1,46,99.6,16.93,28538.58,0.56,276,0.06,1585.48,133,143,55,14,46,0
3,0,0,2,2,1,7,15.32,11,1854.11,0.06,39,0.09,103.01,18,21,9,11,7,0
3,1,0,2,2,1,9,16.01,13,2705.09,0.07,46,0.08,150.28,20,26,10,13,10,0
3,0,0,2,2,1,4,10.13,7.5,570,0.03,19,0.13,31.67,9,10,6,10,4,0
7,0,0,4,3,1,13,14.24,12.75,2314.39,0.06,42,0.08,128.58,17,25,8,12,13,0
3,0,0,2,1,1,6,15.9,6.43,656.91,0.03,25,0.16,36.5,9,16,7,10,6,0
7,0,0,4,2,3,13,15.39,20.17,6258.43,0.1,61,0.05,347.69,22,39,12,22,13,0
11,1,0,6,2,6,20,21.74,20.19,8859.53,0.15,87,0.05,492.2,38,49,16,17,21,0
9,1,0,5,3,1,8,19.89,13,3360.81,0.09,55,0.08,186.71,26,29,13,13,9,0
5,0,0,3,2,1,9,23.64,9.31,2048.42,0.07,48,0.11,113.8,22,26,13,11,9,0
5,1,3,3,2,1,5,12.29,11.25,1555.89,0.05,32,0.09,86.44,15,17,8,12,6,0
3,0,0,2,1,1,5,12.24,9.33,1066.06,0.04,30,0.11,59.23,14,16,6,8,5,0
15,0,1,8,8,8,19,23.36,18.35,7869.25,0.14,85,0.05,437.18,39,46,17,16,19,0
7,0,2,4,3,3,16,35.44,9.9,3476.92,0.12,69,0.1,193.16,32,37,21,13,16,0
5,0,1,3,3,3,7,19.38,5.06,496.63,0.03,24,0.2,27.59,9,15,8,9,7,0
5,0,1,3,2,1,9,10.79,14.57,2290.24,0.05,37,0.07,127.24,17,20,7,12,9,0
9,0,1,5,3,3,14,27.69,10.11,2831.11,0.09,56,0.1,157.28,26,30,18,14,14,0
9,0,2,5,5,5,10,14.4,16,3685.14,0.08,49,0.06,204.73,20,29,10,16,10,0
9,0,2,5,5,5,10,13.06,16,3343.58,0.07,45,0.06,185.75,18,27,9,16,10,0
5,0,1,3,2,1,10,12.54,12.75,2038.87,0.05,37,0.08,113.27,17,20,8,12,10,0
5,0,1,3,3,1,13,19.11,10.5,2107.08,0.07,45,0.1,117.06,21,24,11,11,13,0
3,0,0,2,2,1,3,11.23,14,2200.43,0.05,37,0.07,122.25,10,27,5,14,3,0
7,0,0,4,2,1,10,16.12,14.3,3299.03,0.08,51,0.07,183.28,22,29,10,13,10,0
13,0,0,7,5,6,13,7.8,43.5,14758.99,0.11,74,0.02,819.94,29,45,6,18,13,0
9,0,0,5,4,4,8,7.35,21.12,3281.21,0.05,38,0.05,182.29,13,25,4,13,8,0
3,0,0,2,2,1,6,11.86,8.67,890.92,0.03,27,0.12,49.5,13,14,6,8,6,0
11,0,0,6,2,6,18,22.75,20,9099.07,0.15,88,0.05,505.5,40,48,18,18,18,0
31,0,0,16,12,12,41,42.81,30.67,40261.54,0.44,218,0.03,2236.75,92,126,39,26,41,0
5,0,0,3,2,1,8,16.74,11.23,2110.54,0.06,41,0.09,117.25,19,22,11,13,8,0
5,0,0,3,3,3,13,18.24,12.73,2955.18,0.08,50,0.08,164.18,20,30,11,14,13,0
37,0,0,19,16,5,41,88.36,21.82,42062.82,0.64,300,0.05,2336.82,144,156,66,20,41,0
91,4,2,47,32,22,96,99.09,49.13,239175.87,1.62,679,0.02,13287.55,306,373,109,35,100,0
5,0,0,3,1,1,8,13.45,12.44,2082.85,0.06,37,0.08,115.71,16,21,9,14,8,0
23,1,1,12,9,10,50,53.31,30.13,48410.46,0.54,263,0.03,2689.47,113,150,45,24,51,0
5,0,0,3,3,3,13,29.8,5.77,991.7,0.06,38,0.17,55.09,15,23,13,10,13,0
7,0,0,4,1,3,7,13.83,11.25,1750.38,0.05,36,0.09,97.24,15,21,8,12,7,0
13,0,0,7,4,7,19,25.13,19,9073.67,0.16,91,0.05,504.09,38,53,19,19,19,0
61,0,1,31,15,25,95,104.29,36.9,142000.7,1.28,548,0.03,7888.93,246,302,100,30,95,0
19,1,0,10,5,7,20,31.94,20.33,13197.22,0.22,122,0.05,733.18,55,67,23,17,21,0
3,0,0,2,2,1,6,21.31,4.5,431.59,0.03,23,0.22,23.98,9,14,9,9,6,0
5,0,0,3,3,1,11,33.89,4.85,795.9,0.05,38,0.21,44.22,18,20,13,7,11,0
21,0,0,11,3,3,21,35.91,25.31,23011.32,0.3,172,0.04,1278.41,81,91,24,15,21,0
5,0,0,3,3,1,10,25.87,9,2095.13,0.08,53,0.11,116.4,24,29,12,9,10,0
51,0,0,26,16,22,82,80.57,35.41,101041.69,0.95,444,0.03,5613.43,194,250,63,23,82,0
7,0,0,4,1,1,14,21.83,21.53,10120.67,0.16,94,0.05,562.26,38,56,15,17,14,0
3,0,0,2,2,1,5,10.99,6.4,449.97,0.02,19,0.16,25,8,11,5,8,5,0
11,0,0,6,4,1,22,33.56,12.02,4852.71,0.13,80,0.08,269.59,37,43,20,13,22,0
3,0,0,2,1,1,11,16.61,3,149.49,0.02,15,0.33,8.3,4,11,4,6,11,0
7,0,0,4,1,3,14,15.86,13.3,2805.08,0.07,46,0.08,155.84,19,27,10,14,14,0
3,0,0,2,2,1,11,15.77,6.87,745.37,0.04,26,0.15,41.41,11,15,8,10,11,0
9,0,5,5,4,3,21,16.41,15,3691.87,0.08,53,0.07,205.1,20,33,10,15,21,0
3,0,0,2,2,1,9,16.25,8.89,1283.82,0.05,34,0.11,71.32,16,18,9,10,9,0
5,0,0,3,1,1,10,13.14,8.17,876.39,0.04,29,0.12,48.69,14,15,6,7,10,0
7,0,0,4,2,1,21,34.66,14.24,7026.27,0.16,97,0.07,390.35,46,51,21,13,21,0
15,0,0,8,4,1,34,56.82,11.24,7181.41,0.21,115,0.09,398.97,53,62,33,14,34,0
7,0,0,4,2,1,21,53.82,9.17,4521.96,0.16,94,0.11,251.22,45,49,27,11,21,0
3,0,0,2,1,1,4,7.91,6.13,296.65,0.02,14,0.16,16.48,7,7,4,7,4,0
3,0,0,2,2,1,14,20.76,12.27,3126.53,0.08,58,0.08,173.7,27,31,11,10,14,0
7,0,0,4,3,1,17,25.96,11.15,3229.13,0.1,64,0.09,179.4,29,35,13,10,17,0
3,1,0,2,2,1,7,17.31,5.5,523.51,0.03,25,0.18,29.08,11,14,7,7,8,0
5,0,0,3,3,1,17,23.84,12.69,3840.79,0.1,66,0.08,213.38,30,36,13,11,17,0
5,1,0,3,2,1,19,32.45,13.89,6264.19,0.15,91,0.07,348.01,44,47,19,12,20,0
3,0,0,2,2,1,10,20.81,9,1685.67,0.06,42,0.11,93.65,18,24,11,11,10,0
13,0,2,7,7,4,22,34.83,15.79,8682.88,0.18,111,0.06,482.38,50,61,19,12,22,0
5,0,0,3,2,3,7,12.16,5.6,381.44,0.02,19,0.18,21.19,8,11,5,7,7,0
13,0,0,7,6,6,25,43.02,16.56,11801.69,0.24,125,0.06,655.65,53,72,32,20,25,0
13,0,0,7,1,7,13,10.33,21.25,4666.84,0.07,50,0.05,259.26,17,33,6,15,13,0
43,4,1,22,21,12,73,98.77,30.8,93697.55,1.01,442,0.03,5205.42,198,244,90,28,77,0
7,0,0,4,2,3,9,12.65,16.67,3515.14,0.07,46,0.06,195.29,20,26,9,15,9,0
7,0,0,4,3,4,11,16.45,14.3,3363.72,0.08,52,0.07,186.87,22,30,10,13,11,0
5,0,0,3,2,3,7,13.8,7.86,851.86,0.04,26,0.13,47.33,10,16,7,11,7,0
5,0,0,3,2,3,10,14.12,10.89,1674.72,0.05,34,0.09,93.04,14,20,9,14,10,0
20,1,0,18,2,1,149,90.99,45.11,185151.92,1.37,580,0.02,10286.22,268,312,101,34,150,0
7,2,0,4,2,1,14,20.83,12,2999.79,0.08,52,0.08,166.65,24,28,14,14,16,0
7,1,3,4,2,1,16,21.98,12.6,3489,0.09,57,0.08,193.83,27,30,15,14,17,0
9,1,8,5,3,1,57,130.74,11.41,17020.6,0.5,241,0.09,945.59,116,125,61,12,58,1
5,2,2,3,1,1,49,102.96,17.5,31530.62,0.6,285,0.06,1751.7,140,145,64,16,51,1
11,5,20,6,1,1,26,25.81,30.07,23331.58,0.26,143,0.03,1296.2,63,80,22,21,31,1
14,2,19,8,4,3,48,51.88,14.58,11021.37,0.25,127,0.07,612.3,53,74,40,22,50,0
9,4,16,5,2,3,21,29.73,12.89,4943.51,0.13,76,0.08,274.64,35,41,19,14,25,0
15,4,3,9,7,5,43,40.02,17.15,11771.13,0.23,121,0.06,653.95,49,72,30,21,47,0
3,1,0,2,1,1,6,12.06,6,434.04,0.02,19,0.17,24.11,9,10,6,8,7,0
7,0,0,4,1,4,9,7.44,13.5,1355.12,0.03,28,0.07,75.28,9,19,3,9,9,0
5,5,15,3,1,1,16,50.16,27.35,37530.39,0.46,247,0.04,2085.02,106,141,31,16,21,0
3,0,0,2,1,1,8,20.06,14.21,4049.15,0.09,63,0.07,224.95,31,32,12,11,8,0
3,0,0,2,2,1,5,17.11,5.14,452.57,0.03,22,0.19,25.14,8,14,7,9,5,0
3,0,0,2,2,1,9,16.96,6.75,772.53,0.04,28,0.15,42.92,12,16,8,9,9,0
3,0,0,2,2,1,9,15.57,7.5,875.68,0.04,28,0.13,48.65,12,16,8,10,9,0
5,1,7,3,2,1,17,42.71,14.57,9068.9,0.21,114,0.07,503.83,51,63,28,16,18,0
5,1,6,3,2,1,22,66.13,15.71,16316.58,0.35,185,0.06,906.48,87,98,36,13,23,0
19,3,11,10,4,1,32,35.14,41.18,59587.71,0.48,246,0.02,3310.43,112,134,34,25,35,0
9,3,7,5,4,1,27,44.17,22.38,22130.78,0.33,178,0.04,1229.49,79,99,30,17,30,1
9,4,4,5,4,1,18,18.68,25.88,12505.62,0.16,95,0.04,694.76,46,49,16,18,22,0
11,1,1,6,2,1,19,34.83,13,5886.19,0.15,89,0.08,327.01,42,47,21,13,20,0
3,1,8,2,2,1,11,41.64,7.11,2105.8,0.1,63,0.14,116.99,32,31,18,8,12,0
9,0,0,5,1,5,23,22.35,17,6460,0.13,76,0.06,358.89,30,46,15,17,23,0
3,2,0,2,1,1,30,86.17,6.67,3829.67,0.19,104,0.15,212.76,48,56,36,10,32,0
13,1,0,7,1,1,33,48.23,21,21270.06,0.34,176,0.05,1181.67,84,92,36,18,34,0
589,0,4,299,5,15,591,675.88,137.36,12751451.28,30.95,9605,0.01,708413.98,4015,5590,760,52,591,0
39,0,3,20,2,1,51,71.48,12.37,10946.28,0.29,153,0.08,608.13,66,87,40,15,51,0
39,0,3,20,2,1,54,70.18,13.46,12721.96,0.31,162,0.07,706.78,69,93,41,16,54,0
11,0,1,6,2,1,28,30.47,16.36,8158.14,0.17,95,0.06,453.23,45,50,22,16,28,0
5,0,0,3,1,1,10,20,6,720,0.04,30,0.17,40,12,18,8,8,10,0
13,0,2,7,3,3,27,22.13,13.39,3968.8,0.1,61,0.07,220.49,25,36,14,15,27,0
25,0,6,13,1,13,63,59.11,30.37,54510.88,0.6,290,0.03,3028.38,124,166,49,24,63,0
50,42,27,27,11,1,122,106.48,59.27,374043.26,2.1,863,0.02,20780.18,405,458,123,36,164,1
49,24,0,25,1,1,108,1295.68,12.3,195940.93,5.31,1879,0.08,10885.61,951,928,348,9,132,0
33,15,0,17,1,1,53,396.21,14.03,77960.6,1.85,783,0.07,4331.14,399,384,128,9,68,0
5,0,0,3,2,1,6,17.3,4.2,305.12,0.02,21,0.24,16.95,7,14,5,6,6,0
5,0,0,3,1,1,6,15.36,4.9,368.89,0.03,21,0.2,20.49,7,14,5,7,6,0
5,0,0,3,1,3,5,13.11,4.8,301.96,0.02,17,0.21,16.78,6,11,5,8,5,0
5,0,0,3,1,3,5,13.11,4.8,301.96,0.02,17,0.21,16.78,6,11,5,8,5,0
5,0,0,3,1,3,5,13.11,4.8,301.96,0.02,17,0.21,16.78,6,11,5,8,5,0
5,0,0,3,1,3,5,13.11,4.8,301.96,0.02,17,0.21,16.78,6,11,5,8,5,0
3,0,0,2,1,1,7,14.04,2,56.15,0.01,10,0.5,3.12,3,7,3,4,7,0
15,6,24,8,4,1,22,54.45,20,21781.35,0.36,195,0.05,1210.08,88,107,33,15,28,0
5,3,12,3,3,1,14,28.72,14.88,6354.23,0.14,82,0.07,353.01,35,47,20,17,17,0
15,5,13,8,3,1,18,24.73,28,19390.99,0.23,124,0.04,1077.28,56,68,24,24,23,0
5,1,0,3,2,1,6,18.95,7.5,1066,0.05,31,0.13,59.22,15,16,12,12,7,0
3,1,12,2,2,1,10,50.38,9.45,4498.98,0.16,98,0.11,249.94,42,56,20,9,11,0
5,1,8,3,1,1,9,33.57,11,4062.39,0.12,72,0.09,225.69,33,39,21,14,10,0
9,1,10,5,2,1,17,35.29,23.68,19791.23,0.28,156,0.04,1099.51,74,82,25,16,18,0
11,1,17,6,2,1,32,32.61,64.33,135012.09,0.7,363,0.02,7500.67,193,170,33,22,33,0
3,0,0,2,1,1,11,28.56,10.66,3242.83,0.1,64,0.09,180.16,31,33,16,11,11,0
5,2,0,3,1,1,16,21.78,37.5,30631.81,0.27,158,0.03,1701.77,75,83,18,18,18,1
11,4,24,6,6,1,27,67.71,14.27,13778.81,0.32,178,0.07,765.49,83,95,32,11,31,0
3,0,10,2,2,1,14,48.3,17.5,14790.85,0.28,149,0.06,821.71,70,79,34,17,14,1
11,1,7,6,1,1,17,23.33,29.45,20235.16,0.23,130,0.03,1124.18,62,68,20,19,18,0
17,0,0,9,4,6,19,26.33,31.74,26522.64,0.28,154,0.03,1473.48,73,81,23,20,19,0
3,0,1,2,1,1,6,5.18,15,1165.64,0.03,21,0.07,64.76,9,12,3,10,6,0
9,0,0,5,5,1,19,42.5,16.14,11090.08,0.23,129,0.06,616.12,60,69,26,14,19,0
143,3,0,73,60,15,139,123.47,68.57,580469.3,2.82,1130,0.01,32248.29,530,600,143,37,142,0
13,0,0,7,6,1,21,40.75,21.69,19168.66,0.29,160,0.05,1064.93,74,86,29,17,21,0
7,0,0,4,1,1,12,21.91,10.05,2210.79,0.07,48,0.1,122.82,17,31,11,13,12,0
31,0,0,17,12,15,55,29.26,76.36,170603.91,0.74,367,0.01,9478,144,223,33,35,55,0
13,3,5,7,6,6,21,29.99,22.05,14580.32,0.22,126,0.05,810.02,49,77,20,18,24,0
45,8,1,26,19,23,75,52.16,53.78,150849.96,0.93,425,0.02,8380.54,167,258,59,38,83,0
25,0,0,14,1,10,25,27.2,31.11,26315.66,0.28,147,0.03,1461.98,67,80,28,26,25,0
9,2,7,5,4,1,30,32.53,13.88,6262.85,0.15,88,0.07,347.94,37,51,20,15,32,0
5,0,0,3,1,1,7,14.73,8.94,1176.94,0.04,31,0.11,65.39,13,18,8,11,7,0
129,7,8,65,41,34,179,150.67,48.83,359267.3,2.45,981,0.02,19959.29,438,543,148,33,186,0
11,3,5,6,5,1,37,33.65,18.75,11829.4,0.21,117,0.05,657.19,50,67,24,18,40,0
8,0,4,6,2,1,24,19.95,12.41,3072.34,0.08,54,0.08,170.69,21,33,11,13,24,0
3,0,2,2,2,1,8,13.45,3.6,174.36,0.02,14,0.28,9.69,6,8,5,6,8,0
5,0,3,3,3,1,21,26.21,11.72,3599.53,0.1,62,0.09,199.97,25,37,16,15,21,0
3,0,0,2,2,1,12,26.06,4,416.99,0.03,25,0.25,23.17,10,15,10,8,12,0
3,0,0,2,1,1,8,23.66,7.92,1482.76,0.06,42,0.13,82.38,19,23,12,10,8,0
3,0,0,2,2,1,8,13.69,6.43,565.71,0.03,22,0.16,31.43,10,12,7,9,8,0
25,0,0,13,4,9,28,33.99,21.89,16290.19,0.25,138,0.05,905.01,53,85,23,19,28,0
9,0,1,6,1,1,22,27.21,20.39,11307.85,0.18,101,0.05,628.21,39,62,22,23,22,0
74,0,0,55,45,1,154,59.49,281.13,4701624.47,5.57,2242,0,261201.38,893,1349,108,68,154,0
3,0,0,2,1,1,6,10.58,7.2,548.26,0.03,20,0.14,30.46,8,12,5,9,6,0
5,0,0,3,2,3,10,22.75,11,2752.77,0.08,51,0.09,152.93,22,29,15,15,10,0
7,0,0,4,3,3,10,18.06,11.85,2534.72,0.07,45,0.08,140.82,22,23,13,14,10,0
7,0,0,4,2,3,11,24.61,12.71,3973.8,0.1,62,0.08,220.77,27,35,17,16,11,0
13,0,0,8,2,3,16,18.37,20.67,7844.38,0.13,74,0.05,435.8,31,43,15,20,16,0
15,0,8,8,3,5,42,60.44,19.68,23416.59,0.4,191,0.05,1300.92,89,102,52,23,42,0
33,2,0,17,7,14,34,30.56,37.08,42020.85,0.38,196,0.03,2334.49,89,107,30,25,36,0
37,4,0,19,12,11,46,48.52,36.22,63649.28,0.59,294,0.03,3536.07,135,159,41,22,50,0
25,5,10,13,13,11,43,93.54,12.79,15311.87,0.4,198,0.08,850.66,87,111,51,15,48,0
5,0,0,3,1,1,9,10.4,11,1258.94,0.04,28,0.09,69.94,12,16,6,11,9,0
13,0,0,7,4,7,19,36.63,17.5,11218.74,0.21,124,0.06,623.26,55,69,22,14,19,0
11,0,0,6,4,4,18,34.93,12.73,5658.72,0.15,86,0.08,314.37,40,46,22,14,18,0
13,1,3,9,4,3,29,30.24,13.18,5250.92,0.13,79,0.08,291.72,28,51,17,16,30,0
15,0,0,8,1,6,19,7.74,101.06,79044.51,0.26,161,0.01,4391.36,77,84,8,21,19,0
11,5,0,6,2,4,22,16.21,46.93,35696.56,0.25,146,0.02,1983.14,64,82,15,22,27,0
3,0,0,2,2,1,15,16.95,16.5,4614.93,0.09,57,0.06,256.39,22,35,12,18,15,0
13,9,9,7,4,1,22,49.25,15.23,11417.37,0.25,135,0.07,634.3,59,76,31,16,31,1
3,1,16,2,2,1,6,18.2,6.87,860.05,0.04,30,0.15,47.78,11,19,8,10,7,0
3,2,5,2,2,1,22,53.06,13.85,10172.91,0.24,140,0.07,565.16,60,80,26,12,24,0
7,5,5,4,4,1,24,50.97,10.6,5730.99,0.18,99,0.09,318.39,41,58,29,15,29,1
7,1,3,4,3,4,13,28.06,10.56,3130.06,0.1,61,0.09,173.89,26,35,16,13,14,0
7,2,3,4,3,1,18,25.26,12.89,4196.59,0.11,64,0.08,233.14,29,35,18,16,20,1
13,3,6,7,4,1,28,41.68,16.84,11818.06,0.23,125,0.06,656.56,58,67,31,18,31,1
5,0,0,3,1,1,5,14.2,12.38,2175.04,0.06,43,0.08,120.84,22,21,8,9,5,0
5,0,0,3,1,1,5,13.29,10.29,1406.48,0.05,35,0.1,78.14,18,17,7,8,5,0
7,0,0,4,1,1,10,11.6,38.5,17191.86,0.15,95,0.03,955.1,66,29,12,14,10,0
5,0,0,3,1,1,7,13.09,18.45,4456.41,0.08,52,0.05,247.58,29,23,11,14,7,0
5,0,0,3,1,1,5,14.2,12.38,2175.04,0.06,43,0.08,120.84,22,21,8,9,5,0
5,0,0,3,1,1,7,13.18,14,2582.68,0.06,42,0.07,143.48,21,21,9,12,7,0
9,3,1,5,2,1,14,12.24,29.56,10695.71,0.12,80,0.03,594.21,38,42,9,14,17,0
9,3,1,5,2,1,14,12.24,29.56,10695.71,0.12,80,0.03,594.21,38,42,9,14,17,0
22,7,6,15,8,7,79,48.32,49.43,118064.59,0.8,391,0.02,6559.14,174,217,44,25,86,0
22,7,6,15,8,7,79,48.32,49.43,118064.59,0.8,391,0.02,6559.14,174,217,44,25,86,0
3,0,10,2,1,1,21,46.11,14.5,9695.39,0.22,124,0.07,538.63,58,66,28,14,21,0
3,0,10,2,1,1,21,46.11,14.5,9695.39,0.22,124,0.07,538.63,58,66,28,14,21,0
5,0,4,3,3,1,41,46.77,30.69,44054.95,0.48,243,0.03,2447.5,114,129,39,21,41,1
5,0,4,3,3,1,41,46.77,30.69,44054.95,0.48,243,0.03,2447.5,114,129,39,21,41,1
7,4,14,4,2,3,16,40.48,11.25,5123.16,0.15,85,0.09,284.62,39,46,26,15,20,1
7,4,14,4,2,3,16,40.48,11.25,5123.16,0.15,85,0.09,284.62,39,46,26,15,20,1
25,9,14,14,7,5,65,62.32,19.01,22519.97,0.39,192,0.05,1251.11,81,111,49,23,74,0
25,9,14,14,7,5,65,62.32,19.01,22519.97,0.39,192,0.05,1251.11,81,111,49,23,74,0
5,0,0,3,2,1,11,21.05,7.09,1058.51,0.05,33,0.14,58.81,13,20,11,12,11,1
5,0,0,3,2,1,11,21.05,7.09,1058.51,0.05,33,0.14,58.81,13,20,11,12,11,1
5,0,0,3,2,1,11,21.05,7.09,1058.51,0.05,33,0.14,58.81,13,20,11,12,11,0
5,0,0,3,2,1,11,21.05,7.09,1058.51,0.05,33,0.14,58.81,13,20,11,12,11,0
3,0,0,2,1,1,5,10.75,5,268.87,0.02,15,0.2,14.94,5,10,4,8,5,0
3,0,0,2,1,1,7,8.26,12.1,1210,0.03,25,0.08,67.22,11,14,5,11,7,0
13,0,3,7,7,1,36,33.06,25.74,21902.71,0.28,161,0.04,1216.82,74,87,23,16,36,0
26,1,1,14,11,7,45,30.87,42.62,56084.29,0.44,221,0.02,3115.79,97,124,33,29,46,0
5,4,0,3,3,1,14,52.67,6.38,2143.97,0.11,65,0.16,119.11,29,36,25,11,18,1
5,4,0,3,1,1,10,32.11,9.58,2947.52,0.1,61,0.1,163.75,26,35,19,14,14,0
7,4,6,4,4,1,18,45.88,9.11,3805.17,0.14,77,0.11,211.4,34,43,28,15,22,0
3,2,0,2,2,1,9,34.56,4,552.97,0.05,31,0.25,30.72,14,17,14,8,11,0
25,12,6,13,7,10,47,117.25,17.36,35353.17,0.68,316,0.06,1964.06,143,173,70,17,59,1
7,4,0,4,3,3,14,31.36,10.11,3205.92,0.11,64,0.1,178.11,28,36,18,13,18,0
21,8,4,11,5,10,30,78.46,12.52,12301.89,0.33,165,0.08,683.44,72,93,46,16,38,1
3,1,0,2,1,1,6,21.76,5.25,599.66,0.04,30,0.19,33.31,14,16,8,6,7,0
21,11,5,11,9,7,38,76.18,14.65,16348.21,0.37,186,0.07,908.23,81,105,47,17,49,1
11,6,7,6,5,4,23,43.34,14.66,9309.11,0.21,115,0.07,517.16,50,65,29,17,29,1
7,6,0,4,4,1,24,56.95,11.11,7030.54,0.21,111,0.09,390.59,50,61,36,16,30,1
7,2,0,4,2,4,12,33.12,8,2119.78,0.09,54,0.13,117.77,24,30,18,12,14,0
3,2,0,2,2,1,9,28.66,6.23,1113.38,0.06,38,0.16,61.85,17,21,15,11,11,0
13,8,1,7,5,4,31,73.73,12.57,11641.4,0.31,155,0.08,646.74,68,87,46,17,39,0
13,10,0,7,6,4,33,71.6,13.86,13750.99,0.33,166,0.07,763.94,75,91,46,17,43,1
9,4,11,5,4,3,20,52.95,8.87,4163,0.16,86,0.11,231.28,38,48,30,14,24,1
9,6,10,5,4,3,35,82.63,16.32,22024.66,0.45,224,0.06,1223.59,100,124,49,16,41,0
3,2,4,2,2,1,13,40.12,6.05,1468.67,0.08,49,0.17,81.59,22,27,20,11,15,0
13,6,7,7,3,3,24,46.55,19.92,18476.3,0.31,157,0.05,1026.46,74,83,39,21,30,0
11,0,0,6,4,3,9,33.68,10.74,3883.05,0.12,73,0.09,215.72,34,39,19,12,9,1
5,0,0,3,3,1,5,24.09,5.6,755.36,0.04,33,0.18,41.96,16,17,10,7,5,0
7,3,6,4,3,1,18,56.43,12.83,9294.08,0.24,138,0.08,516.34,63,75,27,11,21,0
11,2,12,6,2,6,14,42.25,11.54,5625.43,0.16,91,0.09,312.52,40,51,26,15,16,1
17,3,35,9,6,3,27,67.59,11.15,8408.78,0.25,131,0.09,467.15,58,73,39,15,30,1
5,1,11,3,3,1,18,46.1,8.61,3416.12,0.13,78,0.12,189.78,36,42,23,11,19,0
12,6,13,7,6,1,29,48.73,13.64,9060.53,0.22,116,0.07,503.36,45,71,33,20,35,0
3,2,18,2,2,1,13,61.47,4.05,1009.6,0.08,53,0.25,56.09,22,31,19,7,15,1
11,3,8,6,1,4,12,21.92,17.73,6891.86,0.13,80,0.06,382.88,38,42,15,14,15,0
5,2,0,3,2,1,14,31.7,10.47,3476.06,0.11,67,0.1,193.11,29,38,18,13,16,0
5,2,0,3,2,1,14,40.79,8.29,2800.36,0.11,67,0.12,155.58,29,38,21,12,16,0
9,2,0,5,2,4,7,13.09,18.67,4559.75,0.08,54,0.05,253.32,24,30,9,14,9,0
9,0,0,5,3,1,11,16.12,14.3,3299.03,0.08,51,0.07,183.28,22,29,10,13,11,0
22,2,1,13,10,8,43,41.66,36.87,56634.51,0.51,256,0.03,3146.36,89,167,35,29,45,0
13,5,0,7,7,6,22,36.01,13.42,6486.52,0.16,95,0.07,360.36,34,61,19,15,27,0
15,0,14,8,5,1,37,48.97,21.05,21705.36,0.34,176,0.05,1205.85,80,96,38,20,37,1
22,3,2,17,12,4,68,55.44,24.38,32939.44,0.45,215,0.04,1829.97,78,137,48,30,71,0
3,1,3,2,2,1,12,29.33,4.5,594,0.04,33,0.22,33,15,18,10,6,13,0
9,0,1,5,1,4,21,18.5,21.54,8579.94,0.13,82,0.05,476.66,35,47,13,16,21,0
9,0,5,5,1,5,23,28.71,23.33,15633.33,0.22,134,0.04,868.52,60,74,18,14,23,0
17,0,3,9,5,7,30,44.42,9.42,3946.1,0.14,83,0.11,219.23,29,54,20,13,30,0
3,0,1,2,2,1,18,64,8.03,4132.74,0.17,98,0.12,229.6,45,53,28,10,18,0
11,0,14,6,4,1,34,51.05,19.74,19886.3,0.34,172,0.05,1104.79,75,97,38,20,34,1
11,0,4,6,4,1,20,51.1,12.22,7632.82,0.21,119,0.08,424.05,60,59,27,11,20,1
3,0,5,2,2,1,21,39.6,9.45,3540.14,0.12,73,0.11,196.67,32,41,22,13,21,1
5,0,0,3,2,1,11,22.64,5.73,742.59,0.04,30,0.17,41.25,14,16,11,9,11,0
29,0,10,15,9,14,81,104.45,30.05,94338.77,1.05,462,0.03,5241.04,187,275,84,27,81,1
7,0,4,4,4,1,23,24.52,16.53,6697.28,0.14,79,0.06,372.07,35,44,18,17,23,1
9,0,10,5,2,1,28,41.8,17.61,12957.24,0.25,134,0.06,719.85,58,76,28,17,28,0
5,0,0,3,3,1,13,27.68,4.38,529.87,0.04,31,0.23,29.44,10,21,8,7,13,0
15,5,1,9,4,4,28,32.72,37.94,47122.94,0.41,207,0.03,2617.94,86,121,34,30,33,0
27,3,2,15,6,10,39,42.04,61.97,161468.35,0.87,428,0.02,8970.46,157,271,38,30,42,0
32,3,12,19,8,5,75,43.01,71.26,218421.83,1.02,471,0.01,12134.55,208,263,54,37,78,0
7,0,0,4,3,1,10,11.9,21.72,5615.72,0.09,55,0.05,311.98,23,32,9,17,10,0
3,0,0,2,1,1,4,11.82,8.8,915.2,0.03,26,0.11,50.84,8,18,5,11,4,0
3,0,0,2,1,1,20,47.51,25.6,31133.81,0.41,227,0.04,1729.66,80,147,25,16,20,0
5,0,0,3,3,1,5,15.88,10.11,1623.23,0.05,36,0.1,90.18,14,22,9,13,5,0
20,0,1,11,2,11,24,20.28,39,30842.25,0.26,144,0.03,1713.46,57,87,19,26,24,0
17,3,0,9,2,5,24,32.25,23.09,17192.85,0.25,139,0.04,955.16,59,80,23,18,27,0
19,4,16,11,2,1,38,33.74,23.2,18157.82,0.26,136,0.04,1008.77,58,78,30,24,42,0
19,4,13,11,2,1,38,33.74,23.2,18157.82,0.26,136,0.04,1008.77,58,78,30,24,42,0
9,1,42,5,3,1,50,106.51,20,42604.83,0.71,325,0.05,2366.93,148,177,74,20,51,1
5,0,27,3,1,1,31,87.22,17.4,26406.88,0.51,252,0.06,1467.05,116,136,50,15,31,0
5,0,27,3,1,1,31,87.22,17.4,26406.88,0.51,252,0.06,1467.05,116,136,50,15,31,0
5,0,13,3,1,1,13,20.6,11.31,2634.57,0.08,49,0.09,146.37,21,28,13,14,13,0
5,0,19,3,1,1,15,28.04,10.32,2988.73,0.1,59,0.1,166.04,27,32,17,13,15,0
7,1,3,4,1,3,19,19.14,14,3750.95,0.09,57,0.07,208.39,24,33,12,14,20,0
7,3,5,4,3,1,20,20.71,28,16240,0.19,116,0.04,902.22,56,60,16,16,23,0
7,0,14,4,3,1,22,28.85,9.71,2717.65,0.09,56,0.1,150.98,22,34,17,15,22,0
5,0,0,3,1,1,10,13.12,10.83,1539.78,0.05,31,0.09,85.54,13,18,9,15,10,0
3,0,14,2,2,1,11,24.39,5.4,711.1,0.04,31,0.19,39.51,12,19,10,9,11,0
3,0,14,2,2,1,10,20.51,4.57,428.64,0.03,24,0.22,23.81,8,16,7,8,10,0
23,2,10,14,6,1,82,38.44,40.11,61835.72,0.51,256,0.02,3435.32,106,150,37,28,84,0
11,0,50,6,4,1,58,182.36,5.4,5311.46,0.33,159,0.19,295.08,68,91,63,10,58,0
3,0,17,2,2,1,12,24.49,6,881.67,0.05,34,0.17,48.98,12,22,10,10,12,0
17,4,9,10,10,1,56,86.98,11.25,11008.93,0.33,165,0.09,611.61,69,96,46,15,60,0
3,0,0,2,1,1,12,20.64,5.56,637.19,0.04,27,0.18,35.4,10,17,9,10,12,0
5,0,4,3,1,3,12,18.86,7.33,1014.21,0.05,32,0.14,56.35,12,20,9,11,12,0
13,1,47,7,3,3,38,39.49,24.85,24386.04,0.33,173,0.04,1354.78,71,102,30,21,39,0
9,2,9,5,4,1,17,41.54,6.32,1656.83,0.09,54,0.16,92.05,24,30,19,10,19,0
7,0,7,4,1,4,14,15.93,7.2,825.94,0.04,31,0.14,45.89,9,22,5,8,14,1
17,0,0,9,1,1,24,35.36,17.72,11106.15,0.21,129,0.06,617.01,58,71,18,11,24,1
17,0,0,9,1,1,24,35.36,17.72,11106.15,0.21,129,0.06,617.01,58,71,18,11,24,1
5,0,0,3,1,1,14,20.84,11,2521.73,0.08,50,0.09,140.1,22,28,12,12,14,0
5,0,0,3,1,1,14,19.1,11.92,2711.63,0.08,49,0.08,150.65,22,27,12,13,14,0
7,0,0,4,1,1,11,25.88,10.71,2971.35,0.09,59,0.09,165.07,25,34,14,12,11,1
5,0,0,3,1,1,10,18.38,11.23,2316.45,0.07,45,0.09,128.69,19,26,11,13,10,0
5,0,0,3,1,1,10,18.38,11.23,2316.45,0.07,45,0.09,128.69,19,26,11,13,10,1
7,0,0,4,1,1,10,22.22,11,2688.65,0.08,52,0.09,149.37,22,30,13,13,10,1
5,0,0,3,1,3,12,21.13,11.5,2794.53,0.08,53,0.09,155.25,23,30,12,12,12,0
5,0,0,3,1,3,12,21.13,11.5,2794.53,0.08,53,0.09,155.25,23,30,12,12,12,0
7,0,0,4,1,1,9,17.28,12.09,2526.68,0.07,45,0.08,140.37,19,26,11,14,9,0
7,0,0,4,1,1,10,23.78,10.15,2451.96,0.08,52,0.1,136.22,22,30,13,12,10,0
7,0,0,4,1,1,10,22.22,11,2688.65,0.08,52,0.09,149.37,22,30,13,13,10,1
13,0,0,7,6,1,25,38.61,14.97,8655.44,0.19,119,0.07,480.86,49,70,18,11,25,1
36,1,0,21,6,9,49,35.67,65.77,154273.13,0.78,384,0.02,8570.73,171,213,39,30,50,0
3,0,0,2,1,1,8,16.53,7.5,930,0.04,31,0.13,51.67,15,16,8,8,8,0
3,0,0,2,1,1,8,13.56,5.33,385.81,0.02,19,0.19,21.43,8,11,6,8,8,0
5,1,3,3,1,1,10,12.86,14.78,2807.62,0.06,42,0.07,155.98,19,23,9,14,11,0
3,1,1,2,2,1,9,20.81,7.5,1170.6,0.05,35,0.13,65.03,15,20,11,11,10,0
48,1,48,27,1,13,116,111.77,28.44,90416.52,1.06,485,0.04,5023.14,157,328,69,25,117,0
16,5,0,12,1,6,41,29.35,33.5,32937,0.33,178,0.03,1829.83,67,111,23,23,46,0
7,0,0,4,1,4,7,14.12,9.63,1308.36,0.05,32,0.1,72.69,14,18,8,11,7,0
95,3,0,48,2,1,103,47.04,115.43,626797.86,1.81,1007,0.01,34822.1,515,492,29,13,106,0
9,1,0,5,1,3,10,16.86,17.14,4949.88,0.1,63,0.06,274.99,29,34,11,13,11,0
5,0,0,3,1,1,7,18.88,9,1529.25,0.06,40,0.11,84.96,20,20,10,9,7,0
11,1,0,6,4,6,18,21.36,16,5469.43,0.11,69,0.06,303.86,30,39,15,16,19,0
81,0,28,41,17,1,349,287.86,42.27,514310.25,4.05,1565,0.02,28572.79,757,808,197,22,349,0
235,0,32,118,43,27,627,362.37,83.27,2512696.67,10.06,3680,0.01,139594.26,1792,1888,269,25,627,0
7,0,3,4,3,1,16,21.01,13.5,3829.06,0.09,59,0.07,212.73,27,32,14,14,16,0
15,0,0,8,2,7,24,10.04,45,20327.14,0.15,95,0.02,1129.29,45,50,9,18,24,0
14,9,22,9,2,1,38,16.23,147.53,353307.23,0.8,447,0.01,19628.18,209,238,17,24,47,0
3,0,1,2,1,1,25,14.23,94.77,127850.89,0.45,287,0.01,7102.83,139,148,11,15,25,0
5,0,0,3,1,1,17,22.02,27,16052.62,0.2,115,0.04,891.81,54,61,18,18,17,0
11,0,0,6,3,6,17,15.38,23.38,8403.09,0.12,74,0.04,466.84,33,41,12,17,17,0
9,0,0,5,1,1,16,25.24,14.54,5332.64,0.12,79,0.07,296.26,37,42,14,11,16,0
13,0,0,7,2,3,29,28.86,20.94,12659.07,0.2,122,0.05,703.28,58,64,18,13,29,0
115,0,0,58,2,1,199,129.4,55.52,398853.5,2.39,1079,0.02,22158.53,512,567,83,18,199,0
7,0,0,4,1,1,16,13.27,21,5851.26,0.09,60,0.05,325.07,28,32,10,15,16,0
3,0,0,2,2,1,6,16.5,2,66,0.01,11,0.5,3.67,4,7,4,4,6,0
49,0,0,25,1,25,52,31.64,38.62,47183.65,0.41,249,0.03,2621.31,101,148,17,13,52,0
3,0,0,2,1,1,4,7.91,6.13,296.65,0.02,14,0.16,16.48,7,7,4,7,4,0
7,0,0,4,1,1,21,16.21,11,1962.54,0.06,42,0.09,109.03,16,26,8,11,21,0
3,0,0,2,2,1,4,6.17,7,302.3,0.01,13,0.14,16.79,6,7,3,7,4,0
17,0,0,9,2,3,31,27.36,29.33,23526.15,0.27,154,0.03,1307.01,69,85,20,17,31,0
3,0,1,2,1,1,12,14.09,13.5,2567.23,0.06,44,0.07,142.62,18,26,8,12,12,0
5,0,0,3,2,1,10,11.82,19,4268.6,0.07,49,0.05,237.14,19,30,8,16,10,0
9,3,0,6,1,1,21,13.76,36,17838.51,0.17,102,0.03,991.03,44,58,11,18,24,0
5,0,0,3,2,1,10,12.06,16.88,3435.08,0.07,45,0.06,190.84,18,27,8,15,10,0
7,0,0,4,1,3,14,11.58,21.25,5230.14,0.08,53,0.05,290.56,20,33,8,17,14,0
7,0,0,4,3,1,13,16.66,27.3,12420.23,0.15,88,0.04,690.01,39,49,15,21,13,0
5,0,0,3,2,1,12,14.42,12.38,2207.86,0.06,42,0.08,122.66,18,24,8,11,12,0
13,0,0,7,7,4,23,28.34,22.91,14874.31,0.22,122,0.04,826.35,56,66,22,18,23,0
25,0,0,13,13,1,30,63.69,18.78,22456.97,0.4,213,0.05,1247.61,104,109,36,13,30,0
29,3,0,15,12,9,49,53.89,38.73,80812.65,0.7,334,0.03,4489.59,158,176,51,25,52,0
29,0,0,15,15,14,37,93.04,18.79,32840.16,0.58,272,0.05,1824.45,124,148,66,20,37,0
14,0,0,9,2,1,28,22.95,22.69,11822.56,0.17,100,0.04,656.81,43,57,18,19,28,0
3,0,0,2,2,1,8,15.92,6.29,629.06,0.03,24,0.16,34.95,8,16,7,11,8,0
17,0,0,9,4,9,19,26.08,25.85,17423.93,0.22,125,0.04,968,47,78,20,22,19,0
3,1,0,2,2,1,4,13.87,4.67,302.05,0.02,17,0.21,16.78,7,10,6,8,5,0
3,1,0,2,2,1,4,13.87,4.67,302.05,0.02,17,0.21,16.78,7,10,6,8,5,0
110,6,6,57,43,42,136,111.38,61.95,427450.82,2.3,952,0.02,23747.27,430,522,118,34,142,0
5,0,0,3,2,3,8,11.85,10.21,1236.07,0.04,28,0.1,68.67,11,17,7,13,8,0
9,0,0,5,1,4,11,7.24,21,3192,0.05,38,0.05,177.33,14,24,4,12,11,0
5,1,0,3,2,3,13,23.84,7.5,1341.1,0.06,39,0.13,74.51,15,24,12,12,14,0
3,1,1,2,2,1,14,29.69,7.44,1642.27,0.07,45,0.13,91.24,17,28,16,14,15,0
7,2,0,4,2,4,21,28.27,9.69,2655.57,0.09,59,0.1,147.53,21,38,13,12,23,1
5,1,0,3,2,1,31,47.6,13.5,8674.38,0.21,117,0.07,481.91,54,63,30,15,32,0
19,1,15,10,8,1,74,79.49,32.46,83754.62,0.86,407,0.03,4653.03,198,209,61,20,75,0
33,8,49,17,14,17,93,99.14,25.67,65333.37,0.85,395,0.04,3629.63,172,223,67,20,101,0
21,1,12,11,2,3,38,35.52,30.55,33139.3,0.36,186,0.03,1841.07,84,102,33,24,39,1
5,1,11,3,2,1,27,43.37,15.45,10350.44,0.22,122,0.06,575.02,56,66,29,16,28,0
7,4,1,4,2,1,19,33.31,17,9625.29,0.19,105,0.06,534.74,50,55,25,17,23,0
7,2,7,4,4,1,24,37.25,27.5,28170.17,0.34,178,0.04,1565.01,80,98,32,22,26,1
7,3,8,4,2,1,25,32.27,25.33,20709.67,0.27,148,0.04,1150.54,72,76,27,19,28,0
3,0,2,2,2,1,13,24.46,8.75,1872.96,0.07,48,0.11,104.05,21,27,12,10,13,0
5,0,0,3,3,1,21,33.54,13,5667.6,0.15,88,0.08,314.87,36,52,18,13,21,0
3,0,0,2,1,1,8,13.4,5.25,369.2,0.02,18,0.19,20.51,7,11,6,9,8,0
7,0,0,4,1,3,10,10.84,13.71,2039.01,0.05,35,0.07,113.28,16,19,7,12,10,0
13,3,1,7,4,4,28,51.63,11.64,6990.82,0.2,107,0.09,388.38,48,59,33,16,31,0
24,1,8,19,18,1,80,44.9,40.53,73764.28,0.61,294,0.02,4098.02,123,171,44,29,81,0
3,0,0,2,2,1,12,19.16,6.19,733.44,0.04,29,0.16,40.75,11,18,8,9,12,0
5,1,1,3,3,1,14,19.08,9.9,1869.81,0.06,43,0.1,103.88,18,25,10,11,15,0
5,0,5,3,1,1,22,53.55,11.45,7025.78,0.2,125,0.09,390.32,63,62,22,8,22,0
11,0,4,6,4,5,33,69.47,9.03,5659.94,0.21,110,0.11,314.44,49,61,38,14,33,0
13,2,9,7,2,3,26,20.57,34.44,24402.86,0.24,135,0.03,1355.71,62,73,18,20,28,0
7,0,0,4,1,3,8,10.8,10,1080,0.04,27,0.1,60,12,15,6,10,8,0
13,2,25,7,6,3,33,42.89,21.47,19769.73,0.31,160,0.05,1098.32,73,87,34,20,35,0
5,0,0,3,1,1,13,18.54,16.14,4839.01,0.1,63,0.06,268.83,30,33,13,14,13,0
13,2,5,7,3,1,16,42.41,15.45,10128.75,0.22,124,0.06,562.71,40,84,22,17,18,0
3,0,1,2,1,1,14,25.61,9.43,2276.82,0.08,52,0.11,126.49,24,28,14,11,14,0
7,2,12,4,4,1,31,44.69,18.75,15711.84,0.28,147,0.05,872.88,60,87,32,20,33,1
7,0,0,4,1,4,13,17.83,10.4,1928.85,0.06,41,0.1,107.16,16,25,10,13,13,0
11,3,5,6,3,1,26,43.02,15.81,10760.54,0.23,127,0.06,597.81,61,66,27,14,29,0
5,0,0,3,3,1,19,55.57,7.2,2880.61,0.13,78,0.14,160.03,36,42,25,10,19,0
25,1,34,13,8,7,68,76.65,23.49,42296.9,0.6,284,0.04,2349.83,126,158,59,22,69,0
17,1,12,9,4,6,54,68.85,10.07,6976.38,0.23,121,0.1,387.58,51,70,38,15,55,0
3,2,3,2,2,1,12,31.35,10.31,3334.36,0.11,68,0.1,185.24,30,38,16,11,14,0
3,0,0,2,1,1,8,12.48,8.33,866.67,0.03,26,0.12,48.15,10,16,6,10,8,0
7,0,0,4,2,1,16,14.38,17.85,4583.24,0.09,54,0.06,254.62,21,33,10,17,16,0
3,1,2,2,1,1,11,25.04,7.33,1346.57,0.06,47,0.14,74.81,22,25,9,6,12,0
5,1,1,3,3,3,22,35.61,11.67,4847.17,0.14,81,0.09,269.29,35,46,21,14,23,0
5,0,0,3,3,1,26,48.96,8.1,3208.43,0.13,80,0.12,178.25,34,46,21,10,26,0
25,2,21,13,8,7,81,103.01,20.42,42973.95,0.7,321,0.05,2387.44,142,179,73,21,83,0
15,2,18,8,7,4,52,61.71,22.17,30324,0.46,228,0.05,1684.67,105,123,45,19,54,0
7,0,7,4,2,4,18,31.03,6.29,1225.98,0.07,42,0.16,68.11,16,26,14,11,18,0
9,2,0,5,3,3,19,21.11,20.5,8869.57,0.14,90,0.05,492.75,41,49,14,14,21,0
9,0,0,5,2,1,18,29.23,9.38,2568.93,0.09,57,0.11,142.72,25,32,16,12,18,0
11,4,2,6,1,3,21,35.4,12.07,5158.69,0.14,84,0.08,286.59,39,45,21,13,25,0
9,0,2,5,5,1,20,57.48,8,3678.64,0.15,87,0.13,204.37,36,51,27,12,20,0
5,0,1,3,1,3,12,18.28,10,1828.37,0.06,41,0.1,101.58,20,21,11,11,12,0
5,0,0,3,2,1,14,16.05,10.67,1827.2,0.06,39,0.09,101.51,16,23,9,12,14,0
13,0,19,9,9,1,54,56.78,18.93,20355.23,0.36,176,0.05,1130.85,71,105,45,24,54,0
5,1,3,3,1,1,13,18.95,10.29,2007.31,0.07,42,0.1,111.52,19,23,12,13,14,0
7,8,23,4,4,3,23,45.05,16.2,11826.86,0.24,130,0.06,657.05,61,69,32,17,31,0
5,5,15,3,3,1,18,59.75,7.4,3272.06,0.15,82,0.14,181.78,37,45,30,12,23,0
9,7,25,5,3,1,24,68.9,9.76,6567.21,0.22,118,0.1,364.84,53,65,38,14,31,0
11,9,27,6,5,4,28,60.67,14.77,13234.87,0.3,155,0.07,735.27,72,83,39,16,37,1
3,0,8,2,1,1,6,22.74,6.67,1010.8,0.05,34,0.15,56.16,16,18,12,10,6,0
13,8,23,7,5,1,19,53.3,10.61,6003.3,0.19,103,0.09,333.52,47,56,31,14,27,0
11,9,17,6,5,1,25,65.18,9.85,6318.58,0.21,111,0.1,351.03,48,63,39,16,34,0
5,0,13,3,1,1,12,36.12,6.39,1474.26,0.08,48,0.16,81.9,23,25,18,10,12,0
21,15,78,11,6,9,55,116.45,19.13,42594.84,0.74,339,0.05,2366.38,153,186,76,19,70,0
15,9,52,8,4,1,43,77.75,20.89,33939.63,0.54,260,0.05,1885.54,117,143,56,20,52,0
9,5,15,5,5,1,20,25.18,20,10073.18,0.17,99,0.05,559.62,45,54,18,16,25,0
3,2,9,2,2,1,9,32.85,9.12,2731.26,0.1,63,0.11,151.74,31,32,17,10,11,0
5,2,14,3,3,3,16,24.56,18.53,8430.88,0.15,91,0.05,468.38,42,49,17,15,18,0
31,21,51,16,7,14,64,85.98,28.08,67800.78,0.8,365,0.04,3766.71,164,201,73,25,85,0
9,6,16,5,4,1,31,90.58,12.32,13749.12,0.37,186,0.08,763.84,88,98,50,14,37,1
27,11,24,14,1,11,43,32.58,37.08,44807.95,0.4,209,0.03,2489.33,89,120,30,25,54,0
33,23,43,17,5,10,83,74.12,38.38,109170.24,0.95,431,0.03,6065.01,199,232,70,27,106,0
9,5,17,5,3,3,18,39.88,13.33,7090.32,0.18,98,0.08,393.91,45,53,27,16,23,0
15,5,14,8,5,6,21,40.15,15.41,9530.93,0.21,114,0.06,529.5,52,62,27,16,26,0
5,2,7,3,2,3,9,26.93,8.65,2013.44,0.08,47,0.12,111.86,21,26,17,14,11,0
5,2,7,3,2,3,9,26.93,8.65,2013.44,0.08,47,0.12,111.86,21,26,17,14,11,0
3,0,15,2,1,1,6,22.54,6.14,848.67,0.05,32,0.16,47.15,15,17,11,9,6,0
13,10,27,7,6,6,48,79.19,19.4,29800.23,0.51,243,0.05,1655.57,109,134,59,21,58,1
3,3,12,2,2,1,11,30.66,7.76,1848.32,0.08,49,0.13,102.68,22,27,17,12,14,0
7,4,19,4,4,1,18,43.02,9.88,4199.81,0.14,81,0.1,233.32,38,43,25,13,22,0
9,5,21,5,4,1,26,50.19,15.29,11739.22,0.26,136,0.07,652.18,65,71,34,16,31,0
19,9,70,10,8,1,53,68.68,23.83,39014.14,0.55,262,0.04,2167.45,117,145,54,22,62,1
9,7,9,5,2,1,17,32.11,15.3,7522.74,0.16,93,0.07,417.93,44,49,23,16,24,0
9,1,25,5,1,1,11,27.87,8.63,2073.17,0.08,50,0.12,115.18,23,27,16,12,12,0
13,4,26,7,3,1,33,66.19,24.42,39480.4,0.54,262,0.04,2193.36,127,135,52,20,37,1
19,7,44,10,3,1,33,84.79,15.33,19927.37,0.43,210,0.07,1107.08,101,109,56,17,40,0
12,6,33,7,6,1,26,42.74,11.03,5204.26,0.16,84,0.09,289.13,32,52,29,20,32,0
3,0,10,2,1,1,6,11.99,6.67,533.03,0.03,21,0.15,29.61,10,11,6,8,6,0
3,0,5,2,1,1,7,17.97,3.5,220.18,0.02,17,0.29,12.23,6,11,6,7,7,0
15,3,0,9,7,4,18,19.75,23.8,11186,0.16,94,0.04,621.44,42,52,15,17,21,0
5,0,1,3,2,1,14,34.4,9.84,3332.3,0.11,69,0.1,185.13,34,35,19,11,14,0
7,0,0,4,2,3,9,10.4,19,3755.43,0.07,45,0.05,208.64,19,26,7,14,9,0
13,0,0,7,6,6,17,27.29,21.05,12094.31,0.19,112,0.05,671.91,50,62,19,16,17,0
7,0,0,4,4,1,11,28.49,13.18,4947.97,0.13,83,0.08,274.89,41,42,14,9,11,0
9,0,0,5,4,3,11,15.17,23.86,8637.06,0.12,77,0.04,479.84,35,42,11,15,11,0
11,0,0,6,1,1,16,19.33,16.82,5466.44,0.11,74,0.06,303.69,37,37,11,10,16,0
11,1,0,6,4,6,23,31.58,13.18,5483.42,0.14,84,0.08,304.63,32,52,17,14,24,0
3,0,0,2,1,1,16,25.68,12.5,4011.84,0.11,70,0.08,222.88,25,45,12,12,16,0
3,0,0,2,1,1,18,30.71,12.86,5076.47,0.13,84,0.08,282.03,30,54,14,12,18,0
5,0,0,3,3,1,12,18.35,8.33,1274.38,0.05,36,0.12,70.8,15,21,9,10,12,0
5,0,0,3,3,1,11,18.35,8.33,1274.38,0.05,36,0.12,70.8,15,21,9,10,11,0
11,0,0,6,1,6,23,23.89,25.29,15285.15,0.2,116,0.04,849.17,43,73,17,20,23,0
11,0,0,6,2,1,38,46.36,12.73,7508.78,0.2,103,0.08,417.15,42,61,33,20,38,0
7,0,3,5,5,1,35,46.83,12.27,7046.59,0.19,104,0.08,391.48,46,58,30,16,35,0
7,0,3,5,5,1,37,48.33,13.68,9040.72,0.22,119,0.07,502.26,53,66,31,16,37,0
34,1,6,25,25,8,117,86.32,29.13,73246.56,0.84,368,0.03,4069.25,143,225,81,33,118,1
11,2,3,6,6,1,44,80.39,9.26,6897.13,0.25,130,0.11,383.17,57,73,40,13,46,0
5,4,0,3,3,1,35,99.53,11.61,13418.54,0.39,199,0.09,745.47,95,104,45,11,39,0
19,10,6,11,8,5,39,51.55,14.14,10311.72,0.24,125,0.07,572.87,45,80,35,22,49,0
3,0,3,2,2,1,22,39.13,13.91,7574.21,0.18,103,0.07,420.79,40,63,23,16,22,1
11,2,30,6,4,1,49,65.63,21.2,29496.56,0.46,227,0.05,1638.7,106,121,50,20,51,0
15,2,39,8,2,4,64,44.02,37.19,60876.7,0.55,268,0.03,3382.04,123,145,43,26,66,0
12,2,12,7,6,1,53,48.73,19.39,18330.01,0.32,160,0.05,1018.33,67,93,38,22,55,0
7,1,12,4,4,1,32,44.39,13.19,7722.51,0.2,106,0.08,429.03,45,61,29,17,33,0
3,0,0,2,1,1,12,22.81,5.4,665.23,0.04,29,0.19,36.96,12,17,10,9,12,0
31,5,35,16,9,8,97,142.15,18.84,50427.99,0.89,389,0.05,2801.56,174,215,97,21,102,1
7,0,7,4,2,1,27,55.45,9.21,4707.63,0.17,96,0.11,261.52,43,53,28,12,27,0
21,5,36,11,5,5,69,84.72,25.33,54371.71,0.72,329,0.04,3020.65,152,177,69,23,74,0
15,2,36,8,2,4,64,45.22,37.82,64671.74,0.57,279,0.03,3592.87,128,151,44,26,66,0
9,5,22,5,5,1,38,67.8,13.4,12174.52,0.3,152,0.07,676.36,67,85,45,18,43,1
75,3,64,38,15,32,144,115.86,37.39,161985.9,1.44,624,0.03,8999.22,279,345,97,26,147,1
61,4,60,31,13,23,128,96.71,39.62,151799.12,1.28,565,0.03,8433.28,256,309,84,26,132,0
3,0,0,2,1,1,10,8.79,12,1265.83,0.04,27,0.08,70.32,12,15,5,10,10,0
39,2,77,20,5,4,144,94.07,30.36,86693.87,0.95,428,0.03,4816.33,187,241,77,25,146,1
3,1,6,2,2,1,16,46.82,5.71,1528.72,0.09,54,0.18,84.93,24,30,21,10,17,0
7,1,0,4,1,1,17,48.72,35.88,62721.59,0.58,313,0.03,3484.53,78,235,25,23,18,0
3,1,1,2,1,1,12,30.83,17.31,9235.67,0.18,111,0.06,513.09,30,81,13,15,13,0
3,0,0,2,2,1,6,19.76,10.5,2178.25,0.07,48,0.1,121.01,14,34,8,12,6,0
5,1,0,3,3,1,18,40.59,14.06,8027.2,0.19,108,0.07,445.96,45,63,24,15,19,0
7,0,0,4,2,3,11,13.39,14.22,2707.88,0.06,41,0.07,150.44,16,25,9,16,11,0
8,0,1,5,4,1,39,32.31,31,31053.16,0.33,171,0.03,1725.18,62,109,29,29,39,0
7,0,0,4,1,4,8,8.89,17.5,2722.81,0.05,36,0.06,151.27,15,21,6,14,8,0
9,0,1,5,3,1,31,64.9,47.74,147935.37,1.03,509,0.02,8218.62,145,364,41,27,31,0
9,14,2,5,3,3,31,61.27,44.61,121958.52,0.91,446,0.02,6775.47,151,295,44,26,45,0
3,1,0,2,2,1,6,27.19,11.08,3336.31,0.1,62,0.09,185.35,18,44,13,16,7,0
3,1,1,2,1,1,6,27.01,11.69,3692.07,0.11,65,0.09,205.11,19,46,13,16,7,0
13,0,0,7,4,4,26,24.26,23.75,13682.58,0.19,109,0.04,760.14,50,59,20,19,26,0
5,0,0,3,1,3,16,15.53,18.9,5545.97,0.1,64,0.05,308.11,27,37,10,14,16,0
11,1,0,6,3,1,20,31.18,19.55,11909.67,0.2,113,0.05,661.65,43,70,22,20,21,0
9,1,1,5,3,1,47,55.62,43.56,105522.12,0.81,377,0.02,5862.34,147,230,54,32,48,0
25,0,0,13,9,6,34,68.44,31.61,68400.43,0.72,353,0.03,3800.02,107,246,44,26,34,0
5,1,0,3,1,1,10,12.7,16.25,3354.63,0.07,47,0.06,186.37,20,27,8,13,11,0
3,1,0,2,1,1,8,14.1,9.64,1311.43,0.05,34,0.1,72.86,15,19,7,9,9,0
3,0,0,2,1,1,6,21.28,15.27,4964.7,0.11,70,0.07,275.82,24,46,11,14,6,0
5,0,0,3,3,1,18,26.88,11.27,3412.26,0.1,63,0.09,189.57,26,37,15,13,18,0
5,0,0,3,3,1,18,26.88,11.27,3412.26,0.1,63,0.09,189.57,26,37,15,13,18,0
9,1,3,5,2,1,9,13.72,23.38,7494.65,0.11,66,0.04,416.37,33,33,12,17,10,0
5,0,0,3,3,1,8,17.84,12,2568.63,0.07,48,0.08,142.7,24,24,11,11,8,0
7,0,0,4,1,1,14,13.04,18.56,4494.57,0.08,57,0.05,249.7,27,30,8,11,14,0
3,0,0,2,1,1,6,9.05,2,36.19,0.01,7,0.5,2,2,5,2,4,6,0
7,0,0,4,2,1,12,15.35,20.67,6557.23,0.11,66,0.05,364.29,31,35,12,16,12,0
11,0,0,6,2,3,19,17.53,23.33,9541.89,0.14,87,0.04,530.11,40,47,12,14,19,0
13,0,1,7,3,1,11,11.3,26.81,8126.06,0.1,69,0.04,451.45,33,36,8,13,11,0
7,0,1,4,1,1,13,14.3,23.27,7746.14,0.11,70,0.04,430.34,32,38,11,16,13,0
13,0,0,7,2,1,14,29.59,14.55,6259.35,0.14,82,0.07,347.74,40,42,22,16,14,0
7,1,0,4,3,1,30,29.83,40.13,48033.42,0.4,222,0.02,2668.52,107,115,24,18,31,0
11,1,0,6,1,1,34,32.18,45,65170.26,0.48,278,0.02,3620.57,132,146,22,15,35,0
7,0,0,4,1,4,6,14.12,9.63,1308.36,0.05,32,0.1,72.69,14,18,8,11,6,0
3,0,0,2,2,1,6,11.42,6.67,507.65,0.03,20,0.15,28.2,10,10,6,8,6,0
7,0,0,4,2,1,12,15.35,20.67,6557.23,0.11,66,0.05,364.29,31,35,12,16,12,0
3,0,0,2,1,1,6,7.57,9,613.03,0.02,19,0.11,34.06,9,10,4,8,6,0
5,0,0,3,3,1,7,13.51,13.33,2401.13,0.06,41,0.08,133.4,20,21,9,12,7,0
3,0,1,2,1,1,6,16.82,8.33,1168.18,0.05,33,0.12,64.9,15,18,9,10,6,0
9,0,1,5,5,1,8,13.02,19.25,4824.58,0.08,59,0.05,268.03,28,31,8,11,8,0
5,0,0,3,3,1,8,17.66,11.5,2336,0.07,47,0.09,129.78,23,24,10,10,8,0
3,0,2,2,2,1,42,100.54,28.52,81768.15,0.96,471,0.04,4542.68,220,251,54,14,42,0
3,0,0,2,1,1,6,6.5,6,234,0.01,13,0.17,13,4,9,2,6,6,0
5,0,0,3,3,1,7,17.66,11.5,2336,0.07,47,0.09,129.78,23,24,10,10,7,0
5,1,1,3,3,1,14,33.76,11.7,4621.5,0.13,79,0.09,256.75,39,40,20,12,15,0
5,1,0,3,3,1,8,22.64,5.73,742.59,0.04,30,0.17,41.25,14,16,11,9,9,0
5,1,0,3,3,1,12,9.76,27,7115.55,0.09,60,0.04,395.31,27,33,7,14,13,0
9,0,0,5,1,3,11,16.86,17.14,4949.88,0.1,63,0.06,274.99,29,34,11,13,11,0
3,0,0,2,2,1,14,18.15,15,4084.22,0.09,63,0.07,226.9,30,33,10,10,14,0
7,0,0,4,3,1,17,25.55,11.15,3178.67,0.09,63,0.09,176.59,29,34,13,10,17,0
3,0,0,2,2,1,4,8.57,5.25,236.11,0.01,13,0.19,13.12,6,7,4,7,4,0
5,0,0,3,2,3,6,19.25,6.5,813.14,0.04,30,0.15,45.17,13,17,9,9,6,0
13,0,1,7,3,1,17,12.97,39.75,20489.85,0.17,111,0.03,1138.33,53,58,10,15,17,0
5,0,0,3,1,1,6,18.88,9,1529.25,0.06,40,0.11,84.96,20,20,10,9,6,0
5,0,0,3,3,1,7,15.57,12.6,2472.31,0.07,44,0.08,137.35,21,23,10,12,7,0
3,0,1,2,1,1,7,16.82,8.33,1168.18,0.05,33,0.12,64.9,15,18,9,10,7,0
7,0,0,4,2,1,12,15.35,20.67,6557.23,0.11,66,0.05,364.29,31,35,12,16,12,0
3,0,0,2,2,1,12,16.73,11,2024,0.06,46,0.09,112.44,22,24,8,8,12,0
5,1,0,3,2,1,11,25.67,11.09,3155.71,0.09,58,0.09,175.32,29,29,17,13,12,0
5,0,0,3,3,1,8,24.59,11.38,3181.51,0.09,57,0.09,176.75,26,31,16,14,8,0
11,0,0,6,4,6,14,16.89,18.31,5659.53,0.1,63,0.05,314.42,28,35,13,17,14,0
15,0,0,8,2,3,24,15.29,43.21,28547.12,0.22,136,0.02,1585.95,61,75,12,17,24,0
15,0,0,8,5,3,18,25.26,27.6,19238.64,0.23,131,0.04,1068.81,61,70,21,19,18,0
16,0,0,10,9,1,23,19.57,30.94,18729.81,0.2,119,0.03,1040.55,55,64,16,18,23,0
15,0,0,8,1,8,22,15.12,25.5,9828.72,0.13,83,0.04,546.04,34,49,10,15,22,0
9,0,0,5,1,3,10,8.52,19.25,3158.72,0.05,42,0.05,175.48,14,28,4,11,10,0
3,0,0,2,2,1,9,11.82,10.83,1386.67,0.04,32,0.09,77.04,13,19,6,10,9,0
7,0,0,4,1,4,6,7.22,13.33,1282.82,0.03,26,0.08,71.27,8,18,3,10,6,0
9,0,0,5,1,5,11,8.77,18.7,3066.8,0.05,41,0.05,170.38,17,24,5,11,11,0
5,0,0,3,1,1,7,6.02,18.33,2024.24,0.04,29,0.05,112.46,10,19,3,11,7,0
7,0,0,4,2,4,6,10.28,10,1027.99,0.03,27,0.1,57.11,8,19,4,10,6,0
7,0,0,4,1,1,10,6.88,24.38,4084.91,0.06,41,0.04,226.94,15,26,4,13,10,0
11,0,0,6,2,5,9,10.31,18.2,3415.17,0.06,45,0.05,189.73,14,31,5,13,9,0
3,0,0,2,2,1,5,11.2,7.5,630,0.03,21,0.13,35,9,12,6,10,5,0
5,0,0,3,1,1,7,6.38,13.33,1134.8,0.03,23,0.08,63.04,8,15,3,10,7,0
11,0,0,6,3,3,9,10.61,23.21,5718.84,0.08,57,0.04,317.71,25,32,7,13,9,0
11,0,0,6,1,5,11,8.91,22.4,4472.22,0.07,47,0.04,248.46,16,31,5,14,11,0
9,0,0,5,1,5,10,8.7,21,3835.88,0.06,43,0.05,213.1,15,28,5,14,10,0
13,0,0,7,5,6,11,7.15,29.75,6326.82,0.07,51,0.03,351.49,17,34,4,14,11,0
5,0,0,3,2,3,7,10.91,8.8,844.8,0.03,24,0.11,46.93,8,16,5,11,7,0
17,0,0,9,2,9,16,10.13,32.58,10759.67,0.11,73,0.03,597.76,23,50,6,17,16,0
7,0,0,4,2,4,7,7.8,19.6,2997.34,0.05,36,0.05,166.52,14,22,5,14,7,0
11,0,0,6,2,6,12,12.67,21.85,6050.37,0.09,57,0.05,336.13,23,34,10,19,12,0
11,0,0,6,2,6,12,11.97,25,7483.01,0.1,61,0.04,415.72,25,36,10,20,12,0
5,0,0,3,1,1,10,10.25,21,4519.69,0.07,49,0.05,251.09,21,28,7,14,10,0
5,0,0,3,2,3,8,9.65,14.08,1914.4,0.05,32,0.07,106.36,13,19,6,13,8,0
5,0,0,3,2,3,7,9.57,8.75,732.92,0.03,22,0.11,40.72,7,15,4,10,7,0
9,0,0,5,1,1,18,11.47,28,8990.21,0.11,72,0.04,499.46,32,40,8,14,18,0
9,0,0,5,1,5,11,8.42,20.4,3502.14,0.06,42,0.05,194.56,17,25,5,12,11,0
17,0,0,9,1,9,16,9.47,31.5,9393.71,0.1,69,0.03,521.87,21,48,5,15,16,0
7,0,0,4,1,1,12,14.41,15,3241.45,0.07,50,0.07,180.08,20,30,8,12,12,0
5,0,0,3,2,1,5,4.54,15,1021.71,0.02,19,0.07,56.76,6,13,2,10,5,0
5,0,0,3,2,1,5,4.54,15,1021.71,0.02,19,0.07,56.76,6,13,2,10,5,0
5,0,0,3,2,3,8,10.76,14.86,2375.83,0.05,37,0.07,131.99,16,21,7,13,8,0
13,0,0,7,3,4,20,33.58,20.52,14141.06,0.23,127,0.05,785.61,57,70,25,18,20,0
85,4,0,43,27,18,136,170.88,39.94,272550.45,2.27,920,0.03,15141.69,426,494,144,27,140,0
19,3,2,10,2,6,43,40.83,24.08,23672.68,0.33,186,0.04,1315.15,86,100,25,14,46,0
11,0,0,6,3,1,17,13.79,21,6080.95,0.1,67,0.05,337.83,28,39,8,12,17,0
9,0,0,5,4,1,24,33.71,14.84,7426.6,0.17,101,0.07,412.59,47,54,19,12,24,0
5,0,0,3,3,1,12,19.74,9.9,1934.51,0.07,46,0.1,107.47,22,24,10,9,12,0
29,0,5,15,8,1,36,40.52,27.02,29576.11,0.36,193,0.04,1643.12,91,102,32,19,36,0
5,0,0,3,3,1,8,18.89,5.63,597.79,0.04,26,0.18,33.21,10,16,8,9,8,0
31,0,1,16,8,14,45,52.14,23.89,29750.8,0.42,210,0.04,1652.82,91,119,40,21,45,0
7,1,0,4,4,1,12,26.73,8.46,1913.81,0.08,50,0.12,106.32,22,28,13,10,13,0
5,0,0,3,1,3,12,10.7,13.75,2023.29,0.05,36,0.07,112.41,15,21,6,11,12,0
5,0,0,3,1,3,10,9.26,12.1,1355.2,0.04,28,0.08,75.29,11,17,5,11,10,0
9,1,0,5,5,5,23,23.67,23,12520.25,0.18,107,0.04,695.57,46,61,17,17,24,0
19,0,0,10,4,4,24,43.97,13.19,7652.73,0.19,109,0.08,425.15,49,60,26,14,24,0
21,2,4,11,3,6,28,26.33,28.41,21254.38,0.25,151,0.04,1180.8,69,82,17,14,30,0
7,1,0,4,2,3,17,18.31,14.77,3996.21,0.09,59,0.07,222.01,25,34,11,13,18,0
19,9,39,10,1,5,65,35.09,30.33,32286.36,0.35,200,0.03,1793.69,91,109,24,16,74,1
3,1,1,2,1,1,17,58.95,6.3,2339.72,0.12,73,0.16,129.97,35,38,25,9,18,1
26,4,0,17,13,5,112,118.43,23.9,67644.11,0.94,405,0.04,3758.01,169,236,99,28,116,0
7,1,11,5,5,1,30,47.28,11.03,5756.98,0.17,95,0.09,319.83,40,55,29,16,31,1
3,0,6,2,2,1,15,39.13,6.39,1597.11,0.08,52,0.16,88.73,23,29,18,10,15,0
5,6,37,3,2,1,26,37.82,17.54,11632.47,0.22,123,0.06,646.25,57,66,26,16,32,0
7,0,16,4,1,1,25,20.43,24,11768.4,0.16,102,0.04,653.8,48,54,14,14,25,0
5,6,16,3,2,1,26,31.15,17.15,9161.25,0.18,105,0.06,508.96,49,56,20,14,32,0
5,4,22,3,2,1,25,25.67,18.53,8812.64,0.16,96,0.05,489.59,45,51,17,14,29,0
3,0,28,2,1,1,12,18.46,16.91,5277.76,0.1,69,0.06,293.21,31,38,11,12,12,0
5,0,0,3,3,1,7,24.15,8.59,1782.21,0.07,48,0.12,99.01,21,27,11,9,7,0
5,0,0,3,2,3,10,14.33,13.6,2651.33,0.06,41,0.07,147.3,16,25,10,17,10,0
5,0,0,3,2,1,9,13.27,11.25,1679.37,0.05,33,0.09,93.3,12,21,8,15,9,0
41,4,1,28,13,14,99,40.18,114.52,526977.11,1.53,676,0.01,29276.51,284,392,62,50,103,0
33,6,0,17,5,7,34,51.63,25.9,34627.03,0.45,214,0.04,1923.72,94,120,49,27,40,0
33,0,0,17,10,8,39,47.02,30.81,44643.75,0.48,238,0.03,2480.21,106,132,43,25,39,0
15,0,0,8,5,5,18,26.46,21.46,12182.6,0.19,104,0.05,676.81,47,57,23,21,18,0
3,0,0,2,2,1,10,18.6,6.5,786.03,0.04,29,0.15,43.67,13,16,9,9,10,0
11,0,7,6,5,4,35,63.05,28.78,52205.44,0.6,297,0.03,2900.3,141,156,49,20,35,0
3,0,0,2,2,1,9,19.24,10.63,2172.39,0.07,43,0.09,120.69,17,26,12,15,9,0
5,0,0,3,3,3,4,12.61,6.75,574.49,0.03,23,0.15,31.92,6,17,4,9,4,0
5,0,0,3,3,3,6,13.67,8,875.14,0.04,28,0.13,48.62,8,20,5,10,6,0
7,0,0,4,3,3,8,14.4,10,1440,0.05,36,0.1,80,12,24,6,10,8,0
3,0,0,2,2,1,8,23.66,7.92,1482.76,0.06,42,0.13,82.38,19,23,12,10,8,0
7,0,0,4,1,4,11,17.45,11.69,2385.64,0.07,42,0.09,132.54,19,23,13,16,11,0
11,2,0,6,6,4,36,37,27.73,28450.7,0.34,171,0.04,1580.59,76,95,37,27,38,0
9,1,0,5,4,1,33,37.18,17.68,11620.19,0.22,119,0.06,645.57,55,64,28,18,34,0
7,2,0,4,3,3,18,25.11,14,4921.77,0.12,68,0.07,273.43,28,40,18,18,20,0
5,0,0,3,2,3,14,22.59,10,2259.46,0.08,47,0.1,125.53,20,27,14,14,14,0
5,0,0,3,1,3,11,16.4,9.1,1358.43,0.05,33,0.11,75.47,14,19,10,13,11,0
5,0,0,3,1,3,11,14.12,10.89,1674.72,0.05,34,0.09,93.04,14,20,9,14,11,0
9,4,2,5,3,3,26,30.81,17.22,9132.06,0.18,99,0.06,507.34,44,55,23,18,30,0
11,0,0,6,3,3,22,20.15,21.39,9220.24,0.14,81,0.05,512.24,35,46,18,22,22,0
7,1,1,4,4,1,21,54.76,4.7,1211.98,0.09,52,0.21,67.33,23,29,22,9,22,0
9,0,2,5,4,4,13,20.09,10.5,2214.54,0.07,46,0.1,123.03,21,25,12,12,13,0
3,0,0,2,1,1,3,10.28,4.38,196.76,0.01,13,0.23,10.93,5,8,4,7,3,0
3,0,0,2,1,1,3,10.28,4.38,196.76,0.01,13,0.23,10.93,5,8,4,7,3,0
3,0,0,2,2,1,11,31.21,6.13,1170.84,0.06,45,0.16,65.05,21,24,12,7,11,0
3,0,1,2,2,1,14,31.97,10.95,3831.58,0.12,70,0.09,212.87,32,38,19,13,14,0
9,2,10,5,3,1,29,51.73,12.95,8682.08,0.22,120,0.08,482.34,57,63,33,15,31,0
5,2,0,3,3,3,10,23.16,11,2802.69,0.08,53,0.09,155.7,22,31,14,14,12,0
3,0,0,2,1,1,3,9.49,3.5,116.27,0.01,10,0.29,6.46,3,7,3,7,3,0
11,1,0,6,4,5,10,14.62,13.72,2753.7,0.07,45,0.07,152.98,19,26,9,13,11,0
3,0,0,2,2,1,9,10.2,13.33,1813.33,0.05,34,0.08,100.74,16,18,6,10,9,0
9,1,0,5,3,5,15,19.64,19.69,7612.12,0.13,76,0.05,422.9,35,41,16,18,16,0
5,0,0,3,2,3,5,11.99,5.4,349.52,0.02,17,0.19,19.42,6,11,5,9,5,0
3,0,0,2,1,1,9,15.92,7.07,796.16,0.04,27,0.14,44.23,9,18,7,11,9,0
11,2,0,6,5,4,19,28.27,12.8,4632.25,0.12,70,0.08,257.35,32,38,20,16,21,0
3,0,0,2,1,1,7,18.62,6.5,786.59,0.04,28,0.15,43.7,13,15,10,10,7,0
3,0,0,2,1,1,6,6,6,216,0.01,12,0.17,12,4,8,2,6,6,0
3,0,0,2,1,1,6,19.23,4.89,459.61,0.03,23,0.2,25.53,11,12,9,8,6,0
7,2,2,4,4,1,17,20.9,18.5,7152.97,0.13,76,0.05,397.39,37,39,17,17,19,0
3,0,0,2,2,1,19,49.17,9.13,4099.12,0.15,89,0.11,227.73,42,47,23,10,19,0
5,1,1,3,2,3,19,30.43,9.95,3010.71,0.1,60,0.1,167.26,27,33,19,14,20,0
5,0,0,3,3,3,22,36.99,12.3,5596.5,0.15,91,0.08,310.92,41,50,20,12,22,0
3,0,0,2,1,1,5,10.75,6,387.18,0.02,18,0.17,21.51,6,12,4,8,5,0
5,0,0,3,1,1,12,36.25,6.35,1463.22,0.08,49,0.16,81.29,24,25,17,9,12,0
13,4,8,7,3,1,36,38.26,27.7,29360.62,0.35,178,0.04,1631.15,82,96,37,25,40,0
11,0,5,6,6,3,32,44,22.29,21860.16,0.33,160,0.04,1214.45,71,89,43,27,32,0
3,0,0,2,1,1,5,20.07,5.91,700.77,0.04,27,0.17,38.93,13,14,11,10,5,0
5,0,0,3,2,3,18,30.6,9.39,2697.84,0.1,58,0.11,149.88,26,32,18,13,18,0
3,0,0,2,1,1,5,18.39,4.89,439.63,0.03,22,0.2,24.42,11,11,9,8,5,0
3,0,0,2,1,1,6,10.04,5,250.95,0.02,14,0.2,13.94,5,9,4,8,6,0
12,0,1,10,9,1,41,42.39,16.16,11064.31,0.23,119,0.06,614.68,47,72,32,22,41,0
3,0,4,2,1,1,34,114.44,11.44,14989.46,0.44,209,0.09,832.75,103,106,63,14,34,0
11,4,2,8,8,3,32,33.95,14.15,6799.13,0.16,88,0.07,377.73,31,57,23,21,36,0
5,0,1,3,2,1,19,37.78,6.11,1408.93,0.08,51,0.16,78.27,19,32,14,9,19,0
5,0,0,3,2,1,15,38.11,8.16,2536.38,0.1,64,0.12,140.91,31,33,19,10,15,0
9,0,1,5,2,1,13,39.26,6.75,1788.56,0.09,54,0.15,99.36,27,27,20,10,13,0
9,3,4,5,5,3,25,41.51,11.69,5674.38,0.16,90,0.09,315.24,38,52,26,16,28,0
3,0,0,2,2,1,10,29.95,3,269.58,0.03,23,0.33,14.98,9,14,9,6,10,0
3,0,0,2,2,1,5,11.91,5.25,328.18,0.02,16,0.19,18.23,7,9,6,9,5,0
5,0,3,3,3,1,13,33.1,7.12,1676.64,0.08,49,0.14,93.15,22,27,17,11,13,0
5,0,1,3,3,3,16,27.81,6.68,1240.57,0.06,40,0.15,68.92,17,23,14,11,16,0
9,0,1,5,3,4,12,19.93,11.08,2448.54,0.07,47,0.09,136.03,19,28,12,14,12,0
9,0,1,5,3,4,10,15.12,11.67,2058.21,0.06,39,0.09,114.35,15,24,9,14,10,0
5,0,3,3,2,3,13,23.79,14.5,5002.5,0.12,69,0.07,277.92,29,40,16,16,13,0
7,2,0,4,4,4,8,26.93,4.8,620.48,0.04,31,0.21,34.47,12,19,10,8,10,0
5,0,0,3,3,1,10,23.58,8.57,1732.45,0.07,43,0.12,96.25,20,23,14,12,10,0
5,0,0,3,2,1,14,18.75,7.09,942.84,0.04,29,0.14,52.38,12,17,11,13,14,0
10,2,0,6,3,6,22,22.38,20,8951.25,0.15,83,0.05,497.29,30,53,18,24,24,0
5,0,0,3,3,1,9,17.03,14,3337.85,0.08,52,0.07,185.44,20,32,10,14,9,0
5,0,0,3,2,1,10,16.1,20,6441.86,0.11,67,0.05,357.88,30,37,12,16,10,0
13,0,1,7,6,7,15,26.3,11.7,3599.75,0.1,64,0.09,199.99,27,37,15,13,15,0
3,0,0,2,1,1,5,11.86,5.25,326.92,0.02,18,0.19,18.16,6,12,4,7,5,0
3,0,0,2,1,1,7,8.88,9,719.59,0.03,21,0.11,39.98,10,11,5,9,7,0
3,0,0,2,1,1,6,9.87,5.63,312.22,0.02,15,0.18,17.35,5,10,4,9,6,0
3,0,0,2,1,1,11,15.7,10.63,1772.22,0.06,40,0.09,98.46,17,23,8,10,11,0
3,0,0,2,1,1,12,15.43,10,1542.87,0.05,37,0.1,85.72,16,21,8,10,12,0
3,0,0,2,1,1,4,11.39,3.5,139.52,0.01,12,0.29,7.75,3,9,3,7,4,0
3,0,0,2,2,1,14,25.22,9.21,2138.11,0.08,50,0.11,118.78,17,33,12,13,14,0
5,0,0,3,1,3,15,30.72,25.5,19978.47,0.26,154,0.04,1109.91,51,103,17,17,15,0
7,0,0,4,1,4,9,17.8,12.28,2682.84,0.07,49,0.08,149.05,17,32,9,13,9,0
3,0,0,2,1,1,5,16.21,4.2,286.08,0.02,19,0.24,15.89,6,13,5,7,5,0
5,0,0,3,3,1,13,14.28,9.33,1243.74,0.04,35,0.11,69.1,14,21,6,8,13,0
7,0,0,4,1,1,26,47.13,21.56,21902.46,0.34,185,0.05,1216.8,59,126,26,19,26,0
9,0,0,5,2,1,18,15.61,23.18,8390.28,0.12,77,0.04,466.13,34,43,11,15,18,0
11,0,0,6,2,5,23,18.18,25.38,11715.15,0.15,96,0.04,650.84,44,52,13,15,23,0
24,10,1,16,5,1,64,36.82,82.8,252471.13,1.02,488,0.01,14026.17,194,294,41,35,74,0
5,1,4,3,3,1,12,20.12,11.08,2469.1,0.07,48,0.09,137.17,24,24,13,12,13,0
25,0,6,13,7,1,40,56.42,19.13,20637.49,0.36,185,0.05,1146.53,90,95,40,17,40,1
32,1,2,21,15,4,93,55.18,32,56505.09,0.59,272,0.03,3139.17,116,156,58,32,94,1
9,4,3,5,4,1,11,30.6,10.95,3667.37,0.11,67,0.09,203.74,32,35,19,13,15,1
9,0,0,5,2,5,13,16.54,12.36,2527.87,0.07,43,0.08,140.44,17,26,11,16,13,0
3,0,0,2,2,1,6,17.47,5.14,462.13,0.03,23,0.19,25.67,9,14,7,8,6,0
5,0,0,3,3,1,12,24.82,7.86,1532.47,0.07,42,0.13,85.14,20,22,14,11,12,0
5,0,1,3,1,1,9,18.27,7.33,982.52,0.04,31,0.14,54.58,12,19,9,11,9,0
8,0,0,5,5,1,51,56.46,14.34,11613.3,0.27,136,0.07,645.18,56,80,41,21,51,1
41,14,24,21,12,6,102,147.44,19.65,56922.69,0.97,418,0.05,3162.37,189,229,101,21,116,1
8,2,4,6,2,1,36,53.33,15.98,13611.71,0.28,142,0.06,756.21,61,81,42,22,38,0
27,1,1,15,8,7,65,44.88,33.62,50731.38,0.5,233,0.03,2818.41,99,134,53,36,66,1
5,2,8,3,2,1,10,15.75,12.35,2402.24,0.06,43,0.08,133.46,19,24,10,13,12,0
13,3,15,7,7,1,38,49.36,14.73,10712.03,0.24,134,0.07,595.11,55,79,28,15,41,0
57,0,4,33,11,10,165,160.17,29.21,136707.89,1.56,636,0.03,7594.88,272,364,135,29,165,1
3,0,0,2,1,1,9,10.53,13.2,1834.45,0.05,34,0.08,101.91,11,23,5,12,9,0
3,2,0,2,2,1,8,24.6,7.5,1383.58,0.06,42,0.13,76.87,20,22,12,9,10,0
3,0,0,2,1,1,4,12.44,9,1008,0.04,28,0.11,56,14,14,7,9,4,0
3,0,0,2,1,1,4,11.42,7.33,614.25,0.03,22,0.14,34.13,11,11,6,8,4,0
3,0,0,2,1,1,4,12.44,7.71,740.57,0.03,24,0.13,41.14,12,12,7,9,4,0
3,0,0,2,1,1,6,11.53,11.25,1458.65,0.04,30,0.09,81.04,15,15,8,12,6,0
3,0,0,2,1,1,4,12.44,9,1008,0.04,28,0.11,56,14,14,7,9,4,0
3,0,0,2,1,1,4,12.44,9,1008,0.04,28,0.11,56,14,14,7,9,4,0
3,0,0,2,1,1,4,11.42,7.33,614.25,0.03,22,0.14,34.13,11,11,6,8,4,0
3,0,0,2,1,1,4,12.44,7.71,740.57,0.03,24,0.13,41.14,12,12,7,9,4,0
3,0,0,2,1,1,6,11.53,11.25,1458.65,0.04,30,0.09,81.04,15,15,8,12,6,0
3,0,0,2,1,1,4,12.44,9,1008,0.04,28,0.11,56,14,14,7,9,4,0
5,1,0,3,3,1,21,41.65,8.64,3111.43,0.12,72,0.12,172.86,33,39,21,11,22,0
5,0,6,3,1,1,13,16.82,11.11,2076.76,0.06,44,0.09,115.38,20,24,9,10,13,0
69,0,0,35,11,19,65,70.75,49.5,173359.85,1.17,526,0.02,9631.1,204,322,68,33,65,0
71,42,24,36,17,1,102,83.06,87.53,636348.83,2.42,1070,0.01,35352.71,495,575,82,29,144,0
3,3,3,2,1,1,7,14.49,36.4,19192.65,0.18,115,0.03,1066.26,52,63,10,14,10,0
71,42,24,36,17,1,99,79.48,89.75,640223.79,2.38,1056,0.01,35567.99,489,567,79,29,141,0
7,2,7,4,2,1,26,27.15,19.13,9929.59,0.17,108,0.05,551.64,51,57,16,12,28,0
20,2,2,12,5,1,43,47.52,28.6,38870.09,0.45,221,0.03,2159.45,99,122,45,26,45,0
11,0,3,6,4,4,24,29.2,19.5,11102.33,0.19,111,0.05,616.8,52,59,20,15,24,0
3,0,1,2,2,1,7,17.79,5.63,562.94,0.03,24,0.18,31.27,9,15,8,10,7,0
3,0,0,2,2,1,13,44.01,5.85,1506.22,0.09,53,0.17,83.68,26,27,20,9,13,0
3,0,0,2,2,1,10,16.18,6.43,668.57,0.03,26,0.16,37.14,10,16,7,9,10,0
5,0,3,3,3,1,11,33.36,3.5,408.65,0.04,28,0.29,22.7,11,17,11,7,11,0
5,0,0,3,3,1,18,35.13,12.41,5410.23,0.15,85,0.08,300.57,42,43,22,13,18,0
17,0,0,13,12,1,56,36.39,41.23,61862.5,0.5,253,0.02,3436.81,111,142,35,26,56,0
21,8,19,11,8,1,52,100.29,13.93,19463.42,0.47,225,0.07,1081.3,101,124,58,16,60,0
3,0,0,2,2,1,11,21.78,5.85,745.51,0.04,30,0.17,41.42,13,17,10,9,11,0
3,0,0,2,2,1,6,9.88,5.25,272.43,0.02,15,0.19,15.14,6,9,4,7,6,0
3,0,0,2,1,1,6,14.36,5.71,468.83,0.03,21,0.18,26.05,10,11,7,8,6,0
5,2,4,3,2,1,36,85.25,13,14407.24,0.37,190,0.08,800.4,88,102,44,13,38,0
5,0,0,3,2,1,14,22.19,8.88,1751.63,0.07,43,0.11,97.31,21,22,13,11,14,0
3,0,0,2,1,1,12,22.73,11.5,3005.44,0.09,57,0.09,166.97,23,34,12,12,12,0
42,4,10,26,20,11,139,120.55,35.67,153359.58,1.43,583,0.03,8519.98,267,316,131,35,143,1
7,1,0,4,2,1,13,17.95,16.69,5000.31,0.1,63,0.06,277.8,31,32,13,14,14,1
3,0,0,2,1,1,6,7.4,9,599.47,0.02,18,0.11,33.3,8,10,4,9,6,0
3,0,1,2,2,1,13,22.46,15,5053.28,0.11,68,0.07,280.74,32,36,16,15,13,0
17,1,17,9,5,8,39,64.34,23.87,36663.65,0.51,256,0.04,2036.87,122,134,46,18,40,0
3,0,0,2,1,1,5,10.75,4,172.08,0.01,12,0.25,9.56,4,8,4,8,5,0
3,0,9,2,1,1,8,14.33,7.86,884.62,0.04,27,0.13,49.15,10,17,7,11,8,0
7,0,0,4,3,1,26,37.65,18.96,13530.91,0.24,136,0.05,751.72,65,71,24,14,26,0
12,3,0,7,2,5,14,30.54,11.43,3988.95,0.12,67,0.09,221.61,30,37,21,16,17,0
3,0,0,2,2,1,6,14.51,4.2,255.97,0.02,17,0.24,14.22,6,11,5,7,6,0
26,4,1,14,5,9,38,39.75,37.71,56535.7,0.5,257,0.03,3140.87,120,137,35,22,42,1
3,4,4,2,1,1,6,33.71,13.2,5874,0.15,89,0.08,326.33,44,45,20,12,10,0
10,1,4,6,5,1,28,38.67,25.92,25983.73,0.33,175,0.04,1443.54,79,96,32,21,29,0
9,4,0,6,4,3,31,42.06,21.68,19763.62,0.3,157,0.05,1097.98,67,90,34,22,35,1
3,5,9,2,1,1,8,13.69,16.61,3777.88,0.08,51,0.06,209.88,23,28,9,13,13,0
7,0,0,4,2,1,12,27.54,9.9,2698.99,0.09,58,0.1,149.94,27,31,15,11,12,0
3,0,0,2,2,1,5,19.1,5.78,637.64,0.04,27,0.17,35.42,13,14,9,8,5,0
7,1,4,4,3,1,12,40.37,13,6822.31,0.17,100,0.08,379.02,50,50,25,13,13,0
24,4,5,15,13,8,82,83.81,33,91264.07,0.92,404,0.03,5070.23,187,217,85,30,86,1
11,1,1,6,1,5,12,8.39,32.79,9019.28,0.09,60,0.03,501.07,27,33,7,17,13,0
3,1,0,2,2,1,16,31.55,14,6184.08,0.15,83,0.07,343.56,42,41,24,16,17,0
5,1,0,3,2,3,23,48.96,17.75,15426.54,0.29,149,0.06,857.03,71,78,38,19,24,1
3,0,19,2,1,1,24,53.7,16.1,13923.65,0.29,154,0.06,773.54,73,81,34,15,24,0
3,0,0,2,1,1,15,42.25,11.18,5280.46,0.16,90,0.09,293.36,43,47,25,13,15,0
7,2,0,4,1,3,8,12.44,13.22,2175.26,0.05,35,0.08,120.85,14,21,9,17,10,0
5,1,7,3,3,1,14,43.72,7.5,2459.14,0.11,65,0.13,136.62,30,35,22,11,15,0
3,1,39,2,1,1,51,107.8,23.13,57647.66,0.83,384,0.04,3202.65,185,199,72,18,52,1
3,0,0,2,1,1,5,7.24,16.88,2060.67,0.04,33,0.06,114.48,15,18,4,9,5,0
5,0,8,3,1,1,21,42.17,14.7,9112.98,0.21,111,0.07,506.28,49,62,30,18,21,0
1,0,4,1,1,1,8,13.96,6,502.57,0.03,22,0.17,27.92,9,13,6,8,8,0
11,0,58,6,2,1,52,54.14,19.23,20023.61,0.35,177,0.05,1112.42,75,102,39,20,52,1
11,0,14,6,1,1,29,42.97,21.15,19213.78,0.3,161,0.05,1067.43,69,92,31,19,29,0
7,1,1,4,1,3,13,22.43,10.08,2280.63,0.08,50,0.1,126.7,22,28,12,11,14,0
25,3,23,13,9,4,95,107.69,33.74,122594.69,1.21,515,0.03,6810.82,242,273,104,29,98,0
7,0,0,4,1,1,18,40.01,5.5,1210.43,0.07,48,0.18,67.25,22,26,16,8,18,0
9,1,0,5,2,1,24,26.39,18.43,8961.02,0.16,92,0.05,497.83,43,49,21,18,25,0
3,0,0,2,2,1,10,28.55,8,1827.2,0.08,52,0.13,101.51,26,26,13,8,10,0
13,1,2,7,1,1,10,13.06,19.83,5137.44,0.09,70,0.05,285.41,34,36,6,7,11,0
19,3,13,10,4,1,49,61.44,21.27,27799.05,0.44,217,0.05,1544.39,103,114,46,19,52,1
17,0,8,9,7,5,37,58.68,10.09,5972.3,0.2,106,0.1,331.79,49,57,34,14,37,0
5,3,1,3,1,1,20,43.19,11.18,5397.81,0.16,92,0.09,299.88,43,49,25,13,23,0
3,0,0,2,1,1,3,5,6,180,0.01,10,0.17,10,4,6,2,6,3,0
3,0,0,2,1,1,9,35.77,7,1752.53,0.08,57,0.14,97.36,28,29,14,7,9,0
3,0,0,2,1,1,9,35.77,7,1752.53,0.08,57,0.14,97.36,28,29,14,7,9,0
7,2,7,4,2,1,35,58.21,21.95,28043.45,0.43,221,0.05,1557.97,107,114,39,16,37,0
3,0,0,2,1,1,20,54.2,22,26232.24,0.4,243,0.05,1457.35,121,122,22,8,20,0
3,0,0,2,1,1,8,16.35,11.5,2162,0.06,47,0.09,120.11,23,24,8,8,8,0
3,0,0,2,1,1,8,16.35,11.5,2162,0.06,47,0.09,120.11,23,24,8,8,8,0
3,0,0,2,1,1,7,11.76,11.33,1510.25,0.04,35,0.09,83.9,17,18,6,8,7,0
3,0,0,2,2,1,6,11.15,9.17,936.71,0.03,25,0.11,52.04,10,15,6,11,6,0