BRANCH_COUNT,LOC_CODE_AND_COMMENT,LOC_COMMENTS,CYCLOMATIC_COMPLEXITY,DESIGN_COMPLEXITY,ESSENTIAL_COMPLEXITY,LOC_EXECUTABLE,HALSTEAD_CONTENT,HALSTEAD_DIFFICULTY,HALSTEAD_EFFORT,HALSTEAD_ERROR_EST,HALSTEAD_LENGTH,HALSTEAD_LEVEL,HALSTEAD_PROG_TIME,NUM_OPERANDS,NUM_OPERATORS,NUM_UNIQUE_OPERANDS,NUM_UNIQUE_OPERATORS,LOC_TOTAL,Bugs
1,0,0,1,1,1,0,0,0,0,0,1,0,0,0,1,0,1,0,0
5,0,6,3,1,1,16,26.51,16.5,7218.24,0.15,91,0.06,401.01,33,58,14,14,16,0
1,0,3,1,1,1,6,16.4,7.07,820.29,0.04,29,0.14,45.57,11,18,7,9,6,0
1,0,0,1,1,1,3,11.65,4,186.42,0.02,13,0.25,10.36,4,9,4,8,3,0
25,18,9,13,1,9,50,22.12,57,71859.2,0.42,242,0.02,3992.18,108,134,18,19,68,0
25,16,8,13,1,9,52,22.12,57,71859.2,0.42,242,0.02,3992.18,108,134,18,19,68,0
21,5,0,11,1,7,28,9.09,37.4,12716,0.11,85,0.03,706.44,34,51,5,11,33,0
21,5,0,11,1,7,28,9.09,37.4,12716,0.11,85,0.03,706.44,34,51,5,11,33,0
21,5,0,11,1,7,28,9.09,37.4,12716,0.11,85,0.03,706.44,34,51,5,11,33,0
9,3,0,5,5,4,4,6.95,27.62,5307.06,0.06,47,0.04,294.84,17,30,4,13,7,0
1,0,0,1,1,1,2,13.18,5.25,363.24,0.02,20,0.19,20.18,6,14,4,7,2,0
1,0,0,1,1,1,2,5.33,1.5,12,0,4,0.67,0.67,1,3,1,3,2,0
1,0,0,1,1,1,2,5.33,1.5,12,0,4,0.67,0.67,1,3,1,3,2,0
1,0,0,1,1,1,2,5.33,1.5,12,0,4,0.67,0.67,1,3,1,3,2,0
1,0,0,1,1,1,2,11.3,6.13,423.78,0.02,20,0.16,23.54,7,13,4,7,2,0
1,0,0,1,1,1,2,7.74,1.5,17.41,0,5,0.67,0.97,2,3,2,3,2,0
1,0,0,1,1,1,2,7.74,1.5,17.41,0,5,0.67,0.97,2,3,2,3,2,0
1,0,0,1,1,1,2,7.74,1.5,17.41,0,5,0.67,0.97,2,3,2,3,2,0
1,0,0,1,1,1,0,0,0,0,0,1,0,0,0,1,0,1,0,0
1,0,0,1,1,1,0,0,0,0,0,1,0,0,0,1,0,1,0,0
9,3,0,5,5,4,4,6.95,27.62,5307.06,0.06,47,0.04,294.84,17,30,4,13,7,0
1,0,0,1,1,1,6,7.92,1,7.92,0,5,1,0.44,4,1,2,1,6,0
1,0,0,1,1,1,6,3.57,4,57.06,0,9,0.25,3.17,4,5,1,2,6,0
1,0,0,1,1,1,6,2.5,2,10,0,5,0.5,0.56,4,1,1,1,6,0
1,0,0,1,1,1,6,8.51,3,76.62,0.01,11,0.33,4.26,4,7,2,3,6,0
1,0,0,1,1,1,6,23.22,0.5,5.8,0,5,2,0.32,4,1,4,1,6,0
1,0,0,1,1,1,2,13.18,5.25,363.24,0.02,20,0.19,20.18,6,14,4,7,2,0
1,0,0,1,1,1,2,5.33,1.5,12,0,4,0.67,0.67,1,3,1,3,2,0
1,1,0,1,1,1,2,13.5,2,54,0.01,9,0.5,3,4,5,4,4,3,0
1,0,0,1,1,1,2,5.33,1.5,12,0,4,0.67,0.67,1,3,1,3,2,0
1,0,0,1,1,1,2,5.33,1.5,12,0,4,0.67,0.67,1,3,1,3,2,0
1,0,0,1,1,1,2,5.33,1.5,12,0,4,0.67,0.67,1,3,1,3,2,0
1,0,0,1,1,1,2,11.3,6.13,423.78,0.02,20,0.16,23.54,7,13,4,7,2,0
7,4,2,4,3,1,18,20.39,21.87,9749.86,0.15,90,0.05,541.66,41,49,15,16,22,0
7,0,0,4,4,1,5,16.93,9,1371.32,0.05,39,0.11,76.18,12,27,6,9,5,0
1,1,0,1,1,1,6,19.86,6.5,838.88,0.04,36,0.15,46.6,13,23,6,6,7,0
1,1,0,1,1,1,18,13.94,27.75,10733.21,0.13,99,0.04,596.29,37,62,6,9,19,0
1,1,3,1,1,1,7,5,27,3642.78,0.04,39,0.04,202.38,12,27,2,9,8,0
1,1,0,1,1,1,6,19.86,6.5,838.88,0.04,36,0.15,46.6,13,23,6,6,7,0
3,0,0,2,1,1,9,12.93,9.9,1267.2,0.04,32,0.1,70.4,9,23,5,11,9,0
7,0,0,4,4,1,5,14.75,8,944.22,0.04,31,0.13,52.46,12,19,6,8,5,0
7,2,2,4,2,1,45,35.53,29.11,30097.78,0.34,205,0.03,1672.1,79,126,19,14,47,0
1,0,0,1,1,1,5,26.94,2,107.78,0.02,17,0.5,5.99,8,9,6,3,5,0
1,0,0,1,1,1,2,7.74,1.5,17.41,0,5,0.67,0.97,2,3,2,3,2,0
1,0,0,1,1,1,4,16.05,3.75,225.86,0.02,19,0.27,12.55,6,13,4,5,4,0
1,0,0,1,1,1,2,7.74,1.5,17.41,0,5,0.67,0.97,2,3,2,3,2,0
1,0,0,1,1,1,2,7.74,1.5,17.41,0,5,0.67,0.97,2,3,2,3,2,0
1,0,0,1,1,1,2,7.74,1.5,17.41,0,5,0.67,0.97,2,3,2,3,2,0
1,2,2,1,1,1,15,17.64,23.25,9537.7,0.14,105,0.04,529.87,31,74,6,9,17,0
11,0,0,6,1,1,20,13.96,12,2010.28,0.06,44,0.08,111.68,18,26,6,8,20,0
17,3,3,9,3,8,30,15.55,36,20153.67,0.19,113,0.03,1119.65,52,61,13,18,33,0
21,3,5,11,3,10,31,19.87,31.5,19711.37,0.21,123,0.03,1095.08,56,67,16,18,34,0
15,2,2,8,1,6,21,15.56,19.2,5736.61,0.1,67,0.05,318.7,32,35,10,12,23,0
5,1,0,3,1,3,11,20.61,6.5,870.87,0.04,31,0.15,48.38,13,18,10,10,12,0
1,0,0,1,1,1,0,5.33,1.5,12,0,4,0.67,0.67,1,3,1,3,0,0
1,0,0,1,1,1,0,5.33,1.5,12,0,4,0.67,0.67,1,3,1,3,0,0
5,1,0,3,1,3,11,20.61,6.5,870.87,0.04,31,0.15,48.38,13,18,10,10,12,0
1,0,0,1,1,1,0,5.33,1.5,12,0,4,0.67,0.67,1,3,1,3,0,0
7,1,0,4,1,4,12,25.42,6.67,1129.72,0.06,38,0.15,62.76,16,22,12,10,13,0
7,2,0,4,2,1,12,15.57,6.42,641.1,0.03,27,0.16,35.62,11,16,6,7,14,0
5,1,1,3,1,3,11,23.04,5.91,804.59,0.05,31,0.17,44.7,13,18,11,10,12,0
5,1,1,3,1,3,11,23.04,5.91,804.59,0.05,31,0.17,44.7,13,18,11,10,12,0
5,1,1,3,2,3,10,18.52,8.27,1267.77,0.05,33,0.12,70.43,13,20,11,14,11,0
9,1,1,5,1,4,13,20.31,10.29,2150.69,0.07,45,0.1,119.48,19,26,12,13,14,0
7,1,0,4,1,1,8,22.78,6.36,922.39,0.05,33,0.16,51.24,14,19,11,10,9,0
19,4,11,10,2,7,28,31.21,30.6,29223.69,0.32,176,0.03,1623.54,85,91,25,18,32,0
19,5,12,10,2,7,46,32.89,32.59,34940.42,0.36,193,0.03,1941.13,88,105,27,20,51,0
1,0,0,1,1,1,0,0,0,0,0,1,0,0,0,1,0,1,0,0
1,0,0,1,1,1,0,0,0,0,0,1,0,0,0,1,0,1,0,0
9,3,0,5,5,4,4,6.95,27.62,5307.06,0.06,47,0.04,294.84,17,30,4,13,7,0
7,0,13,4,4,4,23,41.58,21.64,19463.36,0.3,174,0.05,1081.3,68,106,22,14,23,0
1,3,7,1,1,1,7,27.17,9.38,2388.32,0.08,58,0.11,132.68,25,33,12,9,10,0
1,6,8,1,1,1,16,38.03,18.56,13102.64,0.24,152,0.05,727.92,66,86,16,9,22,0
1,0,6,1,1,1,12,31.09,9.38,2732.13,0.1,62,0.11,151.79,30,32,16,10,12,0
1,1,5,1,1,1,11,31.2,6.68,1393.13,0.07,50,0.15,77.4,21,29,11,7,12,0
1,1,4,1,1,1,11,26.16,8.59,1930.72,0.07,52,0.12,107.26,21,31,11,9,12,0
1,0,0,1,1,1,2,13.18,5.25,363.24,0.02,20,0.19,20.18,6,14,4,7,2,0
1,0,0,1,1,1,2,5.33,1.5,12,0,4,0.67,0.67,1,3,1,3,2,0
1,0,0,1,1,1,2,5.33,1.5,12,0,4,0.67,0.67,1,3,1,3,2,0
1,0,0,1,1,1,2,5.33,1.5,12,0,4,0.67,0.67,1,3,1,3,2,0
1,0,0,1,1,1,2,11.3,6.13,423.78,0.02,20,0.16,23.54,7,13,4,7,2,0
1,0,0,1,1,1,2,7.74,1.5,17.41,0,5,0.67,0.97,2,3,2,3,2,0
1,0,0,1,1,1,2,7.74,1.5,17.41,0,5,0.67,0.97,2,3,2,3,2,0
1,0,0,1,1,1,2,7.74,1.5,17.41,0,5,0.67,0.97,2,3,2,3,2,0
1,0,0,1,1,1,0,0,0,0,0,1,0,0,0,1,0,1,0,0
1,0,0,1,1,1,0,0,0,0,0,1,0,0,0,1,0,1,0,0
9,3,0,5,5,4,4,6.95,27.62,5307.06,0.06,47,0.04,294.84,17,30,4,13,7,0
1,0,2,1,1,1,2,5.33,1.5,12,0,4,0.67,0.67,1,3,1,3,2,0
1,0,0,1,1,1,2,11.07,4.38,211.89,0.02,14,0.23,11.77,5,9,4,7,2,0
5,0,0,3,1,1,8,13.74,6,494.72,0.03,23,0.17,27.48,12,11,6,6,8,0
1,0,0,1,1,1,2,13.18,5.25,363.24,0.02,20,0.19,20.18,6,14,4,7,2,0
5,2,0,3,1,3,10,19.66,7,963.25,0.05,33,0.14,53.51,14,19,9,9,12,0
3,2,0,2,2,1,12,22.36,8.55,1634.39,0.06,45,0.12,90.8,19,26,10,9,14,0
1,0,0,1,1,1,2,5.33,1.5,12,0,4,0.67,0.67,1,3,1,3,2,0
1,0,0,1,1,1,2,5.33,1.5,12,0,4,0.67,0.67,1,3,1,3,2,0
1,0,0,1,1,1,2,5.33,1.5,12,0,4,0.67,0.67,1,3,1,3,2,0
1,0,0,1,1,1,2,11.3,6.13,423.78,0.02,20,0.16,23.54,7,13,4,7,2,0
1,1,0,1,1,1,11,14.59,30,13127.15,0.15,112,0.03,729.29,40,72,6,9,12,0
9,4,0,5,3,5,14,14.66,21.64,6864.9,0.11,66,0.05,381.38,28,38,11,17,18,0
5,1,0,3,1,1,9,13.14,11.57,1758.86,0.05,38,0.09,97.71,18,20,7,9,10,0
5,1,0,3,1,1,11,15.79,18.33,5308.77,0.1,67,0.05,294.93,30,37,9,11,12,0
1,1,0,1,1,1,11,14.59,30,13127.15,0.15,112,0.03,729.29,40,72,6,9,12,0
5,1,0,3,1,1,9,12.83,10.29,1357.71,0.04,33,0.1,75.43,16,17,7,9,10,0
7,1,0,4,1,1,12,12.86,14.78,2807.62,0.06,42,0.07,155.98,19,23,9,14,13,0
5,1,0,3,1,1,9,13.14,11.57,1758.86,0.05,38,0.09,97.71,18,20,7,9,10,0
3,0,0,2,2,1,6,10.48,9.75,996.32,0.03,25,0.1,55.35,6,19,4,13,6,0
9,4,0,5,3,5,14,15.76,19.09,5743.08,0.1,64,0.05,319.06,28,36,11,15,18,0
5,2,0,3,1,3,9,17.56,6.75,800.12,0.04,29,0.15,44.45,12,17,8,9,11,0
3,2,0,2,2,1,11,23.6,8.1,1548.37,0.06,45,0.12,86.02,18,27,10,9,13,0
3,1,0,2,1,1,5,10.34,10.83,1213.33,0.04,28,0.09,67.41,13,15,6,10,6,0
1,0,0,1,1,1,2,7.74,1.5,17.41,0,5,0.67,0.97,2,3,2,3,2,0
1,0,0,1,1,1,2,7.74,1.5,17.41,0,5,0.67,0.97,2,3,2,3,2,0
1,0,0,1,1,1,2,7.74,1.5,17.41,0,5,0.67,0.97,2,3,2,3,2,0
5,1,0,3,1,1,9,11.8,10,1180.28,0.04,31,0.1,65.57,15,16,6,8,10,0
3,1,0,2,1,1,7,8.51,8,544.91,0.02,19,0.13,30.27,8,11,4,8,8,0
5,0,0,3,1,1,2,13.29,4.5,269.08,0.02,18,0.22,14.95,6,12,4,6,2,0
3,0,0,2,1,1,9,13.29,3.75,186.86,0.02,15,0.27,10.38,5,10,4,6,9,0
1,0,1,1,1,1,2,16.92,3.5,207.22,0.02,16,0.29,11.51,6,10,6,7,2,0
1,0,0,1,1,1,0,0,0,0,0,1,0,0,0,1,0,1,0,0
9,3,0,5,5,4,4,6.95,27.62,5307.06,0.06,47,0.04,294.84,17,30,4,13,7,0
1,0,0,1,1,1,5,2.67,1.5,6,0,4,0.67,0.33,3,1,1,1,5,0
1,0,0,1,1,1,5,3.7,3,33.28,0,7,0.33,1.85,3,4,1,2,5,0
1,0,0,1,1,1,5,2.67,1.5,6,0,4,0.67,0.33,3,1,1,1,5,0
1,0,0,1,1,1,5,16,0.5,4,0,4,2,0.22,3,1,3,1,5,0
1,1,0,1,1,1,5,14.17,12.8,2320.92,0.06,49,0.08,128.94,16,33,5,8,6,0
1,0,0,1,1,1,2,13.18,5.25,363.24,0.02,20,0.19,20.18,6,14,4,7,2,0
1,0,0,1,1,1,2,5.33,1.5,12,0,4,0.67,0.67,1,3,1,3,2,0
1,0,0,1,1,1,2,5.33,1.5,12,0,4,0.67,0.67,1,3,1,3,2,0
1,0,0,1,1,1,2,5.33,1.5,12,0,4,0.67,0.67,1,3,1,3,2,0
1,0,0,1,1,1,2,11.3,6.13,423.78,0.02,20,0.16,23.54,7,13,4,7,2,0
1,1,0,1,1,1,5,16.14,6,581.18,0.03,28,0.17,32.29,10,18,5,6,6,0
1,1,0,1,1,1,5,14.41,6,518.9,0.03,25,0.17,28.83,10,15,5,6,6,0
3,1,0,2,1,1,14,13.97,14.93,3112.55,0.07,50,0.07,172.92,19,31,7,11,15,0
1,1,0,1,1,1,5,16.14,6,581.18,0.03,28,0.17,32.29,10,18,5,6,6,0
3,0,0,2,1,1,8,10.96,9.63,1015.3,0.04,27,0.1,56.41,7,20,4,11,8,0
1,0,0,1,1,1,2,7.74,1.5,17.41,0,5,0.67,0.97,2,3,2,3,2,0
1,0,0,1,1,1,2,7.74,1.5,17.41,0,5,0.67,0.97,2,3,2,3,2,0
1,0,0,1,1,1,2,7.74,1.5,17.41,0,5,0.67,0.97,2,3,2,3,2,0
3,1,0,2,1,1,15,16.05,13.75,3037.27,0.07,52,0.07,168.74,20,32,8,11,16,0
1,0,0,1,1,1,1,0,0,0,0,1,0,0,0,1,0,1,1,0
1,0,0,1,1,1,1,0,0,0,0,1,0,0,0,1,0,1,1,0
1,0,0,1,1,1,1,0,0,0,0,1,0,0,0,1,0,1,1,0
1,0,0,1,1,1,1,0,0,0,0,1,0,0,0,1,0,1,1,0
1,0,0,1,1,1,1,0,0,0,0,1,0,0,0,1,0,1,1,0
1,0,0,1,1,1,1,0,0,0,0,1,0,0,0,1,0,1,1,0
9,3,0,5,5,4,4,6.95,27.62,5307.06,0.06,47,0.04,294.84,17,30,4,13,7,0
1,0,0,1,1,1,0,0,0,0,0,1,0,0,0,1,0,1,0,0
1,0,5,1,1,1,37,29.44,16.8,8308.99,0.16,121,0.06,461.61,48,73,10,7,37,0
31,2,27,16,9,7,152,63.24,50.52,161387.41,1.06,569,0.02,8965.97,174,395,31,18,154,1
1,0,1,1,1,1,21,4.63,24,2667.68,0.04,43,0.04,148.2,24,19,2,4,21,0
13,2,12,7,1,3,35,29.66,21.71,13982.99,0.21,121,0.05,776.83,48,73,21,19,37,0
17,4,7,9,6,6,81,41.08,36.67,55223.87,0.5,283,0.03,3067.99,110,173,24,16,85,0
43,4,12,22,15,5,72,72.43,28.18,57499.72,0.68,358,0.04,3194.43,139,219,37,15,76,0
41,4,7,21,15,1,107,81.48,40,130367.47,1.09,569,0.03,7242.64,185,384,37,16,111,1
5,0,1,3,2,1,15,17.89,7.31,956.47,0.04,32,0.14,53.14,13,19,8,9,15,1
13,0,20,7,7,1,37,41.28,17.47,12598.1,0.24,150,0.06,699.89,54,96,17,11,37,1
85,1,158,44,18,29,826,319.49,64.72,1338364.88,6.89,2740,0.02,74353.6,923,1817,164,23,827,0
5,0,1,3,1,1,15,22.01,10,2200.78,0.07,48,0.1,122.27,20,28,12,12,15,0
1,0,0,1,1,1,0,0,0,0,0,1,0,0,0,1,0,1,0,0
1,0,0,1,1,1,2,0,0,0,0,3,0,0,0,3,0,3,2,0
1,0,0,1,1,1,2,0,0,0,0,3,0,0,0,3,0,3,2,0
1,0,0,1,1,1,2,0,0,0,0,3,0,0,0,3,0,3,2,0
1,0,0,1,1,1,2,0,0,0,0,3,0,0,0,3,0,3,2,0
1,0,0,1,1,1,2,0,0,0,0,3,0,0,0,3,0,3,2,0
1,0,0,1,1,1,2,0,0,0,0,3,0,0,0,3,0,3,2,0
1,0,0,1,1,1,2,0,0,0,0,3,0,0,0,3,0,3,2,0
1,0,0,1,1,1,2,0,0,0,0,3,0,0,0,3,0,3,2,0
1,0,0,1,1,1,2,0,0,0,0,3,0,0,0,3,0,3,2,0
1,0,0,1,1,1,2,0,0,0,0,3,0,0,0,3,0,3,2,0
1,0,0,1,1,1,2,0,0,0,0,3,0,0,0,3,0,3,2,0
1,0,0,1,1,1,3,11.63,2,46.53,0.01,9,0.5,2.58,4,5,3,3,3,0
1,0,0,1,1,1,0,5.33,1.5,12,0,4,0.67,0.67,1,3,1,3,0,0
1,0,0,1,1,1,0,5.33,1.5,12,0,4,0.67,0.67,1,3,1,3,0,0
1,0,0,1,1,1,0,5.33,1.5,12,0,4,0.67,0.67,1,3,1,3,0,0
1,0,0,1,1,1,2,0,0,0,0,3,0,0,0,3,0,3,2,0
1,0,0,1,1,1,2,5.33,1.5,12,0,4,0.67,0.67,1,3,1,3,2,0
1,0,0,1,1,1,2,0,0,0,0,3,0,0,0,3,0,3,2,0
1,0,0,1,1,1,2,0,0,0,0,3,0,0,0,3,0,3,2,0
1,0,0,1,1,1,2,0,0,0,0,3,0,0,0,3,0,3,2,0
1,0,0,1,1,1,2,0,0,0,0,3,0,0,0,3,0,3,2,0
1,0,0,1,1,1,2,0,0,0,0,3,0,0,0,3,0,3,2,0
1,0,0,1,1,1,2,0,0,0,0,3,0,0,0,3,0,3,2,0
1,0,0,1,1,1,2,0,0,0,0,3,0,0,0,3,0,3,2,0
1,0,0,1,1,1,2,0,0,0,0,3,0,0,0,3,0,3,2,0
1,0,0,1,1,1,2,0,0,0,0,3,0,0,0,3,0,3,2,0
1,0,0,1,1,1,2,0,0,0,0,3,0,0,0,3,0,3,2,0
1,0,0,1,1,1,2,0,0,0,0,3,0,0,0,3,0,3,2,0
1,0,0,1,1,1,0,7.74,1.5,17.41,0,5,0.67,0.97,2,3,2,3,0,0
1,0,0,1,1,1,0,7.74,1.5,17.41,0,5,0.67,0.97,2,3,2,3,0,0
1,0,0,1,1,1,0,0,0,0,0,3,0,0,0,3,0,3,0,0
1,0,0,1,1,1,0,5.33,1.5,12,0,4,0.67,0.67,1,3,1,3,0,0
1,0,0,1,1,1,2,0,0,0,0,3,0,0,0,3,0,3,2,0
1,0,0,1,1,1,2,0,0,0,0,3,0,0,0,3,0,3,2,0
1,0,0,1,1,1,2,0,0,0,0,3,0,0,0,3,0,3,2,0
1,0,0,1,1,1,2,0,0,0,0,3,0,0,0,3,0,3,2,0
1,0,0,1,1,1,2,0,0,0,0,3,0,0,0,3,0,3,2,0
1,0,0,1,1,1,2,0,0,0,0,3,0,0,0,3,0,3,2,0
1,0,0,1,1,1,2,0,0,0,0,3,0,0,0,3,0,3,2,0
1,0,0,1,1,1,2,0,0,0,0,3,0,0,0,3,0,3,2,0
1,0,0,1,1,1,2,0,0,0,0,3,0,0,0,3,0,3,2,0
1,0,0,1,1,1,2,0,0,0,0,3,0,0,0,3,0,3,2,0
1,0,0,1,1,1,2,0,0,0,0,3,0,0,0,3,0,3,2,0
5,0,5,3,1,1,7,13.32,13.71,2505.06,0.06,43,0.07,139.17,16,27,7,12,7,0
5,0,5,3,1,1,7,13.32,13.71,2505.06,0.06,43,0.07,139.17,16,27,7,12,7,0
1,0,0,1,1,1,0,0,0,0,0,1,0,0,0,1,0,1,0,0
9,2,1,8,1,1,27,34.09,9.88,3329.22,0.11,68,0.1,184.96,24,44,17,14,29,0
3,0,1,2,1,1,2,12.09,6.3,479.73,0.03,20,0.16,26.65,7,13,5,9,2,0
1,0,0,1,1,1,2,5.33,1.5,12,0,4,0.67,0.67,1,3,1,3,2,0
1,0,0,1,1,1,2,5.33,1.5,12,0,4,0.67,0.67,1,3,1,3,2,0
1,0,0,1,1,1,2,5.33,1.5,12,0,4,0.67,0.67,1,3,1,3,2,0
1,0,0,1,1,1,2,5.33,1.5,12,0,4,0.67,0.67,1,3,1,3,2,0
1,0,0,1,1,1,2,5.33,1.5,12,0,4,0.67,0.67,1,3,1,3,2,0
1,0,0,1,1,1,2,5.33,1.5,12,0,4,0.67,0.67,1,3,1,3,2,0
1,0,0,1,1,1,2,5.33,1.5,12,0,4,0.67,0.67,1,3,1,3,2,0
1,0,0,1,1,1,2,5.33,1.5,12,0,4,0.67,0.67,1,3,1,3,2,0
1,0,0,1,1,1,2,5.33,1.5,12,0,4,0.67,0.67,1,3,1,3,2,0
1,0,0,1,1,1,2,0,0,0,0,4,0,0,0,4,0,4,2,0
1,0,0,1,1,1,1,0,0,0,0,1,0,0,0,1,0,1,1,0
1,0,0,1,1,1,2,0,0,0,0,5,0,0,0,5,0,5,2,0
11,1,4,6,1,1,21,13.86,22.5,7014.99,0.1,68,0.04,389.72,27,41,9,15,22,0
1,0,0,1,1,1,1,0,0,0,0,0,0,0,0,0,0,0,1,0
1,0,0,1,1,1,1,0,0,0,0,1,0,0,0,1,0,1,1,0
1,0,0,1,1,1,2,5.33,1.5,12,0,4,0.67,0.67,1,3,1,3,2,0
1,0,0,1,1,1,2,5.33,1.5,12,0,4,0.67,0.67,1,3,1,3,2,0
1,9,0,1,1,1,2,0,0,0,0,9,0,0,9,0,1,0,11,0
1,0,0,1,1,1,1,0,0,0,0,0,0,0,0,0,0,0,1,0
1,0,0,1,1,1,1,0,0,0,0,0,0,0,0,0,0,0,1,0
1,0,0,1,1,1,1,0,0,0,0,1,0,0,0,1,0,1,1,0
1,0,0,1,1,1,4,18.49,2.4,106.51,0.01,14,0.42,5.92,6,8,5,4,4,0
1,0,0,1,1,1,2,5.33,1.5,12,0,4,0.67,0.67,1,3,1,3,2,0
1,0,0,1,1,1,5,8.45,0.75,4.75,0,4,1.33,0.26,3,1,2,1,5,0
1,0,0,1,1,1,1,0,0,0,0,0,0,0,0,0,0,0,1,0
1,0,0,1,1,1,1,0,0,0,0,1,0,0,0,1,0,1,1,0
1,0,0,1,1,1,3,10.8,2.5,67.5,0.01,9,0.4,3.75,3,6,3,5,3,0
1,0,0,1,1,1,2,5.33,1.5,12,0,4,0.67,0.67,1,3,1,3,2,0
1,0,0,1,1,1,2,6.2,2.5,38.77,0.01,6,0.4,2.15,1,5,1,5,2,0
1,0,0,1,1,1,4,9.51,0.5,2.38,0,3,2,0.13,2,1,2,1,4,0
1,0,0,1,1,1,1,0,0,0,0,1,0,0,0,1,0,1,1,0
1,0,0,1,1,1,2,5.33,1.5,12,0,4,0.67,0.67,1,3,1,3,2,0
1,0,0,1,1,1,2,5.33,1.5,12,0,4,0.67,0.67,1,3,1,3,2,0
1,0,0,1,1,1,2,0,0,0,0,4,0,0,0,4,0,4,2,0
1,0,0,1,1,1,1,0,0,0,0,1,0,0,0,1,0,1,1,0
1,0,0,1,1,1,2,0,0,0,0,5,0,0,0,5,0,5,2,0
1,0,0,1,1,1,1,0,0,0,0,1,0,0,0,1,0,1,1,0
1,0,0,1,1,1,2,5.33,1.5,12,0,4,0.67,0.67,1,3,1,3,2,0
1,0,0,1,1,1,2,5.33,1.5,12,0,4,0.67,0.67,1,3,1,3,2,0
1,0,0,1,1,1,1,0,0,0,0,1,0,0,0,1,0,1,1,0
1,0,0,1,1,1,2,7.86,2.5,49.13,0.01,7,0.4,2.73,2,5,2,5,2,0
1,0,0,1,1,1,2,7.49,3,67.38,0.01,8,0.33,3.74,1,7,1,6,2,0
1,0,0,1,1,1,2,7.49,3,67.38,0.01,8,0.33,3.74,1,7,1,6,2,0
1,0,0,1,1,1,2,7.49,3,67.38,0.01,8,0.33,3.74,1,7,1,6,2,0
1,0,0,1,1,1,2,7.49,3,67.38,0.01,8,0.33,3.74,1,7,1,6,2,0
1,0,0,1,1,1,2,7.49,3,67.38,0.01,8,0.33,3.74,1,7,1,6,2,0
1,0,0,1,1,1,2,7.49,3,67.38,0.01,8,0.33,3.74,1,7,1,6,2,0
1,0,0,1,1,1,2,7.49,3,67.38,0.01,8,0.33,3.74,1,7,1,6,2,0
1,0,0,1,1,1,2,10.57,3,95.1,0.01,10,0.33,5.28,3,7,3,6,2,0
1,0,0,1,1,1,0,0,0,0,0,1,0,0,0,1,0,1,0,0
1,0,0,1,1,1,2,5.33,1.5,12,0,4,0.67,0.67,1,3,1,3,2,0
1,0,0,1,1,1,2,5.33,1.5,12,0,4,0.67,0.67,1,3,1,3,2,0
1,0,0,1,1,1,2,5.33,1.5,12,0,4,0.67,0.67,1,3,1,3,2,0
1,0,0,1,1,1,2,5.33,1.5,12,0,4,0.67,0.67,1,3,1,3,2,0
1,0,0,1,1,1,2,5.33,1.5,12,0,4,0.67,0.67,1,3,1,3,2,0
1,0,0,1,1,1,2,5.33,1.5,12,0,4,0.67,0.67,1,3,1,3,2,0
1,0,0,1,1,1,2,5.33,1.5,12,0,4,0.67,0.67,1,3,1,3,2,0
1,0,0,1,1,1,2,13.95,2.5,87.17,0.01,11,0.4,4.84,4,7,4,5,2,0
1,0,0,1,1,1,1,0,0,0,0,1,0,0,0,1,0,1,1,0
1,0,0,1,1,1,1,0,0,0,0,1,0,0,0,1,0,1,1,0
1,0,0,1,1,1,1,0,0,0,0,1,0,0,0,1,0,1,1,0
1,0,0,1,1,1,1,0,0,0,0,1,0,0,0,1,0,1,1,0
1,0,0,1,1,1,1,0,0,0,0,1,0,0,0,1,0,1,1,0
1,0,0,1,1,1,1,0,0,0,0,1,0,0,0,1,0,1,1,0
1,0,0,1,1,1,0,0,0,0,0,1,0,0,0,1,0,1,0,0
1,0,0,1,1,1,0,0,0,0,0,1,0,0,0,1,0,1,0,0
37,11,28,19,17,1,183,101.25,35.75,129435.43,1.21,583,0.03,7190.86,207,376,55,19,194,1
3,2,2,2,1,1,7,15.36,5.6,481.82,0.03,24,0.18,26.77,8,16,5,7,9,0
17,0,19,9,6,1,84,54.89,29.67,48312.46,0.54,306,0.03,2684.03,89,217,24,16,84,0
1,0,0,1,1,1,12,2.2,5,55,0,11,0.2,3.06,10,1,1,1,12,0
3,1,0,2,1,1,13,17.54,14.18,3528.38,0.08,55,0.07,196.02,26,29,11,12,14,0
3,2,2,2,2,1,46,31.18,24.12,18133.17,0.25,164,0.04,1007.4,57,107,13,11,48,0
3,0,0,2,1,1,17,30.64,8.18,2050.94,0.08,58,0.12,113.94,20,38,11,9,17,0
5,0,4,3,3,1,37,42.02,14.54,8882.16,0.2,137,0.07,493.45,42,95,13,9,37,0
7,1,0,4,2,3,15,14.41,13,2434.85,0.06,42,0.08,135.27,18,24,9,13,16,0
23,3,1,12,8,1,37,50.86,16.07,13151.58,0.27,157,0.06,730.64,67,90,25,12,40,0
3,0,0,2,2,1,8,24.92,5.45,741.46,0.05,32,0.18,41.19,15,17,11,8,8,0
17,2,14,9,6,1,36,42,16.71,11734.6,0.23,138,0.06,651.92,54,84,21,13,38,0
1,0,2,1,1,1,31,71.5,13.69,13394.76,0.33,194,0.07,744.15,73,121,24,9,31,0
60,2,28,31,14,19,492,261.7,41.64,453835.77,3.63,1520,0.02,25213.1,583,937,126,18,494,0
11,0,0,6,2,3,26,36.81,15.65,9017.36,0.19,109,0.06,500.96,45,64,23,16,26,0
11,0,0,6,2,1,21,32.63,16.76,9168.64,0.18,105,0.06,509.37,44,61,21,16,21,0
3,0,0,2,2,1,9,24.43,6.55,1046.69,0.05,37,0.15,58.15,16,21,11,9,9,0
3,0,0,2,2,1,10,27.98,6.75,1274.87,0.06,43,0.15,70.83,18,25,12,9,10,0
1,0,0,1,1,1,0,0,0,0,0,1,0,0,0,1,0,1,0,0
1,0,0,1,1,1,2,0,0,0,0,3,0,0,0,3,0,3,2,0
1,0,0,1,1,1,2,0,0,0,0,3,0,0,0,3,0,3,2,0
1,0,0,1,1,1,2,0,0,0,0,3,0,0,0,3,0,3,2,0
1,0,0,1,1,1,2,0,0,0,0,3,0,0,0,3,0,3,2,0
1,0,0,1,1,1,2,0,0,0,0,3,0,0,0,3,0,3,2,0
1,0,0,1,1,1,2,0,0,0,0,3,0,0,0,3,0,3,2,0
1,0,0,1,1,1,2,0,0,0,0,3,0,0,0,3,0,3,2,0
1,0,0,1,1,1,2,0,0,0,0,3,0,0,0,3,0,3,2,0
1,0,0,1,1,1,2,0,0,0,0,3,0,0,0,3,0,3,2,0
1,0,0,1,1,1,2,0,0,0,0,3,0,0,0,3,0,3,2,0
1,0,0,1,1,1,2,0,0,0,0,3,0,0,0,3,0,3,2,0
1,0,0,1,1,1,3,11.63,2,46.53,0.01,9,0.5,2.58,4,5,3,3,3,0
1,0,0,1,1,1,0,5.33,1.5,12,0,4,0.67,0.67,1,3,1,3,0,0
1,0,0,1,1,1,0,5.33,1.5,12,0,4,0.67,0.67,1,3,1,3,0,0
1,0,0,1,1,1,0,5.33,1.5,12,0,4,0.67,0.67,1,3,1,3,0,0
1,0,0,1,1,1,2,0,0,0,0,3,0,0,0,3,0,3,2,0
1,0,0,1,1,1,2,5.33,1.5,12,0,4,0.67,0.67,1,3,1,3,2,0
1,0,0,1,1,1,2,0,0,0,0,3,0,0,0,3,0,3,2,0
1,0,0,1,1,1,2,0,0,0,0,3,0,0,0,3,0,3,2,0
1,0,0,1,1,1,2,0,0,0,0,3,0,0,0,3,0,3,2,0
1,0,0,1,1,1,2,0,0,0,0,3,0,0,0,3,0,3,2,0
1,0,0,1,1,1,2,0,0,0,0,3,0,0,0,3,0,3,2,0
1,0,0,1,1,1,2,0,0,0,0,3,0,0,0,3,0,3,2,0
1,0,0,1,1,1,2,0,0,0,0,3,0,0,0,3,0,3,2,0
1,0,0,1,1,1,2,0,0,0,0,3,0,0,0,3,0,3,2,0
1,0,0,1,1,1,2,0,0,0,0,3,0,0,0,3,0,3,2,0
1,0,0,1,1,1,2,0,0,0,0,3,0,0,0,3,0,3,2,0
1,0,0,1,1,1,2,0,0,0,0,3,0,0,0,3,0,3,2,0
1,0,0,1,1,1,0,7.74,1.5,17.41,0,5,0.67,0.97,2,3,2,3,0,0
1,0,0,1,1,1,0,7.74,1.5,17.41,0,5,0.67,0.97,2,3,2,3,0,0
1,0,0,1,1,1,0,0,0,0,0,3,0,0,0,3,0,3,0,0
1,0,0,1,1,1,0,5.33,1.5,12,0,4,0.67,0.67,1,3,1,3,0,0
1,0,0,1,1,1,2,0,0,0,0,3,0,0,0,3,0,3,2,0
1,0,0,1,1,1,2,0,0,0,0,3,0,0,0,3,0,3,2,0
1,0,0,1,1,1,2,0,0,0,0,3,0,0,0,3,0,3,2,0
1,0,0,1,1,1,2,0,0,0,0,3,0,0,0,3,0,3,2,0
1,0,0,1,1,1,2,0,0,0,0,3,0,0,0,3,0,3,2,0
1,0,0,1,1,1,2,0,0,0,0,3,0,0,0,3,0,3,2,0
1,0,0,1,1,1,2,0,0,0,0,3,0,0,0,3,0,3,2,0
1,0,0,1,1,1,2,0,0,0,0,3,0,0,0,3,0,3,2,0
1,0,0,1,1,1,2,0,0,0,0,3,0,0,0,3,0,3,2,0
1,0,0,1,1,1,2,0,0,0,0,3,0,0,0,3,0,3,2,0
1,0,0,1,1,1,2,0,0,0,0,3,0,0,0,3,0,3,2,0
5,0,5,3,1,1,7,13.32,13.71,2505.06,0.06,43,0.07,139.17,16,27,7,12,7,0
5,0,5,3,1,1,7,13.32,13.71,2505.06,0.06,43,0.07,139.17,16,27,7,12,7,0
1,0,0,1,1,1,0,0,0,0,0,1,0,0,0,1,0,1,0,0
9,2,1,8,1,1,27,34.09,9.88,3329.22,0.11,68,0.1,184.96,24,44,17,14,29,0
3,0,1,2,1,1,2,12.09,6.3,479.73,0.03,20,0.16,26.65,7,13,5,9,2,0
1,0,0,1,1,1,2,5.33,1.5,12,0,4,0.67,0.67,1,3,1,3,2,0
1,0,0,1,1,1,2,5.33,1.5,12,0,4,0.67,0.67,1,3,1,3,2,0
1,0,0,1,1,1,2,5.33,1.5,12,0,4,0.67,0.67,1,3,1,3,2,0
1,0,0,1,1,1,2,5.33,1.5,12,0,4,0.67,0.67,1,3,1,3,2,0
1,0,0,1,1,1,2,5.33,1.5,12,0,4,0.67,0.67,1,3,1,3,2,0
1,0,0,1,1,1,2,5.33,1.5,12,0,4,0.67,0.67,1,3,1,3,2,0
1,0,0,1,1,1,2,5.33,1.5,12,0,4,0.67,0.67,1,3,1,3,2,0
1,0,0,1,1,1,2,5.33,1.5,12,0,4,0.67,0.67,1,3,1,3,2,0
1,0,0,1,1,1,2,5.33,1.5,12,0,4,0.67,0.67,1,3,1,3,2,0
1,0,0,1,1,1,2,0,0,0,0,4,0,0,0,4,0,4,2,0
1,0,0,1,1,1,1,0,0,0,0,1,0,0,0,1,0,1,1,0
1,0,0,1,1,1,2,0,0,0,0,5,0,0,0,5,0,5,2,0
11,1,4,6,1,1,21,13.86,22.5,7014.99,0.1,68,0.04,389.72,27,41,9,15,22,0
1,0,0,1,1,1,1,0,0,0,0,0,0,0,0,0,0,0,1,0
1,0,0,1,1,1,2,8,3,72,0.01,8,0.33,4,2,6,2,6,2,0
1,0,0,1,1,1,2,8,3,72,0.01,8,0.33,4,2,6,2,6,2,0
1,0,0,1,1,1,2,8,3,72,0.01,8,0.33,4,2,6,2,6,2,0
1,0,0,1,1,1,2,8,3,72,0.01,8,0.33,4,2,6,2,6,2,0
1,0,0,1,1,1,2,8,3,72,0.01,8,0.33,4,2,6,2,6,2,0
1,0,0,1,1,1,2,8,3,72,0.01,8,0.33,4,2,6,2,6,2,0
1,0,0,1,1,1,2,8,3,72,0.01,8,0.33,4,2,6,2,6,2,0
1,0,0,1,1,1,2,8,3,72,0.01,8,0.33,4,2,6,2,6,2,0
1,0,0,1,1,1,2,8,3,72,0.01,8,0.33,4,2,6,2,6,2,0
1,0,0,1,1,1,2,8,3,72,0.01,8,0.33,4,2,6,2,6,2,0
1,0,0,1,1,1,1,0,0,0,0,1,0,0,0,1,0,1,1,0
1,0,0,1,1,1,2,5.33,1.5,12,0,4,0.67,0.67,1,3,1,3,2,0
1,0,0,1,1,1,2,5.33,1.5,12,0,4,0.67,0.67,1,3,1,3,2,0
1,9,0,1,1,1,2,0,0,0,0,9,0,0,9,0,1,0,11,0
1,0,0,1,1,1,2,8,3,72,0.01,8,0.33,4,2,6,2,6,2,0
1,0,0,1,1,1,2,8,3,72,0.01,8,0.33,4,2,6,2,6,2,0
1,0,0,1,1,1,3,21.46,5.5,649.15,0.04,31,0.18,36.06,11,20,7,7,3,0
1,0,0,1,1,1,3,21.46,5.5,649.15,0.04,31,0.18,36.06,11,20,7,7,3,0
1,0,0,1,1,1,3,21.46,5.5,649.15,0.04,31,0.18,36.06,11,20,7,7,3,0
1,0,0,1,1,1,3,21.46,5.5,649.15,0.04,31,0.18,36.06,11,20,7,7,3,0
1,0,0,1,1,1,3,21.46,5.5,649.15,0.04,31,0.18,36.06,11,20,7,7,3,0
1,0,0,1,1,1,3,21.46,5.5,649.15,0.04,31,0.18,36.06,11,20,7,7,3,0
1,0,0,1,1,1,2,8,3,72,0.01,8,0.33,4,2,6,2,6,2,0
1,0,0,1,1,1,2,8,3,72,0.01,8,0.33,4,2,6,2,6,2,0
1,0,0,1,1,1,1,0,0,0,0,0,0,0,0,0,0,0,1,0
1,0,0,1,1,1,1,0,0,0,0,0,0,0,0,0,0,0,1,0
1,0,0,1,1,1,1,0,0,0,0,1,0,0,0,1,0,1,1,0
1,0,0,1,1,1,4,18.49,2.4,106.51,0.01,14,0.42,5.92,6,8,5,4,4,0
1,0,0,1,1,1,2,5.33,1.5,12,0,4,0.67,0.67,1,3,1,3,2,0
1,0,0,1,1,1,5,8.45,0.75,4.75,0,4,1.33,0.26,3,1,2,1,5,0
1,0,0,1,1,1,1,0,0,0,0,0,0,0,0,0,0,0,1,0
1,0,0,1,1,1,1,0,0,0,0,1,0,0,0,1,0,1,1,0
1,0,0,1,1,1,3,10.8,2.5,67.5,0.01,9,0.4,3.75,3,6,3,5,3,0
1,0,0,1,1,1,2,5.33,1.5,12,0,4,0.67,0.67,1,3,1,3,2,0
1,0,0,1,1,1,2,6.2,2.5,38.77,0.01,6,0.4,2.15,1,5,1,5,2,0
1,0,0,1,1,1,4,9.51,0.5,2.38,0,3,2,0.13,2,1,2,1,4,0
1,0,0,1,1,1,1,0,0,0,0,1,0,0,0,1,0,1,1,0
1,0,0,1,1,1,2,5.33,1.5,12,0,4,0.67,0.67,1,3,1,3,2,0
1,0,0,1,1,1,2,5.33,1.5,12,0,4,0.67,0.67,1,3,1,3,2,0
1,0,0,1,1,1,2,0,0,0,0,4,0,0,0,4,0,4,2,0
1,0,0,1,1,1,1,0,0,0,0,1,0,0,0,1,0,1,1,0
1,0,0,1,1,1,2,0,0,0,0,5,0,0,0,5,0,5,2,0
1,0,0,1,1,1,1,0,0,0,0,1,0,0,0,1,0,1,1,0
1,0,0,1,1,1,2,5.33,1.5,12,0,4,0.67,0.67,1,3,1,3,2,0
1,0,0,1,1,1,2,5.33,1.5,12,0,4,0.67,0.67,1,3,1,3,2,0
1,0,0,1,1,1,1,0,0,0,0,1,0,0,0,1,0,1,1,0
1,0,0,1,1,1,2,7.86,2.5,49.13,0.01,7,0.4,2.73,2,5,2,5,2,0
1,0,0,1,1,1,2,7.49,3,67.38,0.01,8,0.33,3.74,1,7,1,6,2,0
1,0,0,1,1,1,2,7.49,3,67.38,0.01,8,0.33,3.74,1,7,1,6,2,0
1,0,0,1,1,1,2,7.49,3,67.38,0.01,8,0.33,3.74,1,7,1,6,2,0
1,0,0,1,1,1,2,7.49,3,67.38,0.01,8,0.33,3.74,1,7,1,6,2,0
1,0,0,1,1,1,2,7.49,3,67.38,0.01,8,0.33,3.74,1,7,1,6,2,0
1,0,0,1,1,1,2,7.49,3,67.38,0.01,8,0.33,3.74,1,7,1,6,2,0
1,0,0,1,1,1,2,7.49,3,67.38,0.01,8,0.33,3.74,1,7,1,6,2,0
1,0,0,1,1,1,2,10.57,3,95.1,0.01,10,0.33,5.28,3,7,3,6,2,0
1,0,0,1,1,1,0,0,0,0,0,1,0,0,0,1,0,1,0,0
1,0,0,1,1,1,2,5.33,1.5,12,0,4,0.67,0.67,1,3,1,3,2,0
1,0,0,1,1,1,2,5.33,1.5,12,0,4,0.67,0.67,1,3,1,3,2,0
1,0,0,1,1,1,2,5.33,1.5,12,0,4,0.67,0.67,1,3,1,3,2,0
1,0,0,1,1,1,2,5.33,1.5,12,0,4,0.67,0.67,1,3,1,3,2,0
1,0,0,1,1,1,2,5.33,1.5,12,0,4,0.67,0.67,1,3,1,3,2,0
1,0,0,1,1,1,2,5.33,1.5,12,0,4,0.67,0.67,1,3,1,3,2,0
1,0,0,1,1,1,2,5.33,1.5,12,0,4,0.67,0.67,1,3,1,3,2,0
1,0,0,1,1,1,2,13.95,2.5,87.17,0.01,11,0.4,4.84,4,7,4,5,2,0
1,0,0,1,1,1,1,0,0,0,0,1,0,0,0,1,0,1,1,0
1,0,0,1,1,1,1,0,0,0,0,1,0,0,0,1,0,1,1,0
1,0,0,1,1,1,1,0,0,0,0,1,0,0,0,1,0,1,1,0
1,0,0,1,1,1,1,0,0,0,0,1,0,0,0,1,0,1,1,0
1,0,0,1,1,1,1,0,0,0,0,1,0,0,0,1,0,1,1,0
1,0,0,1,1,1,1,0,0,0,0,1,0,0,0,1,0,1,1,0
1,0,0,1,1,1,0,0,0,0,0,1,0,0,0,1,0,1,0,0
1,0,0,1,1,1,2,0,0,0,0,3,0,0,0,3,0,3,2,0
1,0,0,1,1,1,2,0,0,0,0,3,0,0,0,3,0,3,2,0
1,0,0,1,1,1,2,0,0,0,0,3,0,0,0,3,0,3,2,0
1,0,0,1,1,1,2,0,0,0,0,3,0,0,0,3,0,3,2,0
1,0,0,1,1,1,2,0,0,0,0,3,0,0,0,3,0,3,2,0
1,0,0,1,1,1,2,0,0,0,0,3,0,0,0,3,0,3,2,0
1,0,0,1,1,1,2,0,0,0,0,3,0,0,0,3,0,3,2,0
1,0,0,1,1,1,2,0,0,0,0,3,0,0,0,3,0,3,2,0
1,0,0,1,1,1,2,0,0,0,0,3,0,0,0,3,0,3,2,0
1,0,0,1,1,1,2,0,0,0,0,3,0,0,0,3,0,3,2,0
1,0,0,1,1,1,2,0,0,0,0,3,0,0,0,3,0,3,2,0
1,0,0,1,1,1,3,11.63,2,46.53,0.01,9,0.5,2.58,4,5,3,3,3,0
1,0,0,1,1,1,0,5.33,1.5,12,0,4,0.67,0.67,1,3,1,3,0,0
1,0,0,1,1,1,0,5.33,1.5,12,0,4,0.67,0.67,1,3,1,3,0,0
1,0,0,1,1,1,0,5.33,1.5,12,0,4,0.67,0.67,1,3,1,3,0,0
1,0,0,1,1,1,2,0,0,0,0,3,0,0,0,3,0,3,2,0
1,0,0,1,1,1,2,5.33,1.5,12,0,4,0.67,0.67,1,3,1,3,2,0
1,0,0,1,1,1,2,0,0,0,0,3,0,0,0,3,0,3,2,0
1,0,0,1,1,1,2,0,0,0,0,3,0,0,0,3,0,3,2,0
1,0,0,1,1,1,2,0,0,0,0,3,0,0,0,3,0,3,2,0
1,0,0,1,1,1,2,0,0,0,0,3,0,0,0,3,0,3,2,0
1,0,0,1,1,1,2,0,0,0,0,3,0,0,0,3,0,3,2,0
1,0,0,1,1,1,2,0,0,0,0,3,0,0,0,3,0,3,2,0
1,0,0,1,1,1,2,0,0,0,0,3,0,0,0,3,0,3,2,0
1,0,0,1,1,1,2,0,0,0,0,3,0,0,0,3,0,3,2,0
1,0,0,1,1,1,2,0,0,0,0,3,0,0,0,3,0,3,2,0
1,0,0,1,1,1,2,0,0,0,0,3,0,0,0,3,0,3,2,0
1,0,0,1,1,1,2,0,0,0,0,3,0,0,0,3,0,3,2,0
1,0,0,1,1,1,0,7.74,1.5,17.41,0,5,0.67,0.97,2,3,2,3,0,0
1,0,0,1,1,1,0,7.74,1.5,17.41,0,5,0.67,0.97,2,3,2,3,0,0
1,0,0,1,1,1,0,0,0,0,0,3,0,0,0,3,0,3,0,0
1,0,0,1,1,1,0,5.33,1.5,12,0,4,0.67,0.67,1,3,1,3,0,0
1,0,0,1,1,1,2,0,0,0,0,3,0,0,0,3,0,3,2,0
1,0,0,1,1,1,2,0,0,0,0,3,0,0,0,3,0,3,2,0
1,0,0,1,1,1,2,0,0,0,0,3,0,0,0,3,0,3,2,0
1,0,0,1,1,1,2,0,0,0,0,3,0,0,0,3,0,3,2,0
1,0,0,1,1,1,2,0,0,0,0,3,0,0,0,3,0,3,2,0
1,0,0,1,1,1,2,0,0,0,0,3,0,0,0,3,0,3,2,0
1,0,0,1,1,1,2,0,0,0,0,3,0,0,0,3,0,3,2,0
1,0,0,1,1,1,2,0,0,0,0,3,0,0,0,3,0,3,2,0
1,0,0,1,1,1,2,0,0,0,0,3,0,0,0,3,0,3,2,0
1,0,0,1,1,1,2,0,0,0,0,3,0,0,0,3,0,3,2,0
1,0,0,1,1,1,2,0,0,0,0,3,0,0,0,3,0,3,2,0
5,0,5,3,1,1,7,13.32,13.71,2505.06,0.06,43,0.07,139.17,16,27,7,12,7,0
5,0,5,3,1,1,7,13.32,13.71,2505.06,0.06,43,0.07,139.17,16,27,7,12,7,0
9,2,1,8,1,1,27,34.09,9.88,3329.22,0.11,68,0.1,184.96,24,44,17,14,29,0
1,0,0,1,1,1,1,0,0,0,0,1,0,0,0,1,0,1,1,0
41,27,245,21,10,16,525,70.58,161.26,1835405.27,3.79,1987,0.01,101966.96,683,1304,36,17,552,0
1,0,0,1,1,1,3,2.67,1.5,6,0,4,0.67,0.33,3,1,1,1,3,0
23,9,5,12,7,9,44,39.84,26.74,28485.98,0.36,203,0.04,1582.55,82,121,23,15,53,0
11,3,11,6,6,1,28,39.56,12.65,6329.73,0.17,101,0.08,351.65,46,55,20,11,31,0
1,0,4,1,1,1,6,17.05,9.33,1485.11,0.05,43,0.11,82.51,16,27,6,7,6,0
13,0,157,7,5,4,859,380.31,65.6,1636527.62,8.32,3420,0.02,90918.2,1242,2178,142,15,859,0
5,6,4,3,1,1,10,22.08,5,552.07,0.04,29,0.2,30.67,10,19,7,7,16,0
3,3,1,2,2,1,6,18.28,5,456.88,0.03,24,0.2,25.38,10,14,7,7,9,0
3,3,1,2,2,1,6,18.28,5,456.88,0.03,24,0.2,25.38,10,14,7,7,9,0
3,0,1,2,1,1,2,12.09,6.3,479.73,0.03,20,0.16,26.65,7,13,5,9,2,0
1,0,0,1,1,1,2,5.33,1.5,12,0,4,0.67,0.67,1,3,1,3,2,0
1,0,0,1,1,1,2,5.33,1.5,12,0,4,0.67,0.67,1,3,1,3,2,0
1,0,0,1,1,1,2,5.33,1.5,12,0,4,0.67,0.67,1,3,1,3,2,0
1,0,0,1,1,1,2,5.33,1.5,12,0,4,0.67,0.67,1,3,1,3,2,0
1,0,0,1,1,1,2,5.33,1.5,12,0,4,0.67,0.67,1,3,1,3,2,0
1,0,0,1,1,1,2,5.33,1.5,12,0,4,0.67,0.67,1,3,1,3,2,0
1,0,0,1,1,1,2,5.33,1.5,12,0,4,0.67,0.67,1,3,1,3,2,0
1,0,0,1,1,1,2,5.33,1.5,12,0,4,0.67,0.67,1,3,1,3,2,0
1,0,0,1,1,1,2,5.33,1.5,12,0,4,0.67,0.67,1,3,1,3,2,0
1,0,0,1,1,1,2,0,0,0,0,4,0,0,0,4,0,4,2,0
1,0,0,1,1,1,1,0,0,0,0,1,0,0,0,1,0,1,1,0
1,0,0,1,1,1,2,0,0,0,0,5,0,0,0,5,0,5,2,0
11,1,4,6,1,1,21,13.86,22.5,7014.99,0.1,68,0.04,389.72,27,41,9,15,22,0
1,0,0,1,1,1,1,0,0,0,0,0,0,0,0,0,0,0,1,0
1,0,0,1,1,1,1,0,0,0,0,1,0,0,0,1,0,1,1,0
1,0,0,1,1,1,2,5.33,1.5,12,0,4,0.67,0.67,1,3,1,3,2,0
1,0,0,1,1,1,2,5.33,1.5,12,0,4,0.67,0.67,1,3,1,3,2,0
1,9,0,1,1,1,2,0,0,0,0,9,0,0,9,0,1,0,11,0
1,0,0,1,1,1,1,0,0,0,0,0,0,0,0,0,0,0,1,0
1,0,0,1,1,1,1,0,0,0,0,0,0,0,0,0,0,0,1,0
1,0,0,1,1,1,1,0,0,0,0,1,0,0,0,1,0,1,1,0
1,0,0,1,1,1,4,18.49,2.4,106.51,0.01,14,0.42,5.92,6,8,5,4,4,0
1,0,0,1,1,1,2,5.33,1.5,12,0,4,0.67,0.67,1,3,1,3,2,0
1,0,0,1,1,1,5,8.45,0.75,4.75,0,4,1.33,0.26,3,1,2,1,5,0
1,0,0,1,1,1,1,0,0,0,0,0,0,0,0,0,0,0,1,0
1,0,0,1,1,1,1,0,0,0,0,1,0,0,0,1,0,1,1,0
1,0,0,1,1,1,3,10.8,2.5,67.5,0.01,9,0.4,3.75,3,6,3,5,3,0
1,0,0,1,1,1,2,5.33,1.5,12,0,4,0.67,0.67,1,3,1,3,2,0
1,0,0,1,1,1,2,6.2,2.5,38.77,0.01,6,0.4,2.15,1,5,1,5,2,0
1,0,0,1,1,1,4,9.51,0.5,2.38,0,3,2,0.13,2,1,2,1,4,0
1,0,0,1,1,1,1,0,0,0,0,1,0,0,0,1,0,1,1,0
1,0,0,1,1,1,2,5.33,1.5,12,0,4,0.67,0.67,1,3,1,3,2,0
1,0,0,1,1,1,2,5.33,1.5,12,0,4,0.67,0.67,1,3,1,3,2,0
1,0,0,1,1,1,2,0,0,0,0,4,0,0,0,4,0,4,2,0
1,0,0,1,1,1,1,0,0,0,0,1,0,0,0,1,0,1,1,0
1,0,0,1,1,1,2,0,0,0,0,5,0,0,0,5,0,5,2,0
1,0,0,1,1,1,1,0,0,0,0,1,0,0,0,1,0,1,1,0
1,0,0,1,1,1,2,5.33,1.5,12,0,4,0.67,0.67,1,3,1,3,2,0
1,0,0,1,1,1,2,5.33,1.5,12,0,4,0.67,0.67,1,3,1,3,2,0
1,0,0,1,1,1,1,0,0,0,0,1,0,0,0,1,0,1,1,0
1,0,0,1,1,1,1,0,0,0,0,1,0,0,0,1,0,1,1,0
1,0,0,1,1,1,1,0,0,0,0,1,0,0,0,1,0,1,1,0
1,0,0,1,1,1,1,0,0,0,0,1,0,0,0,1,0,1,1,0
1,0,0,1,1,1,1,0,0,0,0,1,0,0,0,1,0,1,1,0
1,0,0,1,1,1,0,0,0,0,0,1,0,0,0,1,0,1,0,0
13,2,8,7,1,1,27,18.69,26,12636.16,0.16,106,0.04,702.01,44,62,11,13,29,0
1,0,0,1,1,1,4,3,1,3,0,3,1,0.17,2,1,1,1,4,0
3,0,2,2,2,1,8,26.05,4.55,539.34,0.04,29,0.22,29.96,13,16,10,7,8,0
1,0,13,1,1,1,10,22.71,11.2,2848.89,0.08,61,0.09,158.27,28,33,10,8,10,0
9,1,5,5,4,3,41,44.34,24.5,26614.86,0.36,207,0.04,1478.6,84,123,24,14,42,0
3,0,0,2,2,1,7,19.48,4.81,451.25,0.03,24,0.21,25.07,11,13,8,7,7,0
1,0,0,1,1,1,0,0,0,0,0,1,0,0,0,1,0,1,0,0
1,0,0,1,1,1,2,0,0,0,0,3,0,0,0,3,0,3,2,0
1,0,0,1,1,1,2,0,0,0,0,3,0,0,0,3,0,3,2,0
1,0,0,1,1,1,2,0,0,0,0,3,0,0,0,3,0,3,2,0
1,0,0,1,1,1,2,0,0,0,0,3,0,0,0,3,0,3,2,0
1,0,0,1,1,1,2,0,0,0,0,3,0,0,0,3,0,3,2,0
1,0,0,1,1,1,2,0,0,0,0,3,0,0,0,3,0,3,2,0
1,0,0,1,1,1,2,0,0,0,0,3,0,0,0,3,0,3,2,0
1,0,0,1,1,1,2,0,0,0,0,3,0,0,0,3,0,3,2,0
1,0,0,1,1,1,2,0,0,0,0,3,0,0,0,3,0,3,2,0
1,0,0,1,1,1,2,0,0,0,0,3,0,0,0,3,0,3,2,0
1,0,0,1,1,1,2,0,0,0,0,3,0,0,0,3,0,3,2,0
1,0,0,1,1,1,3,11.63,2,46.53,0.01,9,0.5,2.58,4,5,3,3,3,0
1,0,0,1,1,1,0,5.33,1.5,12,0,4,0.67,0.67,1,3,1,3,0,0
1,0,0,1,1,1,0,5.33,1.5,12,0,4,0.67,0.67,1,3,1,3,0,0
1,0,0,1,1,1,0,5.33,1.5,12,0,4,0.67,0.67,1,3,1,3,0,0
1,0,0,1,1,1,2,0,0,0,0,3,0,0,0,3,0,3,2,0
1,0,0,1,1,1,2,5.33,1.5,12,0,4,0.67,0.67,1,3,1,3,2,0
1,0,0,1,1,1,2,0,0,0,0,3,0,0,0,3,0,3,2,0
1,0,0,1,1,1,2,0,0,0,0,3,0,0,0,3,0,3,2,0
1,0,0,1,1,1,2,0,0,0,0,3,0,0,0,3,0,3,2,0
1,0,0,1,1,1,2,0,0,0,0,3,0,0,0,3,0,3,2,0
1,0,0,1,1,1,2,0,0,0,0,3,0,0,0,3,0,3,2,0
1,0,0,1,1,1,2,0,0,0,0,3,0,0,0,3,0,3,2,0
1,0,0,1,1,1,2,0,0,0,0,3,0,0,0,3,0,3,2,0
1,0,0,1,1,1,2,0,0,0,0,3,0,0,0,3,0,3,2,0
1,0,0,1,1,1,2,0,0,0,0,3,0,0,0,3,0,3,2,0
1,0,0,1,1,1,2,0,0,0,0,3,0,0,0,3,0,3,2,0
1,0,0,1,1,1,2,0,0,0,0,3,0,0,0,3,0,3,2,0
1,0,0,1,1,1,0,7.74,1.5,17.41,0,5,0.67,0.97,2,3,2,3,0,0
1,0,0,1,1,1,0,7.74,1.5,17.41,0,5,0.67,0.97,2,3,2,3,0,0
1,0,0,1,1,1,0,0,0,0,0,3,0,0,0,3,0,3,0,0
1,0,0,1,1,1,0,5.33,1.5,12,0,4,0.67,0.67,1,3,1,3,0,0
1,0,0,1,1,1,2,0,0,0,0,3,0,0,0,3,0,3,2,0
1,0,0,1,1,1,2,0,0,0,0,3,0,0,0,3,0,3,2,0
1,0,0,1,1,1,2,0,0,0,0,3,0,0,0,3,0,3,2,0
1,0,0,1,1,1,2,0,0,0,0,3,0,0,0,3,0,3,2,0
1,0,0,1,1,1,2,0,0,0,0,3,0,0,0,3,0,3,2,0
1,0,0,1,1,1,2,0,0,0,0,3,0,0,0,3,0,3,2,0
1,0,0,1,1,1,2,0,0,0,0,3,0,0,0,3,0,3,2,0
1,0,0,1,1,1,2,0,0,0,0,3,0,0,0,3,0,3,2,0
1,0,0,1,1,1,2,0,0,0,0,3,0,0,0,3,0,3,2,0
1,0,0,1,1,1,2,0,0,0,0,3,0,0,0,3,0,3,2,0
1,0,0,1,1,1,2,0,0,0,0,3,0,0,0,3,0,3,2,0
1,0,0,1,1,1,2,5.33,1.5,12,0,4,0.67,0.67,1,3,1,3,2,0
1,0,0,1,1,1,2,5.33,1.5,12,0,4,0.67,0.67,1,3,1,3,2,0
1,0,0,1,1,1,2,5.33,1.5,12,0,4,0.67,0.67,1,3,1,3,2,0
1,0,0,1,1,1,2,5.33,1.5,12,0,4,0.67,0.67,1,3,1,3,2,0
1,0,0,1,1,1,2,5.33,1.5,12,0,4,0.67,0.67,1,3,1,3,2,0
1,0,0,1,1,1,2,5.33,1.5,12,0,4,0.67,0.67,1,3,1,3,2,0
1,0,0,1,1,1,2,5.33,1.5,12,0,4,0.67,0.67,1,3,1,3,2,0
1,0,0,1,1,1,1,0,0,0,0,0,0,0,0,0,0,0,1,0
1,0,0,1,1,1,1,0,0,0,0,1,0,0,0,1,0,1,1,0
1,0,0,1,1,1,2,5.33,1.5,12,0,4,0.67,0.67,1,3,1,3,2,0
1,0,0,1,1,1,2,5.33,1.5,12,0,4,0.67,0.67,1,3,1,3,2,0
1,9,0,1,1,1,2,0,0,0,0,9,0,0,9,0,1,0,11,0
1,0,0,1,1,1,1,0,0,0,0,0,0,0,0,0,0,0,1,0
1,0,0,1,1,1,1,0,0,0,0,0,0,0,0,0,0,0,1,0
1,0,0,1,1,1,1,0,0,0,0,1,0,0,0,1,0,1,1,0
1,0,0,1,1,1,4,18.49,2.4,106.51,0.01,14,0.42,5.92,6,8,5,4,4,0
1,0,0,1,1,1,2,5.33,1.5,12,0,4,0.67,0.67,1,3,1,3,2,0
1,0,0,1,1,1,5,8.45,0.75,4.75,0,4,1.33,0.26,3,1,2,1,5,0
1,0,0,1,1,1,1,0,0,0,0,0,0,0,0,0,0,0,1,0
1,0,0,1,1,1,1,0,0,0,0,1,0,0,0,1,0,1,1,0
1,0,0,1,1,1,3,10.8,2.5,67.5,0.01,9,0.4,3.75,3,6,3,5,3,0
1,0,0,1,1,1,2,5.33,1.5,12,0,4,0.67,0.67,1,3,1,3,2,0
1,0,0,1,1,1,2,6.2,2.5,38.77,0.01,6,0.4,2.15,1,5,1,5,2,0
1,0,0,1,1,1,4,9.51,0.5,2.38,0,3,2,0.13,2,1,2,1,4,0
1,0,0,1,1,1,1,0,0,0,0,1,0,0,0,1,0,1,1,0
1,0,0,1,1,1,2,7.86,2.5,49.13,0.01,7,0.4,2.73,2,5,2,5,2,0
1,0,0,1,1,1,2,7.49,3,67.38,0.01,8,0.33,3.74,1,7,1,6,2,0
1,0,0,1,1,1,2,7.49,3,67.38,0.01,8,0.33,3.74,1,7,1,6,2,0
1,0,0,1,1,1,2,7.49,3,67.38,0.01,8,0.33,3.74,1,7,1,6,2,0
1,0,0,1,1,1,2,7.49,3,67.38,0.01,8,0.33,3.74,1,7,1,6,2,0
1,0,0,1,1,1,2,7.49,3,67.38,0.01,8,0.33,3.74,1,7,1,6,2,0
1,0,0,1,1,1,2,7.49,3,67.38,0.01,8,0.33,3.74,1,7,1,6,2,0
1,0,0,1,1,1,2,7.49,3,67.38,0.01,8,0.33,3.74,1,7,1,6,2,0
1,0,0,1,1,1,2,10.57,3,95.1,0.01,10,0.33,5.28,3,7,3,6,2,0
1,0,0,1,1,1,0,0,0,0,0,1,0,0,0,1,0,1,0,0
1,0,0,1,1,1,2,5.33,1.5,12,0,4,0.67,0.67,1,3,1,3,2,0
1,0,0,1,1,1,2,5.33,1.5,12,0,4,0.67,0.67,1,3,1,3,2,0
1,0,0,1,1,1,2,5.33,1.5,12,0,4,0.67,0.67,1,3,1,3,2,0
1,0,0,1,1,1,2,5.33,1.5,12,0,4,0.67,0.67,1,3,1,3,2,0
1,0,0,1,1,1,2,5.33,1.5,12,0,4,0.67,0.67,1,3,1,3,2,0
1,0,0,1,1,1,2,5.33,1.5,12,0,4,0.67,0.67,1,3,1,3,2,0
1,0,0,1,1,1,2,5.33,1.5,12,0,4,0.67,0.67,1,3,1,3,2,0
1,0,0,1,1,1,2,13.95,2.5,87.17,0.01,11,0.4,4.84,4,7,4,5,2,0
1,0,0,1,1,1,1,0,0,0,0,1,0,0,0,1,0,1,1,0
1,0,0,1,1,1,1,0,0,0,0,1,0,0,0,1,0,1,1,0
1,0,0,1,1,1,1,0,0,0,0,1,0,0,0,1,0,1,1,0
1,0,0,1,1,1,1,0,0,0,0,1,0,0,0,1,0,1,1,0
1,0,0,1,1,1,1,0,0,0,0,1,0,0,0,1,0,1,1,0
1,0,0,1,1,1,1,0,0,0,0,1,0,0,0,1,0,1,1,0
1,0,0,1,1,1,1,0,0,0,0,1,0,0,0,1,0,1,1,0
5,0,79,3,2,3,311,40.03,134.59,725129.9,1.8,1098,0.01,40284.99,352,746,17,13,311,1
31,0,169,16,1,1,929,36.56,467.95,8005307.08,5.7,3309,0,444739.31,1046,2263,19,17,929,1
1,0,0,1,1,1,10,2.22,4.5,45,0,10,0.22,2.5,9,1,1,1,10,0
19,2,7,10,10,1,53,60.6,20.78,26171.33,0.42,228,0.05,1453.96,95,133,32,14,55,0
17,2,5,9,9,1,42,58.62,13.85,11238.62,0.27,157,0.07,624.37,72,85,26,10,44,0
1,0,0,1,1,1,14,55.33,10.4,5984.09,0.19,131,0.1,332.45,52,79,15,6,14,1
37,1,472,19,11,10,1706,1306.54,61.37,4921109.84,26.73,9456,0.02,273394.95,3248,6208,344,13,1707,0
1,0,0,1,1,1,0,0,0,0,0,1,0,0,0,1,0,1,0,0
1,0,0,1,1,1,2,0,0,0,0,3,0,0,0,3,0,3,2,0
1,0,0,1,1,1,2,0,0,0,0,3,0,0,0,3,0,3,2,0
1,0,0,1,1,1,2,0,0,0,0,3,0,0,0,3,0,3,2,0
1,0,0,1,1,1,2,0,0,0,0,3,0,0,0,3,0,3,2,0
1,0,0,1,1,1,2,0,0,0,0,3,0,0,0,3,0,3,2,0
1,0,0,1,1,1,2,0,0,0,0,3,0,0,0,3,0,3,2,0
1,0,0,1,1,1,2,0,0,0,0,3,0,0,0,3,0,3,2,0
1,0,0,1,1,1,2,0,0,0,0,3,0,0,0,3,0,3,2,0
1,0,0,1,1,1,2,0,0,0,0,3,0,0,0,3,0,3,2,0
1,0,0,1,1,1,2,0,0,0,0,3,0,0,0,3,0,3,2,0
1,0,0,1,1,1,2,0,0,0,0,3,0,0,0,3,0,3,2,0
1,0,0,1,1,1,3,11.63,2,46.53,0.01,9,0.5,2.58,4,5,3,3,3,0
1,0,0,1,1,1,0,5.33,1.5,12,0,4,0.67,0.67,1,3,1,3,0,0
1,0,0,1,1,1,0,5.33,1.5,12,0,4,0.67,0.67,1,3,1,3,0,0
1,0,0,1,1,1,0,5.33,1.5,12,0,4,0.67,0.67,1,3,1,3,0,0
1,0,0,1,1,1,2,0,0,0,0,3,0,0,0,3,0,3,2,0
1,0,0,1,1,1,2,5.33,1.5,12,0,4,0.67,0.67,1,3,1,3,2,0
1,0,0,1,1,1,2,0,0,0,0,3,0,0,0,3,0,3,2,0
1,0,0,1,1,1,2,0,0,0,0,3,0,0,0,3,0,3,2,0
1,0,0,1,1,1,2,0,0,0,0,3,0,0,0,3,0,3,2,0
1,0,0,1,1,1,2,0,0,0,0,3,0,0,0,3,0,3,2,0
1,0,0,1,1,1,2,0,0,0,0,3,0,0,0,3,0,3,2,0
1,0,0,1,1,1,2,0,0,0,0,3,0,0,0,3,0,3,2,0
1,0,0,1,1,1,2,0,0,0,0,3,0,0,0,3,0,3,2,0
1,0,0,1,1,1,2,0,0,0,0,3,0,0,0,3,0,3,2,0
1,0,0,1,1,1,2,0,0,0,0,3,0,0,0,3,0,3,2,0
1,0,0,1,1,1,2,0,0,0,0,3,0,0,0,3,0,3,2,0
1,0,0,1,1,1,2,0,0,0,0,3,0,0,0,3,0,3,2,0
1,0,0,1,1,1,0,7.74,1.5,17.41,0,5,0.67,0.97,2,3,2,3,0,0
1,0,0,1,1,1,0,7.74,1.5,17.41,0,5,0.67,0.97,2,3,2,3,0,0
1,0,0,1,1,1,0,0,0,0,0,3,0,0,0,3,0,3,0,0
1,0,0,1,1,1,0,5.33,1.5,12,0,4,0.67,0.67,1,3,1,3,0,0
1,0,0,1,1,1,2,0,0,0,0,3,0,0,0,3,0,3,2,0
1,0,0,1,1,1,2,0,0,0,0,3,0,0,0,3,0,3,2,0
1,0,0,1,1,1,2,0,0,0,0,3,0,0,0,3,0,3,2,0
1,0,0,1,1,1,2,0,0,0,0,3,0,0,0,3,0,3,2,0
1,0,0,1,1,1,2,0,0,0,0,3,0,0,0,3,0,3,2,0
1,0,0,1,1,1,2,0,0,0,0,3,0,0,0,3,0,3,2,0
1,0,0,1,1,1,2,0,0,0,0,3,0,0,0,3,0,3,2,0
1,0,0,1,1,1,2,0,0,0,0,3,0,0,0,3,0,3,2,0
1,0,0,1,1,1,2,0,0,0,0,3,0,0,0,3,0,3,2,0
1,0,0,1,1,1,2,0,0,0,0,3,0,0,0,3,0,3,2,0
1,0,0,1,1,1,2,0,0,0,0,3,0,0,0,3,0,3,2,0
5,0,5,3,1,1,7,13.32,13.71,2505.06,0.06,43,0.07,139.17,16,27,7,12,7,0
5,0,5,3,1,1,7,13.32,13.71,2505.06,0.06,43,0.07,139.17,16,27,7,12,7,0
9,2,1,8,1,1,27,34.09,9.88,3329.22,0.11,68,0.1,184.96,24,44,17,14,29,0
3,0,1,2,1,1,2,12.09,6.3,479.73,0.03,20,0.16,26.65,7,13,5,9,2,0
1,0,0,1,1,1,2,5.33,1.5,12,0,4,0.67,0.67,1,3,1,3,2,0
1,0,0,1,1,1,2,5.33,1.5,12,0,4,0.67,0.67,1,3,1,3,2,0
1,0,0,1,1,1,2,5.33,1.5,12,0,4,0.67,0.67,1,3,1,3,2,0
1,0,0,1,1,1,2,5.33,1.5,12,0,4,0.67,0.67,1,3,1,3,2,0
1,0,0,1,1,1,2,5.33,1.5,12,0,4,0.67,0.67,1,3,1,3,2,0
1,0,0,1,1,1,2,5.33,1.5,12,0,4,0.67,0.67,1,3,1,3,2,0
1,0,0,1,1,1,2,5.33,1.5,12,0,4,0.67,0.67,1,3,1,3,2,0
1,0,0,1,1,1,2,5.33,1.5,12,0,4,0.67,0.67,1,3,1,3,2,0
1,0,0,1,1,1,2,5.33,1.5,12,0,4,0.67,0.67,1,3,1,3,2,0
1,0,0,1,1,1,2,0,0,0,0,4,0,0,0,4,0,4,2,0
1,0,0,1,1,1,1,0,0,0,0,1,0,0,0,1,0,1,1,0
1,0,0,1,1,1,2,0,0,0,0,5,0,0,0,5,0,5,2,0
11,1,4,6,1,1,21,13.86,22.5,7014.99,0.1,68,0.04,389.72,27,41,9,15,22,0
1,0,0,1,1,1,1,0,0,0,0,0,0,0,0,0,0,0,1,0
1,0,0,1,1,1,1,0,0,0,0,1,0,0,0,1,0,1,1,0
1,0,0,1,1,1,2,5.33,1.5,12,0,4,0.67,0.67,1,3,1,3,2,0
1,0,0,1,1,1,2,5.33,1.5,12,0,4,0.67,0.67,1,3,1,3,2,0
1,9,0,1,1,1,2,0,0,0,0,9,0,0,9,0,1,0,11,0
1,0,0,1,1,1,1,0,0,0,0,0,0,0,0,0,0,0,1,0
1,0,0,1,1,1,1,0,0,0,0,0,0,0,0,0,0,0,1,0
1,0,0,1,1,1,1,0,0,0,0,1,0,0,0,1,0,1,1,0
1,0,0,1,1,1,4,18.49,2.4,106.51,0.01,14,0.42,5.92,6,8,5,4,4,0
1,0,0,1,1,1,2,5.33,1.5,12,0,4,0.67,0.67,1,3,1,3,2,0
1,0,0,1,1,1,5,8.45,0.75,4.75,0,4,1.33,0.26,3,1,2,1,5,0
1,0,0,1,1,1,1,0,0,0,0,0,0,0,0,0,0,0,1,0
1,0,0,1,1,1,1,0,0,0,0,1,0,0,0,1,0,1,1,0
1,0,0,1,1,1,3,10.8,2.5,67.5,0.01,9,0.4,3.75,3,6,3,5,3,0
1,0,0,1,1,1,2,5.33,1.5,12,0,4,0.67,0.67,1,3,1,3,2,0
1,0,0,1,1,1,2,6.2,2.5,38.77,0.01,6,0.4,2.15,1,5,1,5,2,0
1,0,0,1,1,1,4,9.51,0.5,2.38,0,3,2,0.13,2,1,2,1,4,0
1,0,0,1,1,1,1,0,0,0,0,1,0,0,0,1,0,1,1,0
1,0,0,1,1,1,2,5.33,1.5,12,0,4,0.67,0.67,1,3,1,3,2,0
1,0,0,1,1,1,2,5.33,1.5,12,0,4,0.67,0.67,1,3,1,3,2,0
1,0,0,1,1,1,2,0,0,0,0,4,0,0,0,4,0,4,2,0
1,0,0,1,1,1,1,0,0,0,0,1,0,0,0,1,0,1,1,0
1,0,0,1,1,1,2,0,0,0,0,5,0,0,0,5,0,5,2,0
1,0,0,1,1,1,1,0,0,0,0,1,0,0,0,1,0,1,1,0
1,0,0,1,1,1,2,5.33,1.5,12,0,4,0.67,0.67,1,3,1,3,2,0
1,0,0,1,1,1,2,5.33,1.5,12,0,4,0.67,0.67,1,3,1,3,2,0
1,0,0,1,1,1,1,0,0,0,0,1,0,0,0,1,0,1,1,0
1,0,0,1,1,1,1,0,0,0,0,1,0,0,0,1,0,1,1,0
1,0,0,1,1,1,1,0,0,0,0,1,0,0,0,1,0,1,1,0
1,0,0,1,1,1,1,0,0,0,0,1,0,0,0,1,0,1,1,0
1,0,0,1,1,1,1,0,0,0,0,1,0,0,0,1,0,1,1,0
1,0,0,1,1,1,1,0,0,0,0,1,0,0,0,1,0,1,1,0
1,0,0,1,1,1,1,0,0,0,0,1,0,0,0,1,0,1,1,0
1,0,0,1,1,1,1,0,0,0,0,1,0,0,0,1,0,1,1,0
223,14,125,112,18,78,723,75.37,243.43,4466096.06,6.12,2964,0,248116.46,994,1970,49,24,737,1
313,7,100,157,3,122,478,130.11,110.29,1582684.27,4.78,2216,0.01,87926.9,761,1455,69,20,485,1
49,3,0,25,1,24,50,28.77,33.6,32482.4,0.32,199,0.03,1804.58,72,127,15,14,53,1
1,0,0,1,1,1,15,2.14,7,105,0.01,15,0.14,5.83,14,1,1,1,15,0
29,2,9,15,15,1,74,76.81,23.45,42240.01,0.6,313,0.04,2346.67,134,179,40,14,76,0
41,2,7,21,12,4,67,80.38,22.58,40974.28,0.6,306,0.04,2276.35,127,179,45,16,69,0
1,0,1,1,1,1,19,59.92,14.2,12082.81,0.28,177,0.07,671.27,71,106,20,8,19,0
57,2,304,29,16,15,1180,912.14,46.06,1935011.87,14,5205,0.02,107500.66,1814,3391,256,13,1182,0
8,7,1,7,7,1,32,41.51,14.33,8528.29,0.2,116,0.07,473.79,43,73,21,14,39,0
1,0,0,1,1,1,0,0,0,0,0,1,0,0,0,1,0,1,0,0
1,0,0,1,1,1,2,0,0,0,0,3,0,0,0,3,0,3,2,0
1,0,0,1,1,1,2,0,0,0,0,3,0,0,0,3,0,3,2,0
1,0,0,1,1,1,2,0,0,0,0,3,0,0,0,3,0,3,2,0
1,0,0,1,1,1,2,0,0,0,0,3,0,0,0,3,0,3,2,0
1,0,0,1,1,1,2,0,0,0,0,3,0,0,0,3,0,3,2,0
1,0,0,1,1,1,2,0,0,0,0,3,0,0,0,3,0,3,2,0
1,0,0,1,1,1,2,0,0,0,0,3,0,0,0,3,0,3,2,0
1,0,0,1,1,1,2,0,0,0,0,3,0,0,0,3,0,3,2,0
1,0,0,1,1,1,2,0,0,0,0,3,0,0,0,3,0,3,2,0
1,0,0,1,1,1,2,0,0,0,0,3,0,0,0,3,0,3,2,0
1,0,0,1,1,1,2,0,0,0,0,3,0,0,0,3,0,3,2,0
1,0,0,1,1,1,3,11.63,2,46.53,0.01,9,0.5,2.58,4,5,3,3,3,0
1,0,0,1,1,1,0,5.33,1.5,12,0,4,0.67,0.67,1,3,1,3,0,0
1,0,0,1,1,1,0,5.33,1.5,12,0,4,0.67,0.67,1,3,1,3,0,0
1,0,0,1,1,1,0,5.33,1.5,12,0,4,0.67,0.67,1,3,1,3,0,0
1,0,0,1,1,1,2,0,0,0,0,3,0,0,0,3,0,3,2,0
1,0,0,1,1,1,2,5.33,1.5,12,0,4,0.67,0.67,1,3,1,3,2,0
1,0,0,1,1,1,2,0,0,0,0,3,0,0,0,3,0,3,2,0
1,0,0,1,1,1,2,0,0,0,0,3,0,0,0,3,0,3,2,0
1,0,0,1,1,1,2,0,0,0,0,3,0,0,0,3,0,3,2,0
1,0,0,1,1,1,2,0,0,0,0,3,0,0,0,3,0,3,2,0
1,0,0,1,1,1,2,0,0,0,0,3,0,0,0,3,0,3,2,0
1,0,0,1,1,1,2,0,0,0,0,3,0,0,0,3,0,3,2,0
1,0,0,1,1,1,2,0,0,0,0,3,0,0,0,3,0,3,2,0
1,0,0,1,1,1,2,0,0,0,0,3,0,0,0,3,0,3,2,0
1,0,0,1,1,1,2,0,0,0,0,3,0,0,0,3,0,3,2,0
1,0,0,1,1,1,2,0,0,0,0,3,0,0,0,3,0,3,2,0
1,0,0,1,1,1,2,0,0,0,0,3,0,0,0,3,0,3,2,0
1,0,0,1,1,1,0,7.74,1.5,17.41,0,5,0.67,0.97,2,3,2,3,0,0
1,0,0,1,1,1,0,7.74,1.5,17.41,0,5,0.67,0.97,2,3,2,3,0,0
1,0,0,1,1,1,0,0,0,0,0,3,0,0,0,3,0,3,0,0
1,0,0,1,1,1,0,5.33,1.5,12,0,4,0.67,0.67,1,3,1,3,0,0
1,0,0,1,1,1,2,0,0,0,0,3,0,0,0,3,0,3,2,0
1,0,0,1,1,1,2,0,0,0,0,3,0,0,0,3,0,3,2,0
1,0,0,1,1,1,2,0,0,0,0,3,0,0,0,3,0,3,2,0
1,0,0,1,1,1,2,0,0,0,0,3,0,0,0,3,0,3,2,0
1,0,0,1,1,1,2,0,0,0,0,3,0,0,0,3,0,3,2,0
1,0,0,1,1,1,2,0,0,0,0,3,0,0,0,3,0,3,2,0
1,0,0,1,1,1,2,0,0,0,0,3,0,0,0,3,0,3,2,0
1,0,0,1,1,1,2,0,0,0,0,3,0,0,0,3,0,3,2,0
1,0,0,1,1,1,2,0,0,0,0,3,0,0,0,3,0,3,2,0
1,0,0,1,1,1,2,0,0,0,0,3,0,0,0,3,0,3,2,0
1,0,0,1,1,1,2,0,0,0,0,3,0,0,0,3,0,3,2,0
5,0,5,3,1,1,7,13.32,13.71,2505.06,0.06,43,0.07,139.17,16,27,7,12,7,0
5,0,5,3,1,1,7,13.32,13.71,2505.06,0.06,43,0.07,139.17,16,27,7,12,7,0
9,2,1,8,1,1,27,34.09,9.88,3329.22,0.11,68,0.1,184.96,24,44,17,14,29,0
3,0,1,2,1,1,2,12.09,6.3,479.73,0.03,20,0.16,26.65,7,13,5,9,2,0
1,0,0,1,1,1,2,5.33,1.5,12,0,4,0.67,0.67,1,3,1,3,2,0
1,0,0,1,1,1,2,5.33,1.5,12,0,4,0.67,0.67,1,3,1,3,2,0
1,0,0,1,1,1,2,5.33,1.5,12,0,4,0.67,0.67,1,3,1,3,2,0
1,0,0,1,1,1,2,5.33,1.5,12,0,4,0.67,0.67,1,3,1,3,2,0
1,0,0,1,1,1,2,5.33,1.5,12,0,4,0.67,0.67,1,3,1,3,2,0
1,0,0,1,1,1,2,5.33,1.5,12,0,4,0.67,0.67,1,3,1,3,2,0
1,0,0,1,1,1,2,5.33,1.5,12,0,4,0.67,0.67,1,3,1,3,2,0
1,0,0,1,1,1,2,5.33,1.5,12,0,4,0.67,0.67,1,3,1,3,2,0
1,0,0,1,1,1,2,5.33,1.5,12,0,4,0.67,0.67,1,3,1,3,2,0
1,0,0,1,1,1,2,0,0,0,0,4,0,0,0,4,0,4,2,0
1,0,0,1,1,1,1,0,0,0,0,1,0,0,0,1,0,1,1,0
1,0,0,1,1,1,2,0,0,0,0,5,0,0,0,5,0,5,2,0
11,1,4,6,1,1,21,13.86,22.5,7014.99,0.1,68,0.04,389.72,27,41,9,15,22,0
1,0,0,1,1,1,2,20.97,3,188.72,0.02,17,0.33,10.48,7,10,7,6,2,0
1,0,0,1,1,1,2,20.97,3,188.72,0.02,17,0.33,10.48,7,10,7,6,2,0
1,0,0,1,1,1,2,27.35,3,246.13,0.03,21,0.33,13.67,9,12,9,6,2,0
1,0,0,1,1,1,3,30.67,3,276,0.03,23,0.33,15.33,10,13,10,6,3,0
1,0,0,1,1,1,3,30.67,3,276,0.03,23,0.33,15.33,10,13,10,6,3,0
1,0,0,1,1,1,3,30.67,3,276,0.03,23,0.33,15.33,10,13,10,6,3,0
1,0,0,1,1,1,2,27.35,3,246.13,0.03,21,0.33,13.67,9,12,9,6,2,0
1,0,0,1,1,1,3,27.35,3,246.13,0.03,21,0.33,13.67,9,12,9,6,3,0
1,0,0,1,1,1,2,20.97,3,188.72,0.02,17,0.33,10.48,7,10,7,6,2,0
1,0,0,1,1,1,2,20.97,3,188.72,0.02,17,0.33,10.48,7,10,7,6,2,0
1,0,0,1,1,1,2,20.97,3,188.72,0.02,17,0.33,10.48,7,10,7,6,2,0
1,0,0,1,1,1,2,17.92,3,161.32,0.02,15,0.33,8.96,6,9,6,6,2,0
1,0,0,1,1,1,2,17.92,3,161.32,0.02,15,0.33,8.96,6,9,6,6,2,0
1,0,0,1,1,1,2,14.99,3,134.92,0.01,13,0.33,7.5,5,8,5,6,2,0
1,0,0,1,1,1,2,14.99,3,134.92,0.01,13,0.33,7.5,5,8,5,6,2,0
1,0,0,1,1,1,2,14.99,3,134.92,0.01,13,0.33,7.5,5,8,5,6,2,0
1,0,0,1,1,1,2,14.99,3,134.92,0.01,13,0.33,7.5,5,8,5,6,2,0
1,0,0,1,1,1,2,14.99,3,134.92,0.01,13,0.33,7.5,5,8,5,6,2,0
1,0,0,1,1,1,2,17.92,3,161.32,0.02,15,0.33,8.96,6,9,6,6,2,0
1,0,0,1,1,1,2,17.92,3,161.32,0.02,15,0.33,8.96,6,9,6,6,2,0
1,0,0,1,1,1,2,20.97,3,188.72,0.02,17,0.33,10.48,7,10,7,6,2,0
1,0,0,1,1,1,2,20.97,3,188.72,0.02,17,0.33,10.48,7,10,7,6,2,0
1,0,0,1,1,1,1,0,0,0,0,0,0,0,0,0,0,0,1,0
1,0,0,1,1,1,1,0,0,0,0,1,0,0,0,1,0,1,1,0
1,0,0,1,1,1,2,5.33,1.5,12,0,4,0.67,0.67,1,3,1,3,2,0
1,0,0,1,1,1,2,5.33,1.5,12,0,4,0.67,0.67,1,3,1,3,2,0
1,9,0,1,1,1,2,0,0,0,0,9,0,0,9,0,1,0,11,0
1,0,0,1,1,1,1,0,0,0,0,0,0,0,0,0,0,0,1,0
1,0,0,1,1,1,1,0,0,0,0,0,0,0,0,0,0,0,1,0
1,0,0,1,1,1,1,0,0,0,0,1,0,0,0,1,0,1,1,0
1,0,0,1,1,1,4,18.49,2.4,106.51,0.01,14,0.42,5.92,6,8,5,4,4,0
1,0,0,1,1,1,2,5.33,1.5,12,0,4,0.67,0.67,1,3,1,3,2,0
1,0,0,1,1,1,5,8.45,0.75,4.75,0,4,1.33,0.26,3,1,2,1,5,0
1,0,0,1,1,1,1,0,0,0,0,0,0,0,0,0,0,0,1,0
1,0,0,1,1,1,1,0,0,0,0,1,0,0,0,1,0,1,1,0
1,0,0,1,1,1,3,10.8,2.5,67.5,0.01,9,0.4,3.75,3,6,3,5,3,0
1,0,0,1,1,1,2,5.33,1.5,12,0,4,0.67,0.67,1,3,1,3,2,0
1,0,0,1,1,1,2,6.2,2.5,38.77,0.01,6,0.4,2.15,1,5,1,5,2,0
1,0,0,1,1,1,4,9.51,0.5,2.38,0,3,2,0.13,2,1,2,1,4,0
1,0,0,1,1,1,1,0,0,0,0,1,0,0,0,1,0,1,1,0
1,0,0,1,1,1,2,5.33,1.5,12,0,4,0.67,0.67,1,3,1,3,2,0
1,0,0,1,1,1,2,5.33,1.5,12,0,4,0.67,0.67,1,3,1,3,2,0
1,0,0,1,1,1,2,0,0,0,0,4,0,0,0,4,0,4,2,0
1,0,0,1,1,1,1,0,0,0,0,1,0,0,0,1,0,1,1,0
1,0,0,1,1,1,2,0,0,0,0,5,0,0,0,5,0,5,2,0
1,0,0,1,1,1,1,0,0,0,0,1,0,0,0,1,0,1,1,0
1,0,0,1,1,1,2,5.33,1.5,12,0,4,0.67,0.67,1,3,1,3,2,0
1,0,0,1,1,1,2,5.33,1.5,12,0,4,0.67,0.67,1,3,1,3,2,0
1,0,0,1,1,1,1,0,0,0,0,1,0,0,0,1,0,1,1,0
1,0,0,1,1,1,0,0,0,0,0,1,0,0,0,1,0,1,0,0
1,0,0,1,1,1,0,0,0,0,0,1,0,0,0,1,0,1,0,0
1,0,0,1,1,1,1,0,0,0,0,1,0,0,0,1,0,1,1,0
1,0,0,1,1,1,1,0,0,0,0,1,0,0,0,1,0,1,1,0
1,0,0,1,1,1,1,0,0,0,0,1,0,0,0,1,0,1,1,0
1,0,0,1,1,1,1,0,0,0,0,1,0,0,0,1,0,1,1,0
1,0,0,1,1,1,1,0,0,0,0,1,0,0,0,1,0,1,1,0
1,0,0,1,1,1,1,0,0,0,0,1,0,0,0,1,0,1,1,0
1,0,0,1,1,1,0,0,0,0,0,1,0,0,0,1,0,1,0,0
9,3,0,5,5,4,4,6.95,27.62,5307.06,0.06,47,0.04,294.84,17,30,4,13,7,0
1,0,0,1,1,1,0,0,0,0,0,1,0,0,0,1,0,1,0,0
13,1,11,7,4,6,26,40.76,18.3,13643.2,0.25,135,0.05,757.96,52,83,27,19,27,0
31,1,6,16,11,12,53,55.43,21.5,25622.24,0.4,217,0.05,1423.46,86,131,30,15,54,1
1,0,0,1,1,1,4,16.84,1.5,37.9,0.01,9,0.67,2.11,4,5,4,3,4,0
5,0,0,3,3,1,16,25.15,8.31,1736.09,0.07,45,0.12,96.45,18,27,13,12,16,0
5,0,2,3,3,1,11,26.41,5.73,866.35,0.05,35,0.17,48.13,14,21,11,9,11,0
9,0,4,5,5,1,19,33.34,9.33,2903.96,0.1,67,0.11,161.33,28,39,15,10,19,0
1,0,2,1,1,1,7,23.39,9.19,1974.2,0.07,55,0.11,109.68,21,34,8,7,7,0
29,4,36,15,10,7,121,151.61,25.09,95473.55,1.27,569,0.04,5304.09,237,332,85,18,125,1
6,1,0,5,5,1,21,34.9,9.88,3408.59,0.11,71,0.1,189.37,28,43,17,12,22,0
26,1,7,14,4,13,39,28.72,26,19415.7,0.25,131,0.04,1078.65,52,79,26,26,40,1
1,0,0,1,1,1,0,0,0,0,0,1,0,0,0,1,0,1,0,0
1,0,0,1,1,1,4,16.84,1.5,37.9,0.01,9,0.67,2.11,4,5,4,3,4,0
1,0,0,1,1,1,0,0,0,0,0,1,0,0,0,1,0,1,0,0
1,0,0,1,1,1,0,0,0,0,0,1,0,0,0,1,0,1,0,0
1,0,0,1,1,1,2,0,0,0,0,3,0,0,0,3,0,3,2,0
1,0,0,1,1,1,2,0,0,0,0,3,0,0,0,3,0,3,2,0
1,0,0,1,1,1,2,0,0,0,0,3,0,0,0,3,0,3,2,0
1,0,0,1,1,1,2,0,0,0,0,3,0,0,0,3,0,3,2,0
1,0,0,1,1,1,2,0,0,0,0,3,0,0,0,3,0,3,2,0
1,0,0,1,1,1,2,0,0,0,0,3,0,0,0,3,0,3,2,0
1,0,0,1,1,1,2,0,0,0,0,3,0,0,0,3,0,3,2,0
1,0,0,1,1,1,2,0,0,0,0,3,0,0,0,3,0,3,2,0
1,0,0,1,1,1,2,0,0,0,0,3,0,0,0,3,0,3,2,0
1,0,0,1,1,1,2,0,0,0,0,3,0,0,0,3,0,3,2,0
1,0,0,1,1,1,2,0,0,0,0,3,0,0,0,3,0,3,2,0
1,0,0,1,1,1,3,11.63,2,46.53,0.01,9,0.5,2.58,4,5,3,3,3,0
1,0,0,1,1,1,0,5.33,1.5,12,0,4,0.67,0.67,1,3,1,3,0,0
1,0,0,1,1,1,0,5.33,1.5,12,0,4,0.67,0.67,1,3,1,3,0,0
1,0,0,1,1,1,0,5.33,1.5,12,0,4,0.67,0.67,1,3,1,3,0,0
1,0,0,1,1,1,2,0,0,0,0,3,0,0,0,3,0,3,2,0
1,0,0,1,1,1,2,5.33,1.5,12,0,4,0.67,0.67,1,3,1,3,2,0
1,0,0,1,1,1,2,0,0,0,0,3,0,0,0,3,0,3,2,0
1,0,0,1,1,1,2,0,0,0,0,3,0,0,0,3,0,3,2,0
1,0,0,1,1,1,2,0,0,0,0,3,0,0,0,3,0,3,2,0
1,0,0,1,1,1,2,0,0,0,0,3,0,0,0,3,0,3,2,0
1,0,0,1,1,1,2,0,0,0,0,3,0,0,0,3,0,3,2,0
1,0,0,1,1,1,2,0,0,0,0,3,0,0,0,3,0,3,2,0
1,0,0,1,1,1,2,0,0,0,0,3,0,0,0,3,0,3,2,0
1,0,0,1,1,1,2,0,0,0,0,3,0,0,0,3,0,3,2,0
1,0,0,1,1,1,2,0,0,0,0,3,0,0,0,3,0,3,2,0
1,0,0,1,1,1,2,0,0,0,0,3,0,0,0,3,0,3,2,0
1,0,0,1,1,1,2,0,0,0,0,3,0,0,0,3,0,3,2,0
1,0,0,1,1,1,0,7.74,1.5,17.41,0,5,0.67,0.97,2,3,2,3,0,0
1,0,0,1,1,1,0,7.74,1.5,17.41,0,5,0.67,0.97,2,3,2,3,0,0
1,0,0,1,1,1,0,0,0,0,0,3,0,0,0,3,0,3,0,0
1,0,0,1,1,1,0,5.33,1.5,12,0,4,0.67,0.67,1,3,1,3,0,0
1,0,0,1,1,1,2,0,0,0,0,3,0,0,0,3,0,3,2,0
1,0,0,1,1,1,2,0,0,0,0,3,0,0,0,3,0,3,2,0
1,0,0,1,1,1,2,0,0,0,0,3,0,0,0,3,0,3,2,0
1,0,0,1,1,1,2,0,0,0,0,3,0,0,0,3,0,3,2,0
1,0,0,1,1,1,2,0,0,0,0,3,0,0,0,3,0,3,2,0
1,0,0,1,1,1,2,0,0,0,0,3,0,0,0,3,0,3,2,0
1,0,0,1,1,1,2,0,0,0,0,3,0,0,0,3,0,3,2,0
1,0,0,1,1,1,2,0,0,0,0,3,0,0,0,3,0,3,2,0
1,0,0,1,1,1,2,0,0,0,0,3,0,0,0,3,0,3,2,0
1,0,0,1,1,1,2,0,0,0,0,3,0,0,0,3,0,3,2,0
1,0,0,1,1,1,2,0,0,0,0,3,0,0,0,3,0,3,2,0
1,0,0,1,1,1,0,0,0,0,0,1,0,0,0,1,0,1,0,0
5,0,5,3,1,1,7,13.32,13.71,2505.06,0.06,43,0.07,139.17,16,27,7,12,7,0
5,0,5,3,1,1,7,13.32,13.71,2505.06,0.06,43,0.07,139.17,16,27,7,12,7,0
9,2,1,8,1,1,27,34.09,9.88,3329.22,0.11,68,0.1,184.96,24,44,17,14,29,0
1,0,0,1,1,1,2,13.18,5.25,363.24,0.02,20,0.19,20.18,6,14,4,7,2,0
3,0,1,2,1,1,2,12.09,6.3,479.73,0.03,20,0.16,26.65,7,13,5,9,2,0
1,0,0,1,1,1,2,5.33,1.5,12,0,4,0.67,0.67,1,3,1,3,2,0
1,0,0,1,1,1,2,5.33,1.5,12,0,4,0.67,0.67,1,3,1,3,2,0
1,0,0,1,1,1,2,5.33,1.5,12,0,4,0.67,0.67,1,3,1,3,2,0
1,0,0,1,1,1,2,5.33,1.5,12,0,4,0.67,0.67,1,3,1,3,2,0
1,0,0,1,1,1,2,5.33,1.5,12,0,4,0.67,0.67,1,3,1,3,2,0
1,0,0,1,1,1,2,5.33,1.5,12,0,4,0.67,0.67,1,3,1,3,2,0
1,0,0,1,1,1,2,5.33,1.5,12,0,4,0.67,0.67,1,3,1,3,2,0
1,0,0,1,1,1,2,5.33,1.5,12,0,4,0.67,0.67,1,3,1,3,2,0
1,0,0,1,1,1,2,5.33,1.5,12,0,4,0.67,0.67,1,3,1,3,2,0
1,0,0,1,1,1,2,5.33,1.5,12,0,4,0.67,0.67,1,3,1,3,2,0
1,0,0,1,1,1,2,5.33,1.5,12,0,4,0.67,0.67,1,3,1,3,2,0
1,0,0,1,1,1,2,5.33,1.5,12,0,4,0.67,0.67,1,3,1,3,2,0
1,0,0,1,1,1,2,11.3,6.13,423.78,0.02,20,0.16,23.54,7,13,4,7,2,0
1,0,0,1,1,1,2,0,0,0,0,4,0,0,0,4,0,4,2,0
1,0,0,1,1,1,0,0,0,0,0,5,0,0,0,5,0,5,0,0
1,0,0,1,1,1,0,0,0,0,0,5,0,0,0,5,0,5,0,0
1,0,0,1,1,1,1,0,0,0,0,1,0,0,0,1,0,1,1,0
1,0,0,1,1,1,2,0,0,0,0,5,0,0,0,5,0,5,2,0
11,1,4,6,1,1,21,13.86,22.5,7014.99,0.1,68,0.04,389.72,27,41,9,15,22,0
1,0,0,1,1,1,2,7.74,1.5,17.41,0,5,0.67,0.97,2,3,2,3,2,0
1,0,0,1,1,1,2,7.74,1.5,17.41,0,5,0.67,0.97,2,3,2,3,2,0
1,0,0,1,1,1,2,7.74,1.5,17.41,0,5,0.67,0.97,2,3,2,3,2,0
1,0,0,1,1,1,2,20.97,3,188.72,0.02,17,0.33,10.48,7,10,7,6,2,0
1,0,0,1,1,1,2,20.97,3,188.72,0.02,17,0.33,10.48,7,10,7,6,2,0
1,0,0,1,1,1,2,27.35,3,246.13,0.03,21,0.33,13.67,9,12,9,6,2,0
1,0,0,1,1,1,3,30.67,3,276,0.03,23,0.33,15.33,10,13,10,6,3,0
1,0,0,1,1,1,3,30.67,3,276,0.03,23,0.33,15.33,10,13,10,6,3,0
1,0,0,1,1,1,3,30.67,3,276,0.03,23,0.33,15.33,10,13,10,6,3,0
1,0,0,1,1,1,2,27.35,3,246.13,0.03,21,0.33,13.67,9,12,9,6,2,0
1,0,0,1,1,1,3,27.35,3,246.13,0.03,21,0.33,13.67,9,12,9,6,3,0
1,0,0,1,1,1,2,20.97,3,188.72,0.02,17,0.33,10.48,7,10,7,6,2,0
1,0,0,1,1,1,2,20.97,3,188.72,0.02,17,0.33,10.48,7,10,7,6,2,0
1,0,0,1,1,1,2,20.97,3,188.72,0.02,17,0.33,10.48,7,10,7,6,2,0
1,0,0,1,1,1,2,17.92,3,161.32,0.02,15,0.33,8.96,6,9,6,6,2,0
1,0,0,1,1,1,2,17.92,3,161.32,0.02,15,0.33,8.96,6,9,6,6,2,0
1,0,0,1,1,1,2,14.99,3,134.92,0.01,13,0.33,7.5,5,8,5,6,2,0
1,0,0,1,1,1,2,14.99,3,134.92,0.01,13,0.33,7.5,5,8,5,6,2,0
1,0,0,1,1,1,2,14.99,3,134.92,0.01,13,0.33,7.5,5,8,5,6,2,0
1,0,0,1,1,1,2,14.99,3,134.92,0.01,13,0.33,7.5,5,8,5,6,2,0
1,0,0,1,1,1,2,14.99,3,134.92,0.01,13,0.33,7.5,5,8,5,6,2,0
1,0,0,1,1,1,2,17.92,3,161.32,0.02,15,0.33,8.96,6,9,6,6,2,0
1,0,0,1,1,1,2,17.92,3,161.32,0.02,15,0.33,8.96,6,9,6,6,2,0
1,0,0,1,1,1,2,20.97,3,188.72,0.02,17,0.33,10.48,7,10,7,6,2,0
1,0,0,1,1,1,2,20.97,3,188.72,0.02,17,0.33,10.48,7,10,7,6,2,0
1,0,0,1,1,1,1,0,0,0,0,0,0,0,0,0,0,0,1,0
1,0,0,1,1,1,1,0,0,0,0,1,0,0,0,1,0,1,1,0
1,0,0,1,1,1,2,5.33,1.5,12,0,4,0.67,0.67,1,3,1,3,2,0
1,0,0,1,1,1,2,5.33,1.5,12,0,4,0.67,0.67,1,3,1,3,2,0
1,9,0,1,1,1,2,0,0,0,0,9,0,0,9,0,1,0,11,0
1,0,0,1,1,1,1,0,0,0,0,0,0,0,0,0,0,0,1,0
1,0,0,1,1,1,1,0,0,0,0,0,0,0,0,0,0,0,1,0
1,0,0,1,1,1,1,0,0,0,0,1,0,0,0,1,0,1,1,0
1,0,0,1,1,1,4,18.49,2.4,106.51,0.01,14,0.42,5.92,6,8,5,4,4,0
1,0,0,1,1,1,2,5.33,1.5,12,0,4,0.67,0.67,1,3,1,3,2,0
1,0,0,1,1,1,5,8.45,0.75,4.75,0,4,1.33,0.26,3,1,2,1,5,0
1,0,0,1,1,1,1,0,0,0,0,0,0,0,0,0,0,0,1,0
1,0,0,1,1,1,1,0,0,0,0,1,0,0,0,1,0,1,1,0
1,0,0,1,1,1,3,10.8,2.5,67.5,0.01,9,0.4,3.75,3,6,3,5,3,0
1,0,0,1,1,1,2,5.33,1.5,12,0,4,0.67,0.67,1,3,1,3,2,0
1,0,0,1,1,1,2,6.2,2.5,38.77,0.01,6,0.4,2.15,1,5,1,5,2,0
1,0,0,1,1,1,4,9.51,0.5,2.38,0,3,2,0.13,2,1,2,1,4,0
1,0,0,1,1,1,1,0,0,0,0,1,0,0,0,1,0,1,1,0
1,0,0,1,1,1,2,5.33,1.5,12,0,4,0.67,0.67,1,3,1,3,2,0
1,0,0,1,1,1,2,5.33,1.5,12,0,4,0.67,0.67,1,3,1,3,2,0
1,0,0,1,1,1,2,0,0,0,0,4,0,0,0,4,0,4,2,0
1,0,0,1,1,1,1,0,0,0,0,1,0,0,0,1,0,1,1,0
1,0,0,1,1,1,2,0,0,0,0,5,0,0,0,5,0,5,2,0
1,0,0,1,1,1,1,0,0,0,0,1,0,0,0,1,0,1,1,0
1,0,0,1,1,1,2,5.33,1.5,12,0,4,0.67,0.67,1,3,1,3,2,0
1,0,0,1,1,1,2,5.33,1.5,12,0,4,0.67,0.67,1,3,1,3,2,0
1,0,0,1,1,1,1,0,0,0,0,1,0,0,0,1,0,1,1,0
1,0,0,1,1,1,6,16.68,7.5,938.23,0.04,30,0.13,52.12,12,18,8,10,6,0
1,0,0,1,1,1,2,5.33,1.5,12,0,4,0.67,0.67,1,3,1,3,2,0
1,0,0,1,1,1,2,10.44,3.5,127.89,0.01,11,0.29,7.11,3,8,3,7,2,0
1,0,0,1,1,1,0,0,0,0,0,1,0,0,0,1,0,1,0,0
1,0,0,1,1,1,0,0,0,0,0,1,0,0,0,1,0,1,0,0
1,0,0,1,1,1,1,0,0,0,0,1,0,0,0,1,0,1,1,0
1,0,0,1,1,1,1,0,0,0,0,1,0,0,0,1,0,1,1,0
1,0,0,1,1,1,1,0,0,0,0,1,0,0,0,1,0,1,1,0
1,0,0,1,1,1,1,0,0,0,0,1,0,0,0,1,0,1,1,0
1,0,0,1,1,1,1,0,0,0,0,1,0,0,0,1,0,1,1,0
1,0,0,1,1,1,1,0,0,0,0,1,0,0,0,1,0,1,1,0
9,3,0,5,5,4,4,6.95,27.62,5307.06,0.06,47,0.04,294.84,17,30,4,13,7,0
1,0,0,1,1,1,0,0,0,0,0,1,0,0,0,1,0,1,0,0
3,0,5,2,2,1,5,9.05,2,36.19,0.01,7,0.5,2,2,5,2,4,5,0
5,1,9,3,1,1,12,33.17,8.89,2623.95,0.1,59,0.11,145.77,26,33,19,13,13,0
1,0,0,1,1,1,4,16.84,1.5,37.9,0.01,9,0.67,2.11,4,5,4,3,4,0
9,0,4,5,4,3,19,31.62,9.63,2929.01,0.1,64,0.1,162.72,28,36,16,11,19,0
1,0,3,1,1,1,5,22.2,3,199.82,0.02,18,0.33,11.1,7,11,7,6,5,0
15,1,26,8,6,4,78,88.38,23.75,49853.91,0.7,337,0.04,2769.66,140,197,56,19,79,0
1,0,0,1,1,1,0,0,0,0,0,1,0,0,0,1,0,1,0,0
1,0,0,1,1,1,4,16.84,1.5,37.9,0.01,9,0.67,2.11,4,5,4,3,4,0
1,0,0,1,1,1,0,0,0,0,0,1,0,0,0,1,0,1,0,0
1,0,0,1,1,1,0,0,0,0,0,1,0,0,0,1,0,1,0,0
1,0,0,1,1,1,2,0,0,0,0,3,0,0,0,3,0,3,2,0
1,0,0,1,1,1,2,0,0,0,0,3,0,0,0,3,0,3,2,0
1,0,0,1,1,1,2,0,0,0,0,3,0,0,0,3,0,3,2,0
1,0,0,1,1,1,2,0,0,0,0,3,0,0,0,3,0,3,2,0
1,0,0,1,1,1,2,0,0,0,0,3,0,0,0,3,0,3,2,0
1,0,0,1,1,1,2,0,0,0,0,3,0,0,0,3,0,3,2,0
1,0,0,1,1,1,2,0,0,0,0,3,0,0,0,3,0,3,2,0
1,0,0,1,1,1,2,0,0,0,0,3,0,0,0,3,0,3,2,0
1,0,0,1,1,1,2,0,0,0,0,3,0,0,0,3,0,3,2,0
1,0,0,1,1,1,2,0,0,0,0,3,0,0,0,3,0,3,2,0
1,0,0,1,1,1,2,0,0,0,0,3,0,0,0,3,0,3,2,0
1,0,0,1,1,1,3,11.63,2,46.53,0.01,9,0.5,2.58,4,5,3,3,3,0
1,0,0,1,1,1,0,5.33,1.5,12,0,4,0.67,0.67,1,3,1,3,0,0
1,0,0,1,1,1,0,5.33,1.5,12,0,4,0.67,0.67,1,3,1,3,0,0
1,0,0,1,1,1,0,5.33,1.5,12,0,4,0.67,0.67,1,3,1,3,0,0
1,0,0,1,1,1,2,0,0,0,0,3,0,0,0,3,0,3,2,0
1,0,0,1,1,1,2,5.33,1.5,12,0,4,0.67,0.67,1,3,1,3,2,0
1,0,0,1,1,1,2,0,0,0,0,3,0,0,0,3,0,3,2,0
1,0,0,1,1,1,2,0,0,0,0,3,0,0,0,3,0,3,2,0
1,0,0,1,1,1,2,0,0,0,0,3,0,0,0,3,0,3,2,0
1,0,0,1,1,1,2,0,0,0,0,3,0,0,0,3,0,3,2,0
1,0,0,1,1,1,2,0,0,0,0,3,0,0,0,3,0,3,2,0
1,0,0,1,1,1,2,0,0,0,0,3,0,0,0,3,0,3,2,0
1,0,0,1,1,1,2,0,0,0,0,3,0,0,0,3,0,3,2,0
1,0,0,1,1,1,2,0,0,0,0,3,0,0,0,3,0,3,2,0
1,0,0,1,1,1,2,0,0,0,0,3,0,0,0,3,0,3,2,0
1,0,0,1,1,1,2,0,0,0,0,3,0,0,0,3,0,3,2,0
1,0,0,1,1,1,2,0,0,0,0,3,0,0,0,3,0,3,2,0
1,0,0,1,1,1,0,7.74,1.5,17.41,0,5,0.67,0.97,2,3,2,3,0,0
1,0,0,1,1,1,0,7.74,1.5,17.41,0,5,0.67,0.97,2,3,2,3,0,0
1,0,0,1,1,1,0,0,0,0,0,3,0,0,0,3,0,3,0,0
1,0,0,1,1,1,0,5.33,1.5,12,0,4,0.67,0.67,1,3,1,3,0,0
1,0,0,1,1,1,2,0,0,0,0,3,0,0,0,3,0,3,2,0
1,0,0,1,1,1,2,0,0,0,0,3,0,0,0,3,0,3,2,0
1,0,0,1,1,1,2,0,0,0,0,3,0,0,0,3,0,3,2,0
1,0,0,1,1,1,2,0,0,0,0,3,0,0,0,3,0,3,2,0
1,0,0,1,1,1,2,0,0,0,0,3,0,0,0,3,0,3,2,0
1,0,0,1,1,1,2,0,0,0,0,3,0,0,0,3,0,3,2,0
1,0,0,1,1,1,2,0,0,0,0,3,0,0,0,3,0,3,2,0
1,0,0,1,1,1,2,0,0,0,0,3,0,0,0,3,0,3,2,0
1,0,0,1,1,1,2,0,0,0,0,3,0,0,0,3,0,3,2,0
1,0,0,1,1,1,2,0,0,0,0,3,0,0,0,3,0,3,2,0
1,0,0,1,1,1,2,0,0,0,0,3,0,0,0,3,0,3,2,0
1,0,0,1,1,1,0,0,0,0,0,1,0,0,0,1,0,1,0,0
1,0,0,1,1,1,2,13.18,5.25,363.24,0.02,20,0.19,20.18,6,14,4,7,2,0
1,0,0,1,1,1,2,5.33,1.5,12,0,4,0.67,0.67,1,3,1,3,2,0
1,0,0,1,1,1,2,5.33,1.5,12,0,4,0.67,0.67,1,3,1,3,2,0
1,0,0,1,1,1,2,5.33,1.5,12,0,4,0.67,0.67,1,3,1,3,2,0
1,0,0,1,1,1,2,5.33,1.5,12,0,4,0.67,0.67,1,3,1,3,2,0
1,0,0,1,1,1,2,5.33,1.5,12,0,4,0.67,0.67,1,3,1,3,2,0
1,0,0,1,1,1,2,5.33,1.5,12,0,4,0.67,0.67,1,3,1,3,2,0
1,0,0,1,1,1,2,5.33,1.5,12,0,4,0.67,0.67,1,3,1,3,2,0
1,0,0,1,1,1,2,5.33,1.5,12,0,4,0.67,0.67,1,3,1,3,2,0
1,0,0,1,1,1,2,5.33,1.5,12,0,4,0.67,0.67,1,3,1,3,2,0
1,0,0,1,1,1,2,5.33,1.5,12,0,4,0.67,0.67,1,3,1,3,2,0
1,0,0,1,1,1,2,5.33,1.5,12,0,4,0.67,0.67,1,3,1,3,2,0
1,0,0,1,1,1,2,5.33,1.5,12,0,4,0.67,0.67,1,3,1,3,2,0
1,0,0,1,1,1,2,11.3,6.13,423.78,0.02,20,0.16,23.54,7,13,4,7,2,0
1,0,0,1,1,1,2,0,0,0,0,4,0,0,0,4,0,4,2,0
1,0,0,1,1,1,1,0,0,0,0,1,0,0,0,1,0,1,1,0
1,0,0,1,1,1,2,0,0,0,0,5,0,0,0,5,0,5,2,0
1,0,0,1,1,1,2,7.74,1.5,17.41,0,5,0.67,0.97,2,3,2,3,2,0
1,0,0,1,1,1,2,7.74,1.5,17.41,0,5,0.67,0.97,2,3,2,3,2,0
1,0,0,1,1,1,2,7.74,1.5,17.41,0,5,0.67,0.97,2,3,2,3,2,0
1,0,0,1,1,1,2,20.97,3,188.72,0.02,17,0.33,10.48,7,10,7,6,2,0
1,0,0,1,1,1,2,20.97,3,188.72,0.02,17,0.33,10.48,7,10,7,6,2,0
1,0,0,1,1,1,2,27.35,3,246.13,0.03,21,0.33,13.67,9,12,9,6,2,0
1,0,0,1,1,1,3,30.67,3,276,0.03,23,0.33,15.33,10,13,10,6,3,0
1,0,0,1,1,1,3,30.67,3,276,0.03,23,0.33,15.33,10,13,10,6,3,0
1,0,0,1,1,1,3,30.67,3,276,0.03,23,0.33,15.33,10,13,10,6,3,0
1,0,0,1,1,1,2,27.35,3,246.13,0.03,21,0.33,13.67,9,12,9,6,2,0
1,0,0,1,1,1,3,27.35,3,246.13,0.03,21,0.33,13.67,9,12,9,6,3,0
1,0,0,1,1,1,2,20.97,3,188.72,0.02,17,0.33,10.48,7,10,7,6,2,0
1,0,0,1,1,1,2,20.97,3,188.72,0.02,17,0.33,10.48,7,10,7,6,2,0
1,0,0,1,1,1,2,20.97,3,188.72,0.02,17,0.33,10.48,7,10,7,6,2,0
1,0,0,1,1,1,2,17.92,3,161.32,0.02,15,0.33,8.96,6,9,6,6,2,0
1,0,0,1,1,1,2,17.92,3,161.32,0.02,15,0.33,8.96,6,9,6,6,2,0
1,0,0,1,1,1,2,14.99,3,134.92,0.01,13,0.33,7.5,5,8,5,6,2,0
1,0,0,1,1,1,2,14.99,3,134.92,0.01,13,0.33,7.5,5,8,5,6,2,0
1,0,0,1,1,1,2,14.99,3,134.92,0.01,13,0.33,7.5,5,8,5,6,2,0
1,0,0,1,1,1,2,14.99,3,134.92,0.01,13,0.33,7.5,5,8,5,6,2,0
1,0,0,1,1,1,2,14.99,3,134.92,0.01,13,0.33,7.5,5,8,5,6,2,0
1,0,0,1,1,1,2,17.92,3,161.32,0.02,15,0.33,8.96,6,9,6,6,2,0
1,0,0,1,1,1,2,17.92,3,161.32,0.02,15,0.33,8.96,6,9,6,6,2,0
1,0,0,1,1,1,2,20.97,3,188.72,0.02,17,0.33,10.48,7,10,7,6,2,0
1,0,0,1,1,1,2,20.97,3,188.72,0.02,17,0.33,10.48,7,10,7,6,2,0
1,0,0,1,1,1,1,0,0,0,0,0,0,0,0,0,0,0,1,0
1,0,0,1,1,1,1,0,0,0,0,1,0,0,0,1,0,1,1,0
1,0,0,1,1,1,2,5.33,1.5,12,0,4,0.67,0.67,1,3,1,3,2,0
1,0,0,1,1,1,2,5.33,1.5,12,0,4,0.67,0.67,1,3,1,3,2,0
1,9,0,1,1,1,2,0,0,0,0,9,0,0,9,0,1,0,11,0
1,0,0,1,1,1,1,0,0,0,0,0,0,0,0,0,0,0,1,0
1,0,0,1,1,1,1,0,0,0,0,0,0,0,0,0,0,0,1,0
1,0,0,1,1,1,1,0,0,0,0,1,0,0,0,1,0,1,1,0
1,0,0,1,1,1,4,18.49,2.4,106.51,0.01,14,0.42,5.92,6,8,5,4,4,0
1,0,0,1,1,1,2,5.33,1.5,12,0,4,0.67,0.67,1,3,1,3,2,0
1,0,0,1,1,1,5,8.45,0.75,4.75,0,4,1.33,0.26,3,1,2,1,5,0
1,0,0,1,1,1,1,0,0,0,0,0,0,0,0,0,0,0,1,0
1,0,0,1,1,1,1,0,0,0,0,1,0,0,0,1,0,1,1,0
1,0,0,1,1,1,3,10.8,2.5,67.5,0.01,9,0.4,3.75,3,6,3,5,3,0
1,0,0,1,1,1,2,5.33,1.5,12,0,4,0.67,0.67,1,3,1,3,2,0
1,0,0,1,1,1,2,6.2,2.5,38.77,0.01,6,0.4,2.15,1,5,1,5,2,0
1,0,0,1,1,1,4,9.51,0.5,2.38,0,3,2,0.13,2,1,2,1,4,0
1,0,0,1,1,1,1,0,0,0,0,1,0,0,0,1,0,1,1,0
1,0,0,1,1,1,2,5.33,1.5,12,0,4,0.67,0.67,1,3,1,3,2,0
1,0,0,1,1,1,2,5.33,1.5,12,0,4,0.67,0.67,1,3,1,3,2,0
1,0,0,1,1,1,2,0,0,0,0,4,0,0,0,4,0,4,2,0
1,0,0,1,1,1,1,0,0,0,0,1,0,0,0,1,0,1,1,0
1,0,0,1,1,1,2,0,0,0,0,5,0,0,0,5,0,5,2,0
1,0,0,1,1,1,1,0,0,0,0,1,0,0,0,1,0,1,1,0
1,0,0,1,1,1,2,5.33,1.5,12,0,4,0.67,0.67,1,3,1,3,2,0
1,0,0,1,1,1,2,5.33,1.5,12,0,4,0.67,0.67,1,3,1,3,2,0
1,0,0,1,1,1,1,0,0,0,0,1,0,0,0,1,0,1,1,0
1,0,0,1,1,1,0,0,0,0,0,1,0,0,0,1,0,1,0,0
1,0,0,1,1,1,0,0,0,0,0,1,0,0,0,1,0,1,0,0
1,0,0,1,1,1,1,0,0,0,0,1,0,0,0,1,0,1,1,0
1,0,0,1,1,1,1,0,0,0,0,1,0,0,0,1,0,1,1,0
1,0,0,1,1,1,1,0,0,0,0,1,0,0,0,1,0,1,1,0
1,0,0,1,1,1,1,0,0,0,0,1,0,0,0,1,0,1,1,0
1,0,0,1,1,1,1,0,0,0,0,1,0,0,0,1,0,1,1,0
1,0,0,1,1,1,1,0,0,0,0,1,0,0,0,1,0,1,1,0
1,0,0,1,1,1,0,0,0,0,0,1,0,0,0,1,0,1,0,0
9,3,0,5,5,4,4,6.95,27.62,5307.06,0.06,47,0.04,294.84,17,30,4,13,7,0
1,0,0,1,1,1,0,0,0,0,0,1,0,0,0,1,0,1,0,0
13,0,9,7,1,7,21,22.23,16,5691.91,0.12,74,0.06,316.22,32,42,14,14,21,0
17,1,31,9,4,7,34,44.37,20.23,18150.1,0.3,159,0.05,1008.34,66,93,31,19,35,1
573,66,321,287,75,157,835,214.91,151.9,4958584.3,10.88,4287,0.01,275476.92,1681,2606,166,30,901,1
157,3,49,79,14,54,253,97.22,80.64,632225.65,2.61,1175,0.01,35123.65,448,727,75,27,256,0
1,0,0,1,1,1,3,16.67,7.5,937.65,0.04,32,0.13,52.09,10,22,6,9,3,0
5,7,2,3,1,1,9,34.9,19.2,12864,0.22,134,0.05,714.67,64,70,20,12,16,0
15,0,25,8,1,1,46,32.77,22.1,16002.92,0.24,139,0.05,889.05,52,87,20,17,46,0
3,1,12,2,2,1,13,31.7,8.1,2079.73,0.09,56,0.12,115.54,27,29,15,9,14,0
5,8,2,3,1,1,8,28.83,12.83,4748.33,0.12,74,0.08,263.8,33,41,18,14,16,0
5,1,0,3,3,1,19,27.01,11.11,3335.11,0.1,59,0.09,185.28,25,34,18,16,20,0
3,0,0,2,2,1,13,20.27,7.15,1036.36,0.05,33,0.14,57.58,13,20,10,11,13,1
7,1,16,4,1,1,27,28.24,16,7230.26,0.15,94,0.06,401.68,32,62,14,14,28,0
17,0,7,9,8,3,40,45.44,18.69,15868.32,0.28,163,0.05,881.57,69,94,24,13,40,0
23,0,9,12,11,3,54,64.45,18.77,22717.85,0.4,223,0.05,1262.1,97,126,31,12,54,0
25,0,11,13,11,3,57,60.85,22.27,30186.67,0.45,244,0.04,1677.04,105,139,33,14,57,0
1,0,3,1,1,1,43,102.35,18.01,33206.73,0.61,325,0.06,1844.82,131,194,40,11,43,1
11,1,2,6,4,3,22,25.35,25.65,16675.18,0.22,123,0.04,926.4,54,69,20,19,23,0
1,0,0,1,1,1,4,20.06,7.2,1039.89,0.05,34,0.14,57.77,16,18,10,9,4,0
95,1,277,48,29,21,703,665.93,56.34,2113694.29,12.51,4554,0.02,117427.46,1889,2665,285,17,704,1
78,2,29,47,28,9,167,67.25,72,348604.58,1.61,701,0.01,19366.92,288,413,80,40,169,1
7,0,0,4,2,3,20,35.77,9.97,3555.02,0.12,75,0.1,197.5,29,46,16,11,20,0
39,2,5,24,5,19,54,39.56,29.59,34648.03,0.39,193,0.03,1924.89,73,120,37,30,56,0
7,0,0,4,2,3,20,31.42,11.2,3940.85,0.12,74,0.09,218.94,28,46,15,12,20,0
1,0,0,1,1,1,0,0,0,0,0,1,0,0,0,1,0,1,0,0
1,0,0,1,1,1,2,0,0,0,0,3,0,0,0,3,0,3,2,0
1,0,0,1,1,1,2,0,0,0,0,3,0,0,0,3,0,3,2,0
1,0,0,1,1,1,2,0,0,0,0,3,0,0,0,3,0,3,2,0
1,0,0,1,1,1,2,0,0,0,0,3,0,0,0,3,0,3,2,0
1,0,0,1,1,1,2,0,0,0,0,3,0,0,0,3,0,3,2,0
1,0,0,1,1,1,2,0,0,0,0,3,0,0,0,3,0,3,2,0
1,0,0,1,1,1,2,0,0,0,0,3,0,0,0,3,0,3,2,0
1,0,0,1,1,1,2,0,0,0,0,3,0,0,0,3,0,3,2,0
1,0,0,1,1,1,2,0,0,0,0,3,0,0,0,3,0,3,2,0
1,0,0,1,1,1,2,0,0,0,0,3,0,0,0,3,0,3,2,0
1,0,0,1,1,1,2,0,0,0,0,3,0,0,0,3,0,3,2,0
1,0,0,1,1,1,3,11.63,2,46.53,0.01,9,0.5,2.58,4,5,3,3,3,0
1,0,0,1,1,1,0,5.33,1.5,12,0,4,0.67,0.67,1,3,1,3,0,0
1,0,0,1,1,1,0,5.33,1.5,12,0,4,0.67,0.67,1,3,1,3,0,0
1,0,0,1,1,1,0,5.33,1.5,12,0,4,0.67,0.67,1,3,1,3,0,0
1,0,0,1,1,1,2,0,0,0,0,3,0,0,0,3,0,3,2,0
1,0,0,1,1,1,2,5.33,1.5,12,0,4,0.67,0.67,1,3,1,3,2,0
1,0,0,1,1,1,2,0,0,0,0,3,0,0,0,3,0,3,2,0
1,0,0,1,1,1,2,0,0,0,0,3,0,0,0,3,0,3,2,0
1,0,0,1,1,1,2,0,0,0,0,3,0,0,0,3,0,3,2,0
1,0,0,1,1,1,2,0,0,0,0,3,0,0,0,3,0,3,2,0
1,0,0,1,1,1,2,0,0,0,0,3,0,0,0,3,0,3,2,0
1,0,0,1,1,1,2,0,0,0,0,3,0,0,0,3,0,3,2,0
1,0,0,1,1,1,2,0,0,0,0,3,0,0,0,3,0,3,2,0
1,0,0,1,1,1,2,0,0,0,0,3,0,0,0,3,0,3,2,0
1,0,0,1,1,1,2,0,0,0,0,3,0,0,0,3,0,3,2,0
1,0,0,1,1,1,2,0,0,0,0,3,0,0,0,3,0,3,2,0
1,0,0,1,1,1,2,0,0,0,0,3,0,0,0,3,0,3,2,0
1,0,0,1,1,1,0,7.74,1.5,17.41,0,5,0.67,0.97,2,3,2,3,0,0
1,0,0,1,1,1,0,7.74,1.5,17.41,0,5,0.67,0.97,2,3,2,3,0,0
1,0,0,1,1,1,0,0,0,0,0,3,0,0,0,3,0,3,0,0
1,0,0,1,1,1,0,5.33,1.5,12,0,4,0.67,0.67,1,3,1,3,0,0
1,0,0,1,1,1,2,0,0,0,0,3,0,0,0,3,0,3,2,0
1,0,0,1,1,1,2,0,0,0,0,3,0,0,0,3,0,3,2,0
1,0,0,1,1,1,2,0,0,0,0,3,0,0,0,3,0,3,2,0
1,0,0,1,1,1,2,0,0,0,0,3,0,0,0,3,0,3,2,0
1,0,0,1,1,1,2,0,0,0,0,3,0,0,0,3,0,3,2,0
1,0,0,1,1,1,2,0,0,0,0,3,0,0,0,3,0,3,2,0
1,0,0,1,1,1,2,0,0,0,0,3,0,0,0,3,0,3,2,0
1,0,0,1,1,1,2,0,0,0,0,3,0,0,0,3,0,3,2,0
1,0,0,1,1,1,2,0,0,0,0,3,0,0,0,3,0,3,2,0
1,0,0,1,1,1,2,0,0,0,0,3,0,0,0,3,0,3,2,0
1,0,0,1,1,1,2,0,0,0,0,3,0,0,0,3,0,3,2,0
1,0,0,1,1,1,0,0,0,0,0,1,0,0,0,1,0,1,0,0
5,0,5,3,1,1,7,13.32,13.71,2505.06,0.06,43,0.07,139.17,16,27,7,12,7,0
5,0,5,3,1,1,7,13.32,13.71,2505.06,0.06,43,0.07,139.17,16,27,7,12,7,0
9,2,1,8,1,1,27,34.09,9.88,3329.22,0.11,68,0.1,184.96,24,44,17,14,29,0
1,0,0,1,1,1,2,13.18,5.25,363.24,0.02,20,0.19,20.18,6,14,4,7,2,0
3,0,1,2,1,1,2,12.09,6.3,479.73,0.03,20,0.16,26.65,7,13,5,9,2,0
1,0,0,1,1,1,2,5.33,1.5,12,0,4,0.67,0.67,1,3,1,3,2,0
1,0,0,1,1,1,2,5.33,1.5,12,0,4,0.67,0.67,1,3,1,3,2,0
1,0,0,1,1,1,2,5.33,1.5,12,0,4,0.67,0.67,1,3,1,3,2,0
1,0,0,1,1,1,2,5.33,1.5,12,0,4,0.67,0.67,1,3,1,3,2,0
1,0,0,1,1,1,2,5.33,1.5,12,0,4,0.67,0.67,1,3,1,3,2,0
1,0,0,1,1,1,2,5.33,1.5,12,0,4,0.67,0.67,1,3,1,3,2,0
1,0,0,1,1,1,2,5.33,1.5,12,0,4,0.67,0.67,1,3,1,3,2,0
1,0,0,1,1,1,2,5.33,1.5,12,0,4,0.67,0.67,1,3,1,3,2,0
1,0,0,1,1,1,2,5.33,1.5,12,0,4,0.67,0.67,1,3,1,3,2,0
1,0,0,1,1,1,2,5.33,1.5,12,0,4,0.67,0.67,1,3,1,3,2,0
1,0,0,1,1,1,2,5.33,1.5,12,0,4,0.67,0.67,1,3,1,3,2,0
1,0,0,1,1,1,2,5.33,1.5,12,0,4,0.67,0.67,1,3,1,3,2,0
1,0,0,1,1,1,2,11.3,6.13,423.78,0.02,20,0.16,23.54,7,13,4,7,2,0
1,0,0,1,1,1,2,0,0,0,0,4,0,0,0,4,0,4,2,0
1,0,0,1,1,1,0,0,0,0,0,5,0,0,0,5,0,5,0,0
1,0,0,1,1,1,0,0,0,0,0,5,0,0,0,5,0,5,0,0
1,0,0,1,1,1,1,0,0,0,0,1,0,0,0,1,0,1,1,0
1,0,0,1,1,1,2,0,0,0,0,5,0,0,0,5,0,5,2,0
11,1,4,6,1,1,21,13.86,22.5,7014.99,0.1,68,0.04,389.72,27,41,9,15,22,0
1,0,0,1,1,1,2,7.74,1.5,17.41,0,5,0.67,0.97,2,3,2,3,2,0
1,0,0,1,1,1,2,7.74,1.5,17.41,0,5,0.67,0.97,2,3,2,3,2,0
1,0,0,1,1,1,2,7.74,1.5,17.41,0,5,0.67,0.97,2,3,2,3,2,0
1,0,0,1,1,1,2,20.97,3,188.72,0.02,17,0.33,10.48,7,10,7,6,2,0
1,0,0,1,1,1,2,20.97,3,188.72,0.02,17,0.33,10.48,7,10,7,6,2,0
1,0,0,1,1,1,2,27.35,3,246.13,0.03,21,0.33,13.67,9,12,9,6,2,0
1,0,0,1,1,1,3,30.67,3,276,0.03,23,0.33,15.33,10,13,10,6,3,0
1,0,0,1,1,1,3,30.67,3,276,0.03,23,0.33,15.33,10,13,10,6,3,0
1,0,0,1,1,1,3,30.67,3,276,0.03,23,0.33,15.33,10,13,10,6,3,0
1,0,0,1,1,1,2,27.35,3,246.13,0.03,21,0.33,13.67,9,12,9,6,2,0
1,0,0,1,1,1,3,27.35,3,246.13,0.03,21,0.33,13.67,9,12,9,6,3,0
1,0,0,1,1,1,2,20.97,3,188.72,0.02,17,0.33,10.48,7,10,7,6,2,0
1,0,0,1,1,1,2,20.97,3,188.72,0.02,17,0.33,10.48,7,10,7,6,2,0
1,0,0,1,1,1,2,20.97,3,188.72,0.02,17,0.33,10.48,7,10,7,6,2,0
1,0,0,1,1,1,2,17.92,3,161.32,0.02,15,0.33,8.96,6,9,6,6,2,0
1,0,0,1,1,1,2,17.92,3,161.32,0.02,15,0.33,8.96,6,9,6,6,2,0
1,0,0,1,1,1,2,14.99,3,134.92,0.01,13,0.33,7.5,5,8,5,6,2,0
1,0,0,1,1,1,2,14.99,3,134.92,0.01,13,0.33,7.5,5,8,5,6,2,0
1,0,0,1,1,1,2,14.99,3,134.92,0.01,13,0.33,7.5,5,8,5,6,2,0
1,0,0,1,1,1,2,14.99,3,134.92,0.01,13,0.33,7.5,5,8,5,6,2,0
1,0,0,1,1,1,2,14.99,3,134.92,0.01,13,0.33,7.5,5,8,5,6,2,0
1,0,0,1,1,1,2,17.92,3,161.32,0.02,15,0.33,8.96,6,9,6,6,2,0
1,0,0,1,1,1,2,17.92,3,161.32,0.02,15,0.33,8.96,6,9,6,6,2,0
1,0,0,1,1,1,2,20.97,3,188.72,0.02,17,0.33,10.48,7,10,7,6,2,0
1,0,0,1,1,1,2,20.97,3,188.72,0.02,17,0.33,10.48,7,10,7,6,2,0
1,0,0,1,1,1,1,0,0,0,0,0,0,0,0,0,0,0,1,0
1,0,0,1,1,1,1,0,0,0,0,1,0,0,0,1,0,1,1,0
1,0,0,1,1,1,2,5.33,1.5,12,0,4,0.67,0.67,1,3,1,3,2,0
1,0,0,1,1,1,2,5.33,1.5,12,0,4,0.67,0.67,1,3,1,3,2,0
1,9,0,1,1,1,2,0,0,0,0,9,0,0,9,0,1,0,11,0
1,0,0,1,1,1,1,0,0,0,0,0,0,0,0,0,0,0,1,0
1,0,0,1,1,1,1,0,0,0,0,0,0,0,0,0,0,0,1,0
1,0,0,1,1,1,1,0,0,0,0,1,0,0,0,1,0,1,1,0
1,0,0,1,1,1,4,18.49,2.4,106.51,0.01,14,0.42,5.92,6,8,5,4,4,0
1,0,0,1,1,1,2,5.33,1.5,12,0,4,0.67,0.67,1,3,1,3,2,0
1,0,0,1,1,1,5,8.45,0.75,4.75,0,4,1.33,0.26,3,1,2,1,5,0
1,0,0,1,1,1,1,0,0,0,0,0,0,0,0,0,0,0,1,0
1,0,0,1,1,1,1,0,0,0,0,1,0,0,0,1,0,1,1,0
1,0,0,1,1,1,3,10.8,2.5,67.5,0.01,9,0.4,3.75,3,6,3,5,3,0
1,0,0,1,1,1,2,5.33,1.5,12,0,4,0.67,0.67,1,3,1,3,2,0
1,0,0,1,1,1,2,6.2,2.5,38.77,0.01,6,0.4,2.15,1,5,1,5,2,0
1,0,0,1,1,1,4,9.51,0.5,2.38,0,3,2,0.13,2,1,2,1,4,0
1,0,0,1,1,1,1,0,0,0,0,1,0,0,0,1,0,1,1,0
1,0,0,1,1,1,2,5.33,1.5,12,0,4,0.67,0.67,1,3,1,3,2,0
1,0,0,1,1,1,2,5.33,1.5,12,0,4,0.67,0.67,1,3,1,3,2,0
1,0,0,1,1,1,2,0,0,0,0,4,0,0,0,4,0,4,2,0
1,0,0,1,1,1,1,0,0,0,0,1,0,0,0,1,0,1,1,0
1,0,0,1,1,1,2,0,0,0,0,5,0,0,0,5,0,5,2,0
1,0,0,1,1,1,1,0,0,0,0,1,0,0,0,1,0,1,1,0
1,0,0,1,1,1,2,5.33,1.5,12,0,4,0.67,0.67,1,3,1,3,2,0
1,0,0,1,1,1,2,5.33,1.5,12,0,4,0.67,0.67,1,3,1,3,2,0
1,0,0,1,1,1,1,0,0,0,0,1,0,0,0,1,0,1,1,0
1,0,0,1,1,1,6,16.68,7.5,938.23,0.04,30,0.13,52.12,12,18,8,10,6,0
1,0,0,1,1,1,2,5.33,1.5,12,0,4,0.67,0.67,1,3,1,3,2,0
1,0,0,1,1,1,2,10.44,3.5,127.89,0.01,11,0.29,7.11,3,8,3,7,2,0
1,0,0,1,1,1,2,7.86,2.5,49.13,0.01,7,0.4,2.73,2,5,2,5,2,0
1,0,0,1,1,1,2,7.49,3,67.38,0.01,8,0.33,3.74,1,7,1,6,2,0
1,0,0,1,1,1,2,7.49,3,67.38,0.01,8,0.33,3.74,1,7,1,6,2,0
1,0,0,1,1,1,2,7.49,3,67.38,0.01,8,0.33,3.74,1,7,1,6,2,0
1,0,0,1,1,1,2,7.49,3,67.38,0.01,8,0.33,3.74,1,7,1,6,2,0
1,0,0,1,1,1,2,7.49,3,67.38,0.01,8,0.33,3.74,1,7,1,6,2,0
1,0,0,1,1,1,2,7.49,3,67.38,0.01,8,0.33,3.74,1,7,1,6,2,0
1,0,0,1,1,1,2,7.49,3,67.38,0.01,8,0.33,3.74,1,7,1,6,2,0
1,0,0,1,1,1,2,10.57,3,95.1,0.01,10,0.33,5.28,3,7,3,6,2,0
1,0,0,1,1,1,0,0,0,0,0,1,0,0,0,1,0,1,0,0
1,0,0,1,1,1,2,5.33,1.5,12,0,4,0.67,0.67,1,3,1,3,2,0
1,0,0,1,1,1,2,5.33,1.5,12,0,4,0.67,0.67,1,3,1,3,2,0
1,0,0,1,1,1,2,5.33,1.5,12,0,4,0.67,0.67,1,3,1,3,2,0
1,0,0,1,1,1,2,5.33,1.5,12,0,4,0.67,0.67,1,3,1,3,2,0
1,0,0,1,1,1,2,5.33,1.5,12,0,4,0.67,0.67,1,3,1,3,2,0
1,0,0,1,1,1,2,5.33,1.5,12,0,4,0.67,0.67,1,3,1,3,2,0
1,0,0,1,1,1,2,5.33,1.5,12,0,4,0.67,0.67,1,3,1,3,2,0
1,0,0,1,1,1,2,13.95,2.5,87.17,0.01,11,0.4,4.84,4,7,4,5,2,0
1,0,0,1,1,1,1,0,0,0,0,1,0,0,0,1,0,1,1,0
1,0,0,1,1,1,1,0,0,0,0,1,0,0,0,1,0,1,1,0
1,0,0,1,1,1,1,0,0,0,0,1,0,0,0,1,0,1,1,0
1,0,0,1,1,1,1,0,0,0,0,1,0,0,0,1,0,1,1,0
1,0,0,1,1,1,1,0,0,0,0,1,0,0,0,1,0,1,1,0
1,0,0,1,1,1,1,0,0,0,0,1,0,0,0,1,0,1,1,0
1,0,0,1,1,1,0,0,0,0,0,1,0,0,0,1,0,1,0,0
1,0,0,1,1,1,0,0,0,0,0,1,0,0,0,1,0,1,0,0
7,1,0,4,2,3,15,14.41,13,2434.85,0.06,42,0.08,135.27,18,24,9,13,16,0
1,0,0,1,1,1,0,0,0,0,0,1,0,0,0,1,0,1,0,0
13,0,0,7,7,1,43,76.32,8,4884.27,0.2,127,0.13,271.35,48,79,21,7,43,0
25,3,38,13,11,4,162,76.24,42.1,135139.85,1.07,537,0.02,7507.77,195,342,44,19,165,0
1,0,11,1,1,1,30,48.99,15.68,12036.84,0.26,155,0.06,668.71,57,98,20,11,30,1
11,1,4,6,4,1,34,32.67,15,7350,0.16,98,0.07,408.33,34,64,17,15,35,0
5,1,4,3,3,1,33,39.53,13.2,6887.08,0.17,111,0.08,382.62,36,75,15,11,34,0
22,2,7,13,1,5,55,26.04,35.2,32261.73,0.31,185,0.03,1792.32,66,119,15,16,57,1
41,2,52,22,1,12,84,40.07,41.81,70041.8,0.56,286,0.02,3891.21,96,190,31,27,86,1
9,4,6,5,5,1,40,34.81,20,13922.53,0.23,138,0.05,773.47,48,90,18,15,44,1
15,3,6,8,6,1,23,32.11,12.71,5184.89,0.14,84,0.08,288.05,36,48,17,12,26,1
17,3,6,9,7,1,30,39.68,14.48,8316.9,0.19,112,0.07,462.05,49,63,22,13,33,0
15,3,9,8,6,1,23,32.11,12.71,5184.89,0.14,84,0.08,288.05,36,48,17,12,26,0
3,0,2,2,2,1,9,15.86,8.57,1165.15,0.05,32,0.12,64.73,10,22,7,12,9,1
15,1,48,8,2,8,309,193.62,34.08,224856.06,2.2,1035,0.03,12492,367,668,70,13,310,0
1,0,0,1,1,1,0,0,0,0,0,1,0,0,0,1,0,1,0,0
1,0,0,1,1,1,3,7.74,1.5,17.41,0,5,0.67,0.97,2,3,2,3,3,0
1,1,19,1,1,1,98,101.59,14.92,22624.34,0.51,298,0.07,1256.91,97,201,26,8,99,0
1,0,0,1,1,1,0,0,0,0,0,1,0,0,0,1,0,1,0,0
1,0,0,1,1,1,2,7.74,1.5,17.41,0,5,0.67,0.97,2,3,2,3,2,0
1,1,19,1,1,1,98,101.59,14.92,22624.34,0.51,298,0.07,1256.91,97,201,26,8,99,0
1,0,0,1,1,1,0,0,0,0,0,1,0,0,0,1,0,1,0,0
1,0,0,1,1,1,2,0,0,0,0,3,0,0,0,3,0,3,2,0
1,0,0,1,1,1,2,0,0,0,0,3,0,0,0,3,0,3,2,0
1,0,0,1,1,1,2,0,0,0,0,3,0,0,0,3,0,3,2,0
1,0,0,1,1,1,2,0,0,0,0,3,0,0,0,3,0,3,2,0
1,0,0,1,1,1,2,0,0,0,0,3,0,0,0,3,0,3,2,0
1,0,0,1,1,1,2,0,0,0,0,3,0,0,0,3,0,3,2,0
1,0,0,1,1,1,2,0,0,0,0,3,0,0,0,3,0,3,2,0
1,0,0,1,1,1,2,0,0,0,0,3,0,0,0,3,0,3,2,0
1,0,0,1,1,1,2,0,0,0,0,3,0,0,0,3,0,3,2,0
1,0,0,1,1,1,2,0,0,0,0,3,0,0,0,3,0,3,2,0
1,0,0,1,1,1,2,0,0,0,0,3,0,0,0,3,0,3,2,0
1,0,0,1,1,1,3,11.63,2,46.53,0.01,9,0.5,2.58,4,5,3,3,3,0
1,0,0,1,1,1,0,5.33,1.5,12,0,4,0.67,0.67,1,3,1,3,0,0
1,0,0,1,1,1,0,5.33,1.5,12,0,4,0.67,0.67,1,3,1,3,0,0
1,0,0,1,1,1,0,5.33,1.5,12,0,4,0.67,0.67,1,3,1,3,0,0
1,0,0,1,1,1,2,0,0,0,0,3,0,0,0,3,0,3,2,0
1,0,0,1,1,1,2,5.33,1.5,12,0,4,0.67,0.67,1,3,1,3,2,0
1,0,0,1,1,1,2,0,0,0,0,3,0,0,0,3,0,3,2,0
1,0,0,1,1,1,2,0,0,0,0,3,0,0,0,3,0,3,2,0
1,0,0,1,1,1,2,0,0,0,0,3,0,0,0,3,0,3,2,0
1,0,0,1,1,1,2,0,0,0,0,3,0,0,0,3,0,3,2,0
1,0,0,1,1,1,2,0,0,0,0,3,0,0,0,3,0,3,2,0
1,0,0,1,1,1,2,0,0,0,0,3,0,0,0,3,0,3,2,0
1,0,0,1,1,1,2,0,0,0,0,3,0,0,0,3,0,3,2,0
1,0,0,1,1,1,2,0,0,0,0,3,0,0,0,3,0,3,2,0
1,0,0,1,1,1,2,0,0,0,0,3,0,0,0,3,0,3,2,0
1,0,0,1,1,1,2,0,0,0,0,3,0,0,0,3,0,3,2,0
1,0,0,1,1,1,2,0,0,0,0,3,0,0,0,3,0,3,2,0
1,0,0,1,1,1,0,7.74,1.5,17.41,0,5,0.67,0.97,2,3,2,3,0,0
1,0,0,1,1,1,0,7.74,1.5,17.41,0,5,0.67,0.97,2,3,2,3,0,0
1,0,0,1,1,1,0,0,0,0,0,3,0,0,0,3,0,3,0,0
1,0,0,1,1,1,0,5.33,1.5,12,0,4,0.67,0.67,1,3,1,3,0,0
1,0,0,1,1,1,2,0,0,0,0,3,0,0,0,3,0,3,2,0
1,0,0,1,1,1,2,0,0,0,0,3,0,0,0,3,0,3,2,0
1,0,0,1,1,1,2,0,0,0,0,3,0,0,0,3,0,3,2,0
1,0,0,1,1,1,2,0,0,0,0,3,0,0,0,3,0,3,2,0
1,0,0,1,1,1,2,0,0,0,0,3,0,0,0,3,0,3,2,0
1,0,0,1,1,1,2,0,0,0,0,3,0,0,0,3,0,3,2,0
1,0,0,1,1,1,2,0,0,0,0,3,0,0,0,3,0,3,2,0
1,0,0,1,1,1,2,0,0,0,0,3,0,0,0,3,0,3,2,0
1,0,0,1,1,1,2,0,0,0,0,3,0,0,0,3,0,3,2,0
1,0,0,1,1,1,2,0,0,0,0,3,0,0,0,3,0,3,2,0
1,0,0,1,1,1,2,0,0,0,0,3,0,0,0,3,0,3,2,0
5,0,5,3,1,1,7,13.32,13.71,2505.06,0.06,43,0.07,139.17,16,27,7,12,7,0
5,0,5,3,1,1,7,13.32,13.71,2505.06,0.06,43,0.07,139.17,16,27,7,12,7,0
1,0,0,1,1,1,0,0,0,0,0,1,0,0,0,1,0,1,0,0
9,2,1,8,1,1,27,34.09,9.88,3329.22,0.11,68,0.1,184.96,24,44,17,14,29,0
3,0,1,2,1,1,2,12.09,6.3,479.73,0.03,20,0.16,26.65,7,13,5,9,2,0
1,0,0,1,1,1,2,5.33,1.5,12,0,4,0.67,0.67,1,3,1,3,2,0
1,0,0,1,1,1,2,5.33,1.5,12,0,4,0.67,0.67,1,3,1,3,2,0
1,0,0,1,1,1,2,5.33,1.5,12,0,4,0.67,0.67,1,3,1,3,2,0
1,0,0,1,1,1,2,5.33,1.5,12,0,4,0.67,0.67,1,3,1,3,2,0
1,0,0,1,1,1,2,5.33,1.5,12,0,4,0.67,0.67,1,3,1,3,2,0
1,0,0,1,1,1,2,5.33,1.5,12,0,4,0.67,0.67,1,3,1,3,2,0
1,0,0,1,1,1,2,5.33,1.5,12,0,4,0.67,0.67,1,3,1,3,2,0
1,0,0,1,1,1,2,5.33,1.5,12,0,4,0.67,0.67,1,3,1,3,2,0
1,0,0,1,1,1,2,5.33,1.5,12,0,4,0.67,0.67,1,3,1,3,2,0
1,0,0,1,1,1,2,0,0,0,0,4,0,0,0,4,0,4,2,0
1,0,0,1,1,1,1,0,0,0,0,1,0,0,0,1,0,1,1,0
1,0,0,1,1,1,2,0,0,0,0,5,0,0,0,5,0,5,2,0
11,1,4,6,1,1,21,13.86,22.5,7014.99,0.1,68,0.04,389.72,27,41,9,15,22,0
1,0,0,1,1,1,1,0,0,0,0,0,0,0,0,0,0,0,1,0
1,0,0,1,1,1,2,8,3,72,0.01,8,0.33,4,2,6,2,6,2,0
1,0,0,1,1,1,2,8,3,72,0.01,8,0.33,4,2,6,2,6,2,0
1,0,0,1,1,1,2,8,3,72,0.01,8,0.33,4,2,6,2,6,2,0
1,0,0,1,1,1,2,8,3,72,0.01,8,0.33,4,2,6,2,6,2,0
1,0,0,1,1,1,2,8,3,72,0.01,8,0.33,4,2,6,2,6,2,0
1,0,0,1,1,1,2,8,3,72,0.01,8,0.33,4,2,6,2,6,2,0
1,0,0,1,1,1,2,8,3,72,0.01,8,0.33,4,2,6,2,6,2,0
1,0,0,1,1,1,2,8,3,72,0.01,8,0.33,4,2,6,2,6,2,0
1,0,0,1,1,1,2,8,3,72,0.01,8,0.33,4,2,6,2,6,2,0
1,0,0,1,1,1,2,8,3,72,0.01,8,0.33,4,2,6,2,6,2,0
1,0,0,1,1,1,1,0,0,0,0,1,0,0,0,1,0,1,1,0
1,0,0,1,1,1,2,5.33,1.5,12,0,4,0.67,0.67,1,3,1,3,2,0
1,0,0,1,1,1,2,5.33,1.5,12,0,4,0.67,0.67,1,3,1,3,2,0
1,9,0,1,1,1,2,0,0,0,0,9,0,0,9,0,1,0,11,0
1,0,0,1,1,1,2,8,3,72,0.01,8,0.33,4,2,6,2,6,2,0
1,0,0,1,1,1,2,8,3,72,0.01,8,0.33,4,2,6,2,6,2,0
1,0,0,1,1,1,3,21.46,5.5,649.15,0.04,31,0.18,36.06,11,20,7,7,3,0
1,0,0,1,1,1,3,21.46,5.5,649.15,0.04,31,0.18,36.06,11,20,7,7,3,0
1,0,0,1,1,1,3,21.46,5.5,649.15,0.04,31,0.18,36.06,11,20,7,7,3,0
1,0,0,1,1,1,3,21.46,5.5,649.15,0.04,31,0.18,36.06,11,20,7,7,3,0
1,0,0,1,1,1,3,21.46,5.5,649.15,0.04,31,0.18,36.06,11,20,7,7,3,0
1,0,0,1,1,1,3,21.46,5.5,649.15,0.04,31,0.18,36.06,11,20,7,7,3,0
1,0,0,1,1,1,2,8,3,72,0.01,8,0.33,4,2,6,2,6,2,0
1,0,0,1,1,1,2,8,3,72,0.01,8,0.33,4,2,6,2,6,2,0
1,0,0,1,1,1,1,0,0,0,0,0,0,0,0,0,0,0,1,0
1,0,0,1,1,1,1,0,0,0,0,0,0,0,0,0,0,0,1,0
1,0,0,1,1,1,1,0,0,0,0,1,0,0,0,1,0,1,1,0
1,0,0,1,1,1,4,18.49,2.4,106.51,0.01,14,0.42,5.92,6,8,5,4,4,0
1,0,0,1,1,1,2,5.33,1.5,12,0,4,0.67,0.67,1,3,1,3,2,0
1,0,0,1,1,1,5,8.45,0.75,4.75,0,4,1.33,0.26,3,1,2,1,5,0
1,0,0,1,1,1,1,0,0,0,0,0,0,0,0,0,0,0,1,0
1,0,0,1,1,1,1,0,0,0,0,1,0,0,0,1,0,1,1,0
1,0,0,1,1,1,3,10.8,2.5,67.5,0.01,9,0.4,3.75,3,6,3,5,3,0
1,0,0,1,1,1,2,5.33,1.5,12,0,4,0.67,0.67,1,3,1,3,2,0
1,0,0,1,1,1,2,6.2,2.5,38.77,0.01,6,0.4,2.15,1,5,1,5,2,0
1,0,0,1,1,1,4,9.51,0.5,2.38,0,3,2,0.13,2,1,2,1,4,0
1,0,0,1,1,1,1,0,0,0,0,1,0,0,0,1,0,1,1,0
1,0,0,1,1,1,2,5.33,1.5,12,0,4,0.67,0.67,1,3,1,3,2,0
1,0,0,1,1,1,2,5.33,1.5,12,0,4,0.67,0.67,1,3,1,3,2,0
1,0,0,1,1,1,2,0,0,0,0,4,0,0,0,4,0,4,2,0
1,0,0,1,1,1,1,0,0,0,0,1,0,0,0,1,0,1,1,0
1,0,0,1,1,1,2,0,0,0,0,5,0,0,0,5,0,5,2,0
1,0,0,1,1,1,1,0,0,0,0,1,0,0,0,1,0,1,1,0
1,0,0,1,1,1,2,5.33,1.5,12,0,4,0.67,0.67,1,3,1,3,2,0
1,0,0,1,1,1,2,5.33,1.5,12,0,4,0.67,0.67,1,3,1,3,2,0
1,0,0,1,1,1,1,0,0,0,0,1,0,0,0,1,0,1,1,0
1,0,0,1,1,1,2,7.86,2.5,49.13,0.01,7,0.4,2.73,2,5,2,5,2,0
1,0,0,1,1,1,2,7.49,3,67.38,0.01,8,0.33,3.74,1,7,1,6,2,0
1,0,0,1,1,1,2,7.49,3,67.38,0.01,8,0.33,3.74,1,7,1,6,2,0
1,0,0,1,1,1,2,7.49,3,67.38,0.01,8,0.33,3.74,1,7,1,6,2,0
1,0,0,1,1,1,2,7.49,3,67.38,0.01,8,0.33,3.74,1,7,1,6,2,0
1,0,0,1,1,1,2,7.49,3,67.38,0.01,8,0.33,3.74,1,7,1,6,2,0
1,0,0,1,1,1,2,7.49,3,67.38,0.01,8,0.33,3.74,1,7,1,6,2,0
1,0,0,1,1,1,2,7.49,3,67.38,0.01,8,0.33,3.74,1,7,1,6,2,0
1,0,0,1,1,1,2,10.57,3,95.1,0.01,10,0.33,5.28,3,7,3,6,2,0
1,0,0,1,1,1,0,0,0,0,0,1,0,0,0,1,0,1,0,0
1,0,0,1,1,1,2,5.33,1.5,12,0,4,0.67,0.67,1,3,1,3,2,0
1,0,0,1,1,1,2,5.33,1.5,12,0,4,0.67,0.67,1,3,1,3,2,0
1,0,0,1,1,1,2,5.33,1.5,12,0,4,0.67,0.67,1,3,1,3,2,0
1,0,0,1,1,1,2,5.33,1.5,12,0,4,0.67,0.67,1,3,1,3,2,0
1,0,0,1,1,1,2,5.33,1.5,12,0,4,0.67,0.67,1,3,1,3,2,0
1,0,0,1,1,1,2,5.33,1.5,12,0,4,0.67,0.67,1,3,1,3,2,0
1,0,0,1,1,1,2,5.33,1.5,12,0,4,0.67,0.67,1,3,1,3,2,0
1,0,0,1,1,1,2,13.95,2.5,87.17,0.01,11,0.4,4.84,4,7,4,5,2,0
1,0,0,1,1,1,1,0,0,0,0,1,0,0,0,1,0,1,1,0
1,0,0,1,1,1,1,0,0,0,0,1,0,0,0,1,0,1,1,0
1,0,0,1,1,1,1,0,0,0,0,1,0,0,0,1,0,1,1,0
1,0,0,1,1,1,1,0,0,0,0,1,0,0,0,1,0,1,1,0
1,0,0,1,1,1,1,0,0,0,0,1,0,0,0,1,0,1,1,0
1,0,0,1,1,1,1,0,0,0,0,1,0,0,0,1,0,1,1,0
1,0,0,1,1,1,0,0,0,0,0,1,0,0,0,1,0,1,0,0
9,2,18,5,2,3,42,75.51,9.82,7279.2,0.25,135,0.1,404.4,54,81,33,12,44,0
11,3,8,6,3,1,32,29.01,50.87,75080.63,0.49,272,0.02,4171.14,117,155,23,20,35,0
1,0,0,1,1,1,4,16.84,1.5,37.9,0.01,9,0.67,2.11,4,5,4,3,4,0
7,0,1,4,4,1,20,31.8,8.68,2394.74,0.09,61,0.12,133.04,27,34,14,9,20,0
5,0,6,3,3,1,30,64.75,11.43,8456.66,0.25,141,0.09,469.81,64,77,28,10,30,0
21,0,51,11,7,6,137,206.64,27.45,155671.12,1.89,838,0.04,8648.4,344,494,94,15,137,0
16,1,3,9,4,5,32,39.4,15.33,9262.93,0.2,110,0.07,514.61,46,64,27,18,33,0
9,1,2,5,4,4,22,25.01,14.12,4985.05,0.12,70,0.07,276.95,30,40,17,16,23,0
1,0,0,1,1,1,0,0,0,0,0,1,0,0,0,1,0,1,0,0
1,0,0,1,1,1,4,16.84,1.5,37.9,0.01,9,0.67,2.11,4,5,4,3,4,0
1,0,0,1,1,1,0,0,0,0,0,1,0,0,0,1,0,1,0,0
1,0,0,1,1,1,0,0,0,0,0,1,0,0,0,1,0,1,0,0
1,0,0,1,1,1,2,0,0,0,0,3,0,0,0,3,0,3,2,0
1,0,0,1,1,1,2,0,0,0,0,3,0,0,0,3,0,3,2,0
1,0,0,1,1,1,2,0,0,0,0,3,0,0,0,3,0,3,2,0
1,0,0,1,1,1,2,0,0,0,0,3,0,0,0,3,0,3,2,0
1,0,0,1,1,1,2,0,0,0,0,3,0,0,0,3,0,3,2,0
1,0,0,1,1,1,2,0,0,0,0,3,0,0,0,3,0,3,2,0
1,0,0,1,1,1,2,0,0,0,0,3,0,0,0,3,0,3,2,0
1,0,0,1,1,1,2,0,0,0,0,3,0,0,0,3,0,3,2,0
1,0,0,1,1,1,2,0,0,0,0,3,0,0,0,3,0,3,2,0
1,0,0,1,1,1,2,0,0,0,0,3,0,0,0,3,0,3,2,0
1,0,0,1,1,1,2,0,0,0,0,3,0,0,0,3,0,3,2,0
1,0,0,1,1,1,3,11.63,2,46.53,0.01,9,0.5,2.58,4,5,3,3,3,0
1,0,0,1,1,1,0,5.33,1.5,12,0,4,0.67,0.67,1,3,1,3,0,0
1,0,0,1,1,1,0,5.33,1.5,12,0,4,0.67,0.67,1,3,1,3,0,0
1,0,0,1,1,1,0,5.33,1.5,12,0,4,0.67,0.67,1,3,1,3,0,0
1,0,0,1,1,1,2,0,0,0,0,3,0,0,0,3,0,3,2,0
1,0,0,1,1,1,2,5.33,1.5,12,0,4,0.67,0.67,1,3,1,3,2,0
1,0,0,1,1,1,2,0,0,0,0,3,0,0,0,3,0,3,2,0
1,0,0,1,1,1,2,0,0,0,0,3,0,0,0,3,0,3,2,0
1,0,0,1,1,1,2,0,0,0,0,3,0,0,0,3,0,3,2,0
1,0,0,1,1,1,2,0,0,0,0,3,0,0,0,3,0,3,2,0
1,0,0,1,1,1,2,0,0,0,0,3,0,0,0,3,0,3,2,0
1,0,0,1,1,1,2,0,0,0,0,3,0,0,0,3,0,3,2,0
1,0,0,1,1,1,2,0,0,0,0,3,0,0,0,3,0,3,2,0
1,0,0,1,1,1,2,0,0,0,0,3,0,0,0,3,0,3,2,0
1,0,0,1,1,1,2,0,0,0,0,3,0,0,0,3,0,3,2,0
1,0,0,1,1,1,2,0,0,0,0,3,0,0,0,3,0,3,2,0
1,0,0,1,1,1,2,0,0,0,0,3,0,0,0,3,0,3,2,0
1,0,0,1,1,1,0,7.74,1.5,17.41,0,5,0.67,0.97,2,3,2,3,0,0
1,0,0,1,1,1,0,7.74,1.5,17.41,0,5,0.67,0.97,2,3,2,3,0,0
1,0,0,1,1,1,0,0,0,0,0,3,0,0,0,3,0,3,0,0
1,0,0,1,1,1,0,5.33,1.5,12,0,4,0.67,0.67,1,3,1,3,0,0
1,0,0,1,1,1,2,0,0,0,0,3,0,0,0,3,0,3,2,0
1,0,0,1,1,1,2,0,0,0,0,3,0,0,0,3,0,3,2,0
1,0,0,1,1,1,2,0,0,0,0,3,0,0,0,3,0,3,2,0
1,0,0,1,1,1,2,0,0,0,0,3,0,0,0,3,0,3,2,0
1,0,0,1,1,1,2,0,0,0,0,3,0,0,0,3,0,3,2,0
1,0,0,1,1,1,2,0,0,0,0,3,0,0,0,3,0,3,2,0
1,0,0,1,1,1,2,0,0,0,0,3,0,0,0,3,0,3,2,0
1,0,0,1,1,1,2,0,0,0,0,3,0,0,0,3,0,3,2,0
1,0,0,1,1,1,2,0,0,0,0,3,0,0,0,3,0,3,2,0
1,0,0,1,1,1,2,0,0,0,0,3,0,0,0,3,0,3,2,0
1,0,0,1,1,1,2,0,0,0,0,3,0,0,0,3,0,3,2,0
1,0,0,1,1,1,0,0,0,0,0,1,0,0,0,1,0,1,0,0
5,0,5,3,1,1,7,13.32,13.71,2505.06,0.06,43,0.07,139.17,16,27,7,12,7,0
5,0,5,3,1,1,7,13.32,13.71,2505.06,0.06,43,0.07,139.17,16,27,7,12,7,0
9,2,1,8,1,1,27,34.09,9.88,3329.22,0.11,68,0.1,184.96,24,44,17,14,29,0
3,0,1,2,1,1,2,12.09,6.3,479.73,0.03,20,0.16,26.65,7,13,5,9,2,0
1,0,0,1,1,1,2,5.33,1.5,12,0,4,0.67,0.67,1,3,1,3,2,0
1,0,0,1,1,1,2,5.33,1.5,12,0,4,0.67,0.67,1,3,1,3,2,0
1,0,0,1,1,1,2,5.33,1.5,12,0,4,0.67,0.67,1,3,1,3,2,0
1,0,0,1,1,1,2,5.33,1.5,12,0,4,0.67,0.67,1,3,1,3,2,0
1,0,0,1,1,1,2,5.33,1.5,12,0,4,0.67,0.67,1,3,1,3,2,0
1,0,0,1,1,1,2,5.33,1.5,12,0,4,0.67,0.67,1,3,1,3,2,0
1,0,0,1,1,1,2,5.33,1.5,12,0,4,0.67,0.67,1,3,1,3,2,0
1,0,0,1,1,1,2,5.33,1.5,12,0,4,0.67,0.67,1,3,1,3,2,0
1,0,0,1,1,1,2,5.33,1.5,12,0,4,0.67,0.67,1,3,1,3,2,0
1,0,0,1,1,1,2,0,0,0,0,4,0,0,0,4,0,4,2,0
1,0,0,1,1,1,1,0,0,0,0,1,0,0,0,1,0,1,1,0
1,0,0,1,1,1,2,0,0,0,0,5,0,0,0,5,0,5,2,0
11,1,4,6,1,1,21,13.86,22.5,7014.99,0.1,68,0.04,389.72,27,41,9,15,22,0
1,0,0,1,1,1,2,20.97,3,188.72,0.02,17,0.33,10.48,7,10,7,6,2,0
1,0,0,1,1,1,2,20.97,3,188.72,0.02,17,0.33,10.48,7,10,7,6,2,0
1,0,0,1,1,1,2,27.35,3,246.13,0.03,21,0.33,13.67,9,12,9,6,2,0
1,0,0,1,1,1,3,30.67,3,276,0.03,23,0.33,15.33,10,13,10,6,3,0
1,0,0,1,1,1,3,30.67,3,276,0.03,23,0.33,15.33,10,13,10,6,3,0
1,0,0,1,1,1,3,30.67,3,276,0.03,23,0.33,15.33,10,13,10,6,3,0
1,0,0,1,1,1,2,27.35,3,246.13,0.03,21,0.33,13.67,9,12,9,6,2,0
1,0,0,1,1,1,3,27.35,3,246.13,0.03,21,0.33,13.67,9,12,9,6,3,0
1,0,0,1,1,1,2,20.97,3,188.72,0.02,17,0.33,10.48,7,10,7,6,2,0
1,0,0,1,1,1,2,20.97,3,188.72,0.02,17,0.33,10.48,7,10,7,6,2,0
1,0,0,1,1,1,2,20.97,3,188.72,0.02,17,0.33,10.48,7,10,7,6,2,0
1,0,0,1,1,1,2,17.92,3,161.32,0.02,15,0.33,8.96,6,9,6,6,2,0
1,0,0,1,1,1,2,17.92,3,161.32,0.02,15,0.33,8.96,6,9,6,6,2,0
1,0,0,1,1,1,2,14.99,3,134.92,0.01,13,0.33,7.5,5,8,5,6,2,0
1,0,0,1,1,1,2,14.99,3,134.92,0.01,13,0.33,7.5,5,8,5,6,2,0
1,0,0,1,1,1,2,14.99,3,134.92,0.01,13,0.33,7.5,5,8,5,6,2,0
1,0,0,1,1,1,2,14.99,3,134.92,0.01,13,0.33,7.5,5,8,5,6,2,0
1,0,0,1,1,1,2,14.99,3,134.92,0.01,13,0.33,7.5,5,8,5,6,2,0
1,0,0,1,1,1,2,17.92,3,161.32,0.02,15,0.33,8.96,6,9,6,6,2,0
1,0,0,1,1,1,2,17.92,3,161.32,0.02,15,0.33,8.96,6,9,6,6,2,0
1,0,0,1,1,1,2,20.97,3,188.72,0.02,17,0.33,10.48,7,10,7,6,2,0
1,0,0,1,1,1,2,20.97,3,188.72,0.02,17,0.33,10.48,7,10,7,6,2,0
1,0,0,1,1,1,1,0,0,0,0,0,0,0,0,0,0,0,1,0
1,0,0,1,1,1,1,0,0,0,0,1,0,0,0,1,0,1,1,0
1,0,0,1,1,1,2,5.33,1.5,12,0,4,0.67,0.67,1,3,1,3,2,0
1,0,0,1,1,1,2,5.33,1.5,12,0,4,0.67,0.67,1,3,1,3,2,0
1,9,0,1,1,1,2,0,0,0,0,9,0,0,9,0,1,0,11,0
1,0,0,1,1,1,1,0,0,0,0,0,0,0,0,0,0,0,1,0
1,0,0,1,1,1,1,0,0,0,0,0,0,0,0,0,0,0,1,0
1,0,0,1,1,1,1,0,0,0,0,1,0,0,0,1,0,1,1,0
1,0,0,1,1,1,4,18.49,2.4,106.51,0.01,14,0.42,5.92,6,8,5,4,4,0
1,0,0,1,1,1,2,5.33,1.5,12,0,4,0.67,0.67,1,3,1,3,2,0
1,0,0,1,1,1,5,8.45,0.75,4.75,0,4,1.33,0.26,3,1,2,1,5,0
1,0,0,1,1,1,1,0,0,0,0,0,0,0,0,0,0,0,1,0
1,0,0,1,1,1,1,0,0,0,0,1,0,0,0,1,0,1,1,0
1,0,0,1,1,1,3,10.8,2.5,67.5,0.01,9,0.4,3.75,3,6,3,5,3,0
1,0,0,1,1,1,2,5.33,1.5,12,0,4,0.67,0.67,1,3,1,3,2,0
1,0,0,1,1,1,2,6.2,2.5,38.77,0.01,6,0.4,2.15,1,5,1,5,2,0
1,0,0,1,1,1,4,9.51,0.5,2.38,0,3,2,0.13,2,1,2,1,4,0
1,0,0,1,1,1,1,0,0,0,0,1,0,0,0,1,0,1,1,0
1,0,0,1,1,1,2,5.33,1.5,12,0,4,0.67,0.67,1,3,1,3,2,0
1,0,0,1,1,1,2,5.33,1.5,12,0,4,0.67,0.67,1,3,1,3,2,0
1,0,0,1,1,1,2,0,0,0,0,4,0,0,0,4,0,4,2,0
1,0,0,1,1,1,1,0,0,0,0,1,0,0,0,1,0,1,1,0
1,0,0,1,1,1,2,0,0,0,0,5,0,0,0,5,0,5,2,0
1,0,0,1,1,1,1,0,0,0,0,1,0,0,0,1,0,1,1,0
1,0,0,1,1,1,2,5.33,1.5,12,0,4,0.67,0.67,1,3,1,3,2,0
1,0,0,1,1,1,2,5.33,1.5,12,0,4,0.67,0.67,1,3,1,3,2,0
1,0,0,1,1,1,1,0,0,0,0,1,0,0,0,1,0,1,1,0
1,0,0,1,1,1,1,0,0,0,0,1,0,0,0,1,0,1,1,0
1,0,0,1,1,1,1,0,0,0,0,1,0,0,0,1,0,1,1,0
1,0,0,1,1,1,1,0,0,0,0,1,0,0,0,1,0,1,1,0
1,0,0,1,1,1,1,0,0,0,0,1,0,0,0,1,0,1,1,0
1,0,0,1,1,1,1,0,0,0,0,1,0,0,0,1,0,1,1,0
1,0,0,1,1,1,1,0,0,0,0,1,0,0,0,1,0,1,1,0
9,3,0,5,5,4,4,6.95,27.62,5307.06,0.06,47,0.04,294.84,17,30,4,13,7,0
1,0,0,1,1,1,0,0,0,0,0,1,0,0,0,1,0,1,0,0
7,2,32,4,2,3,37,84.16,10.54,9350.77,0.3,158,0.09,519.49,65,93,37,12,39,0
29,1,59,15,5,10,77,40.08,42.96,73978.89,0.57,310,0.02,4109.93,116,194,27,20,78,1
7,0,11,4,1,1,35,38.59,35.64,49007.13,0.46,266,0.03,2722.62,112,154,22,14,35,0
17,4,26,9,3,8,34,25.12,28.82,20871.52,0.24,139,0.03,1159.53,49,90,17,20,38,1
1,0,0,1,1,1,4,16.84,1.5,37.9,0.01,9,0.67,2.11,4,5,4,3,4,0
7,0,2,4,4,1,20,31.8,8.68,2394.74,0.09,61,0.12,133.04,27,34,14,9,20,0
11,0,1,6,6,1,30,41.4,12.75,6729.35,0.18,111,0.08,373.85,51,60,18,9,30,0
13,0,4,7,6,1,31,41.18,14.45,8603.82,0.2,117,0.07,477.99,53,64,22,12,31,0
5,0,7,3,3,1,43,77.39,19.82,30407.06,0.51,263,0.05,1689.28,111,152,42,15,43,0
55,0,103,28,17,13,307,406.71,33.1,445558.73,4.49,1793,0.03,24753.26,737,1056,167,15,307,1
9,1,0,5,3,3,18,29.68,10.8,3461.78,0.11,62,0.09,192.32,27,35,20,16,19,0
9,1,1,5,4,4,22,25.01,14.12,4985.05,0.12,70,0.07,276.95,30,40,17,16,23,0
1,0,0,1,1,1,0,0,0,0,0,1,0,0,0,1,0,1,0,0
1,0,0,1,1,1,4,16.84,1.5,37.9,0.01,9,0.67,2.11,4,5,4,3,4,0
1,0,0,1,1,1,0,0,0,0,0,1,0,0,0,1,0,1,0,0
1,0,0,1,1,1,0,0,0,0,0,1,0,0,0,1,0,1,0,0
1,0,0,1,1,1,2,0,0,0,0,3,0,0,0,3,0,3,2,0
1,0,0,1,1,1,2,0,0,0,0,3,0,0,0,3,0,3,2,0
1,0,0,1,1,1,2,0,0,0,0,3,0,0,0,3,0,3,2,0
1,0,0,1,1,1,2,0,0,0,0,3,0,0,0,3,0,3,2,0
1,0,0,1,1,1,2,0,0,0,0,3,0,0,0,3,0,3,2,0
1,0,0,1,1,1,2,0,0,0,0,3,0,0,0,3,0,3,2,0
1,0,0,1,1,1,2,0,0,0,0,3,0,0,0,3,0,3,2,0
1,0,0,1,1,1,2,0,0,0,0,3,0,0,0,3,0,3,2,0
1,0,0,1,1,1,2,0,0,0,0,3,0,0,0,3,0,3,2,0
1,0,0,1,1,1,2,0,0,0,0,3,0,0,0,3,0,3,2,0
1,0,0,1,1,1,2,0,0,0,0,3,0,0,0,3,0,3,2,0
1,0,0,1,1,1,3,11.63,2,46.53,0.01,9,0.5,2.58,4,5,3,3,3,0
1,0,0,1,1,1,0,5.33,1.5,12,0,4,0.67,0.67,1,3,1,3,0,0
1,0,0,1,1,1,0,5.33,1.5,12,0,4,0.67,0.67,1,3,1,3,0,0
1,0,0,1,1,1,0,5.33,1.5,12,0,4,0.67,0.67,1,3,1,3,0,0
1,0,0,1,1,1,2,0,0,0,0,3,0,0,0,3,0,3,2,0
1,0,0,1,1,1,2,5.33,1.5,12,0,4,0.67,0.67,1,3,1,3,2,0
1,0,0,1,1,1,2,0,0,0,0,3,0,0,0,3,0,3,2,0
1,0,0,1,1,1,2,0,0,0,0,3,0,0,0,3,0,3,2,0
1,0,0,1,1,1,2,0,0,0,0,3,0,0,0,3,0,3,2,0
1,0,0,1,1,1,2,0,0,0,0,3,0,0,0,3,0,3,2,0
1,0,0,1,1,1,2,0,0,0,0,3,0,0,0,3,0,3,2,0
1,0,0,1,1,1,2,0,0,0,0,3,0,0,0,3,0,3,2,0
1,0,0,1,1,1,2,0,0,0,0,3,0,0,0,3,0,3,2,0
1,0,0,1,1,1,2,0,0,0,0,3,0,0,0,3,0,3,2,0
1,0,0,1,1,1,2,0,0,0,0,3,0,0,0,3,0,3,2,0
1,0,0,1,1,1,2,0,0,0,0,3,0,0,0,3,0,3,2,0
1,0,0,1,1,1,2,0,0,0,0,3,0,0,0,3,0,3,2,0
1,0,0,1,1,1,0,7.74,1.5,17.41,0,5,0.67,0.97,2,3,2,3,0,0
1,0,0,1,1,1,0,7.74,1.5,17.41,0,5,0.67,0.97,2,3,2,3,0,0
1,0,0,1,1,1,0,0,0,0,0,3,0,0,0,3,0,3,0,0
1,0,0,1,1,1,0,5.33,1.5,12,0,4,0.67,0.67,1,3,1,3,0,0
1,0,0,1,1,1,2,0,0,0,0,3,0,0,0,3,0,3,2,0
1,0,0,1,1,1,2,0,0,0,0,3,0,0,0,3,0,3,2,0
1,0,0,1,1,1,2,0,0,0,0,3,0,0,0,3,0,3,2,0
1,0,0,1,1,1,2,0,0,0,0,3,0,0,0,3,0,3,2,0
1,0,0,1,1,1,2,0,0,0,0,3,0,0,0,3,0,3,2,0
1,0,0,1,1,1,2,0,0,0,0,3,0,0,0,3,0,3,2,0
1,0,0,1,1,1,2,0,0,0,0,3,0,0,0,3,0,3,2,0
1,0,0,1,1,1,2,0,0,0,0,3,0,0,0,3,0,3,2,0
1,0,0,1,1,1,2,0,0,0,0,3,0,0,0,3,0,3,2,0
1,0,0,1,1,1,2,0,0,0,0,3,0,0,0,3,0,3,2,0
1,0,0,1,1,1,2,0,0,0,0,3,0,0,0,3,0,3,2,0
1,0,0,1,1,1,0,0,0,0,0,1,0,0,0,1,0,1,0,0
5,0,5,3,1,1,7,13.32,13.71,2505.06,0.06,43,0.07,139.17,16,27,7,12,7,0
5,0,5,3,1,1,7,13.32,13.71,2505.06,0.06,43,0.07,139.17,16,27,7,12,7,0
9,2,1,8,1,1,27,34.09,9.88,3329.22,0.11,68,0.1,184.96,24,44,17,14,29,0
3,0,1,2,1,1,2,12.09,6.3,479.73,0.03,20,0.16,26.65,7,13,5,9,2,0
1,0,0,1,1,1,2,5.33,1.5,12,0,4,0.67,0.67,1,3,1,3,2,0
1,0,0,1,1,1,2,5.33,1.5,12,0,4,0.67,0.67,1,3,1,3,2,0
1,0,0,1,1,1,2,5.33,1.5,12,0,4,0.67,0.67,1,3,1,3,2,0
1,0,0,1,1,1,2,5.33,1.5,12,0,4,0.67,0.67,1,3,1,3,2,0
1,0,0,1,1,1,2,5.33,1.5,12,0,4,0.67,0.67,1,3,1,3,2,0
1,0,0,1,1,1,2,5.33,1.5,12,0,4,0.67,0.67,1,3,1,3,2,0
1,0,0,1,1,1,2,5.33,1.5,12,0,4,0.67,0.67,1,3,1,3,2,0
1,0,0,1,1,1,2,5.33,1.5,12,0,4,0.67,0.67,1,3,1,3,2,0
1,0,0,1,1,1,2,5.33,1.5,12,0,4,0.67,0.67,1,3,1,3,2,0
1,0,0,1,1,1,2,0,0,0,0,4,0,0,0,4,0,4,2,0
1,0,0,1,1,1,1,0,0,0,0,1,0,0,0,1,0,1,1,0
1,0,0,1,1,1,2,0,0,0,0,5,0,0,0,5,0,5,2,0
11,1,4,6,1,1,21,13.86,22.5,7014.99,0.1,68,0.04,389.72,27,41,9,15,22,0
1,0,0,1,1,1,2,20.97,3,188.72,0.02,17,0.33,10.48,7,10,7,6,2,0
1,0,0,1,1,1,2,20.97,3,188.72,0.02,17,0.33,10.48,7,10,7,6,2,0
1,0,0,1,1,1,2,27.35,3,246.13,0.03,21,0.33,13.67,9,12,9,6,2,0
1,0,0,1,1,1,3,30.67,3,276,0.03,23,0.33,15.33,10,13,10,6,3,0
1,0,0,1,1,1,3,30.67,3,276,0.03,23,0.33,15.33,10,13,10,6,3,0
1,0,0,1,1,1,3,30.67,3,276,0.03,23,0.33,15.33,10,13,10,6,3,0
1,0,0,1,1,1,2,27.35,3,246.13,0.03,21,0.33,13.67,9,12,9,6,2,0
1,0,0,1,1,1,3,27.35,3,246.13,0.03,21,0.33,13.67,9,12,9,6,3,0
1,0,0,1,1,1,2,20.97,3,188.72,0.02,17,0.33,10.48,7,10,7,6,2,0
1,0,0,1,1,1,2,20.97,3,188.72,0.02,17,0.33,10.48,7,10,7,6,2,0
1,0,0,1,1,1,2,20.97,3,188.72,0.02,17,0.33,10.48,7,10,7,6,2,0
1,0,0,1,1,1,2,17.92,3,161.32,0.02,15,0.33,8.96,6,9,6,6,2,0
1,0,0,1,1,1,2,17.92,3,161.32,0.02,15,0.33,8.96,6,9,6,6,2,0
1,0,0,1,1,1,2,14.99,3,134.92,0.01,13,0.33,7.5,5,8,5,6,2,0
1,0,0,1,1,1,2,14.99,3,134.92,0.01,13,0.33,7.5,5,8,5,6,2,0
1,0,0,1,1,1,2,14.99,3,134.92,0.01,13,0.33,7.5,5,8,5,6,2,0
1,0,0,1,1,1,2,14.99,3,134.92,0.01,13,0.33,7.5,5,8,5,6,2,0
1,0,0,1,1,1,2,14.99,3,134.92,0.01,13,0.33,7.5,5,8,5,6,2,0
1,0,0,1,1,1,2,17.92,3,161.32,0.02,15,0.33,8.96,6,9,6,6,2,0
1,0,0,1,1,1,2,17.92,3,161.32,0.02,15,0.33,8.96,6,9,6,6,2,0
1,0,0,1,1,1,2,20.97,3,188.72,0.02,17,0.33,10.48,7,10,7,6,2,0
1,0,0,1,1,1,2,20.97,3,188.72,0.02,17,0.33,10.48,7,10,7,6,2,0
1,0,0,1,1,1,1,0,0,0,0,0,0,0,0,0,0,0,1,0
1,0,0,1,1,1,1,0,0,0,0,1,0,0,0,1,0,1,1,0
1,0,0,1,1,1,2,5.33,1.5,12,0,4,0.67,0.67,1,3,1,3,2,0
1,0,0,1,1,1,2,5.33,1.5,12,0,4,0.67,0.67,1,3,1,3,2,0
1,9,0,1,1,1,2,0,0,0,0,9,0,0,9,0,1,0,11,0
1,0,0,1,1,1,1,0,0,0,0,0,0,0,0,0,0,0,1,0
1,0,0,1,1,1,1,0,0,0,0,0,0,0,0,0,0,0,1,0
1,0,0,1,1,1,1,0,0,0,0,1,0,0,0,1,0,1,1,0
1,0,0,1,1,1,4,18.49,2.4,106.51,0.01,14,0.42,5.92,6,8,5,4,4,0
1,0,0,1,1,1,2,5.33,1.5,12,0,4,0.67,0.67,1,3,1,3,2,0
1,0,0,1,1,1,5,8.45,0.75,4.75,0,4,1.33,0.26,3,1,2,1,5,0
1,0,0,1,1,1,1,0,0,0,0,0,0,0,0,0,0,0,1,0
1,0,0,1,1,1,1,0,0,0,0,1,0,0,0,1,0,1,1,0
1,0,0,1,1,1,3,10.8,2.5,67.5,0.01,9,0.4,3.75,3,6,3,5,3,0
1,0,0,1,1,1,2,5.33,1.5,12,0,4,0.67,0.67,1,3,1,3,2,0
1,0,0,1,1,1,2,6.2,2.5,38.77,0.01,6,0.4,2.15,1,5,1,5,2,0
1,0,0,1,1,1,4,9.51,0.5,2.38,0,3,2,0.13,2,1,2,1,4,0
1,0,0,1,1,1,1,0,0,0,0,1,0,0,0,1,0,1,1,0
1,0,0,1,1,1,2,5.33,1.5,12,0,4,0.67,0.67,1,3,1,3,2,0
1,0,0,1,1,1,2,5.33,1.5,12,0,4,0.67,0.67,1,3,1,3,2,0
1,0,0,1,1,1,2,0,0,0,0,4,0,0,0,4,0,4,2,0
1,0,0,1,1,1,1,0,0,0,0,1,0,0,0,1,0,1,1,0
1,0,0,1,1,1,2,0,0,0,0,5,0,0,0,5,0,5,2,0
1,0,0,1,1,1,1,0,0,0,0,1,0,0,0,1,0,1,1,0
1,0,0,1,1,1,2,5.33,1.5,12,0,4,0.67,0.67,1,3,1,3,2,0
1,0,0,1,1,1,2,5.33,1.5,12,0,4,0.67,0.67,1,3,1,3,2,0
1,0,0,1,1,1,1,0,0,0,0,1,0,0,0,1,0,1,1,0
1,0,0,1,1,1,1,0,0,0,0,1,0,0,0,1,0,1,1,0
1,0,0,1,1,1,1,0,0,0,0,1,0,0,0,1,0,1,1,0
1,0,0,1,1,1,1,0,0,0,0,1,0,0,0,1,0,1,1,0
1,0,0,1,1,1,1,0,0,0,0,1,0,0,0,1,0,1,1,0
1,0,0,1,1,1,1,0,0,0,0,1,0,0,0,1,0,1,1,0
1,0,0,1,1,1,1,0,0,0,0,1,0,0,0,1,0,1,1,0
9,3,0,5,5,4,4,6.95,27.62,5307.06,0.06,47,0.04,294.84,17,30,4,13,7,0
1,0,0,1,1,1,0,0,0,0,0,1,0,0,0,1,0,1,0,0
201,29,333,101,23,71,483,103.15,135.56,1895571.32,4.66,2062,0.01,105309.52,794,1268,82,28,512,1
17,3,52,9,2,1,71,40.84,23.26,22100,0.32,190,0.04,1227.78,68,122,19,13,74,0
43,2,120,22,2,1,126,50.4,38.79,75848.87,0.65,352,0.03,4213.83,125,227,29,18,128,0
1,0,1,1,1,1,4,11.39,3.5,139.52,0.01,12,0.29,7.75,3,9,3,7,4,0
9,1,1,5,1,1,26,11.4,37.14,15731.82,0.14,98,0.03,873.99,40,58,7,13,27,0
9,1,15,5,3,4,19,27.91,11.5,3690.89,0.11,70,0.09,205.05,23,47,12,12,20,0
1,7,0,1,1,1,10,63.01,11.44,8242.37,0.24,132,0.09,457.91,61,71,32,12,17,1
23,0,10,12,11,1,61,62.85,25,39281.55,0.52,277,0.04,2182.31,120,157,36,15,61,0
11,0,5,6,5,1,29,39.38,14.86,8692.29,0.2,115,0.07,482.91,48,67,21,13,29,0
21,0,9,11,8,1,46,46.02,21.7,21662.42,0.33,184,0.05,1203.47,81,103,28,15,46,0
1,0,1,1,1,1,3,7.24,2.5,45.24,0.01,7,0.4,2.51,1,6,1,5,3,0
3,0,18,2,2,1,35,60.99,27.71,46829.13,0.56,291,0.04,2601.62,117,174,38,18,35,0
65,0,176,33,17,17,449,453.43,54.23,1333692.61,8.2,3155,0.02,74094.03,1308,1847,205,17,449,1
16,1,0,12,10,3,40,44.65,23.91,25522.46,0.36,180,0.04,1417.91,79,101,38,23,41,0
10,1,0,9,2,1,25,27.4,10.77,3176.17,0.1,59,0.09,176.45,19,40,15,17,26,0
1,0,0,1,1,1,0,0,0,0,0,1,0,0,0,1,0,1,0,0
1,0,0,1,1,1,2,0,0,0,0,3,0,0,0,3,0,3,2,0
1,0,0,1,1,1,2,0,0,0,0,3,0,0,0,3,0,3,2,0
1,0,0,1,1,1,2,0,0,0,0,3,0,0,0,3,0,3,2,0
1,0,0,1,1,1,2,0,0,0,0,3,0,0,0,3,0,3,2,0
1,0,0,1,1,1,2,0,0,0,0,3,0,0,0,3,0,3,2,0
1,0,0,1,1,1,2,0,0,0,0,3,0,0,0,3,0,3,2,0
1,0,0,1,1,1,2,0,0,0,0,3,0,0,0,3,0,3,2,0
1,0,0,1,1,1,2,0,0,0,0,3,0,0,0,3,0,3,2,0
1,0,0,1,1,1,2,0,0,0,0,3,0,0,0,3,0,3,2,0
1,0,0,1,1,1,2,0,0,0,0,3,0,0,0,3,0,3,2,0
1,0,0,1,1,1,2,0,0,0,0,3,0,0,0,3,0,3,2,0
1,0,0,1,1,1,3,11.63,2,46.53,0.01,9,0.5,2.58,4,5,3,3,3,0
1,0,0,1,1,1,0,5.33,1.5,12,0,4,0.67,0.67,1,3,1,3,0,0
1,0,0,1,1,1,0,5.33,1.5,12,0,4,0.67,0.67,1,3,1,3,0,0
1,0,0,1,1,1,0,5.33,1.5,12,0,4,0.67,0.67,1,3,1,3,0,0
1,0,0,1,1,1,2,0,0,0,0,3,0,0,0,3,0,3,2,0
1,0,0,1,1,1,2,5.33,1.5,12,0,4,0.67,0.67,1,3,1,3,2,0
1,0,0,1,1,1,2,0,0,0,0,3,0,0,0,3,0,3,2,0
1,0,0,1,1,1,2,0,0,0,0,3,0,0,0,3,0,3,2,0
1,0,0,1,1,1,2,0,0,0,0,3,0,0,0,3,0,3,2,0
1,0,0,1,1,1,2,0,0,0,0,3,0,0,0,3,0,3,2,0
1,0,0,1,1,1,2,0,0,0,0,3,0,0,0,3,0,3,2,0
1,0,0,1,1,1,2,0,0,0,0,3,0,0,0,3,0,3,2,0
1,0,0,1,1,1,2,0,0,0,0,3,0,0,0,3,0,3,2,0
1,0,0,1,1,1,2,0,0,0,0,3,0,0,0,3,0,3,2,0
1,0,0,1,1,1,2,0,0,0,0,3,0,0,0,3,0,3,2,0
1,0,0,1,1,1,2,0,0,0,0,3,0,0,0,3,0,3,2,0
1,0,0,1,1,1,2,0,0,0,0,3,0,0,0,3,0,3,2,0
1,0,0,1,1,1,0,7.74,1.5,17.41,0,5,0.67,0.97,2,3,2,3,0,0
1,0,0,1,1,1,0,7.74,1.5,17.41,0,5,0.67,0.97,2,3,2,3,0,0
1,0,0,1,1,1,0,0,0,0,0,3,0,0,0,3,0,3,0,0
1,0,0,1,1,1,0,5.33,1.5,12,0,4,0.67,0.67,1,3,1,3,0,0
1,0,0,1,1,1,2,0,0,0,0,3,0,0,0,3,0,3,2,0
1,0,0,1,1,1,2,0,0,0,0,3,0,0,0,3,0,3,2,0
1,0,0,1,1,1,2,0,0,0,0,3,0,0,0,3,0,3,2,0
1,0,0,1,1,1,2,0,0,0,0,3,0,0,0,3,0,3,2,0
1,0,0,1,1,1,2,0,0,0,0,3,0,0,0,3,0,3,2,0
1,0,0,1,1,1,2,0,0,0,0,3,0,0,0,3,0,3,2,0
1,0,0,1,1,1,2,0,0,0,0,3,0,0,0,3,0,3,2,0
1,0,0,1,1,1,2,0,0,0,0,3,0,0,0,3,0,3,2,0
1,0,0,1,1,1,2,0,0,0,0,3,0,0,0,3,0,3,2,0
1,0,0,1,1,1,2,0,0,0,0,3,0,0,0,3,0,3,2,0
1,0,0,1,1,1,2,0,0,0,0,3,0,0,0,3,0,3,2,0
1,0,0,1,1,1,0,0,0,0,0,1,0,0,0,1,0,1,0,0
5,0,5,3,1,1,7,13.32,13.71,2505.06,0.06,43,0.07,139.17,16,27,7,12,7,0
5,0,5,3,1,1,7,13.32,13.71,2505.06,0.06,43,0.07,139.17,16,27,7,12,7,0
9,2,1,8,1,1,27,34.09,9.88,3329.22,0.11,68,0.1,184.96,24,44,17,14,29,0
3,0,1,2,1,1,2,12.09,6.3,479.73,0.03,20,0.16,26.65,7,13,5,9,2,0
1,0,0,1,1,1,2,5.33,1.5,12,0,4,0.67,0.67,1,3,1,3,2,0
1,0,0,1,1,1,2,5.33,1.5,12,0,4,0.67,0.67,1,3,1,3,2,0
1,0,0,1,1,1,2,5.33,1.5,12,0,4,0.67,0.67,1,3,1,3,2,0
1,0,0,1,1,1,2,5.33,1.5,12,0,4,0.67,0.67,1,3,1,3,2,0
1,0,0,1,1,1,2,5.33,1.5,12,0,4,0.67,0.67,1,3,1,3,2,0
1,0,0,1,1,1,2,5.33,1.5,12,0,4,0.67,0.67,1,3,1,3,2,0
1,0,0,1,1,1,2,5.33,1.5,12,0,4,0.67,0.67,1,3,1,3,2,0
1,0,0,1,1,1,2,5.33,1.5,12,0,4,0.67,0.67,1,3,1,3,2,0
1,0,0,1,1,1,2,5.33,1.5,12,0,4,0.67,0.67,1,3,1,3,2,0
1,0,0,1,1,1,2,0,0,0,0,4,0,0,0,4,0,4,2,0
1,0,0,1,1,1,1,0,0,0,0,1,0,0,0,1,0,1,1,0
1,0,0,1,1,1,2,0,0,0,0,5,0,0,0,5,0,5,2,0
11,1,4,6,1,1,21,13.86,22.5,7014.99,0.1,68,0.04,389.72,27,41,9,15,22,0
1,0,0,1,1,1,2,20.97,3,188.72,0.02,17,0.33,10.48,7,10,7,6,2,0
1,0,0,1,1,1,2,20.97,3,188.72,0.02,17,0.33,10.48,7,10,7,6,2,0
1,0,0,1,1,1,2,27.35,3,246.13,0.03,21,0.33,13.67,9,12,9,6,2,0
1,0,0,1,1,1,3,30.67,3,276,0.03,23,0.33,15.33,10,13,10,6,3,0
1,0,0,1,1,1,3,30.67,3,276,0.03,23,0.33,15.33,10,13,10,6,3,0
1,0,0,1,1,1,3,30.67,3,276,0.03,23,0.33,15.33,10,13,10,6,3,0
1,0,0,1,1,1,2,27.35,3,246.13,0.03,21,0.33,13.67,9,12,9,6,2,0
1,0,0,1,1,1,3,27.35,3,246.13,0.03,21,0.33,13.67,9,12,9,6,3,0
1,0,0,1,1,1,2,20.97,3,188.72,0.02,17,0.33,10.48,7,10,7,6,2,0
1,0,0,1,1,1,2,20.97,3,188.72,0.02,17,0.33,10.48,7,10,7,6,2,0
1,0,0,1,1,1,2,20.97,3,188.72,0.02,17,0.33,10.48,7,10,7,6,2,0
1,0,0,1,1,1,2,17.92,3,161.32,0.02,15,0.33,8.96,6,9,6,6,2,0
1,0,0,1,1,1,2,17.92,3,161.32,0.02,15,0.33,8.96,6,9,6,6,2,0
1,0,0,1,1,1,2,14.99,3,134.92,0.01,13,0.33,7.5,5,8,5,6,2,0
1,0,0,1,1,1,2,14.99,3,134.92,0.01,13,0.33,7.5,5,8,5,6,2,0
1,0,0,1,1,1,2,14.99,3,134.92,0.01,13,0.33,7.5,5,8,5,6,2,0
1,0,0,1,1,1,2,14.99,3,134.92,0.01,13,0.33,7.5,5,8,5,6,2,0
1,0,0,1,1,1,2,14.99,3,134.92,0.01,13,0.33,7.5,5,8,5,6,2,0
1,0,0,1,1,1,2,17.92,3,161.32,0.02,15,0.33,8.96,6,9,6,6,2,0
1,0,0,1,1,1,2,17.92,3,161.32,0.02,15,0.33,8.96,6,9,6,6,2,0
1,0,0,1,1,1,2,20.97,3,188.72,0.02,17,0.33,10.48,7,10,7,6,2,0
1,0,0,1,1,1,2,20.97,3,188.72,0.02,17,0.33,10.48,7,10,7,6,2,0
1,0,0,1,1,1,1,0,0,0,0,0,0,0,0,0,0,0,1,0
1,0,0,1,1,1,1,0,0,0,0,1,0,0,0,1,0,1,1,0
1,0,0,1,1,1,2,5.33,1.5,12,0,4,0.67,0.67,1,3,1,3,2,0
1,0,0,1,1,1,2,5.33,1.5,12,0,4,0.67,0.67,1,3,1,3,2,0
1,9,0,1,1,1,2,0,0,0,0,9,0,0,9,0,1,0,11,0
1,0,0,1,1,1,1,0,0,0,0,0,0,0,0,0,0,0,1,0
1,0,0,1,1,1,1,0,0,0,0,0,0,0,0,0,0,0,1,0
1,0,0,1,1,1,1,0,0,0,0,1,0,0,0,1,0,1,1,0
1,0,0,1,1,1,4,18.49,2.4,106.51,0.01,14,0.42,5.92,6,8,5,4,4,0
1,0,0,1,1,1,2,5.33,1.5,12,0,4,0.67,0.67,1,3,1,3,2,0
1,0,0,1,1,1,5,8.45,0.75,4.75,0,4,1.33,0.26,3,1,2,1,5,0
1,0,0,1,1,1,1,0,0,0,0,0,0,0,0,0,0,0,1,0
1,0,0,1,1,1,1,0,0,0,0,1,0,0,0,1,0,1,1,0
1,0,0,1,1,1,3,10.8,2.5,67.5,0.01,9,0.4,3.75,3,6,3,5,3,0
1,0,0,1,1,1,2,5.33,1.5,12,0,4,0.67,0.67,1,3,1,3,2,0
1,0,0,1,1,1,2,6.2,2.5,38.77,0.01,6,0.4,2.15,1,5,1,5,2,0
1,0,0,1,1,1,4,9.51,0.5,2.38,0,3,2,0.13,2,1,2,1,4,0
1,0,0,1,1,1,1,0,0,0,0,1,0,0,0,1,0,1,1,0
1,0,0,1,1,1,2,5.33,1.5,12,0,4,0.67,0.67,1,3,1,3,2,0
1,0,0,1,1,1,2,5.33,1.5,12,0,4,0.67,0.67,1,3,1,3,2,0
1,0,0,1,1,1,2,0,0,0,0,4,0,0,0,4,0,4,2,0
1,0,0,1,1,1,1,0,0,0,0,1,0,0,0,1,0,1,1,0
1,0,0,1,1,1,2,0,0,0,0,5,0,0,0,5,0,5,2,0
1,0,0,1,1,1,1,0,0,0,0,1,0,0,0,1,0,1,1,0
1,0,0,1,1,1,2,5.33,1.5,12,0,4,0.67,0.67,1,3,1,3,2,0
1,0,0,1,1,1,2,5.33,1.5,12,0,4,0.67,0.67,1,3,1,3,2,0
1,0,0,1,1,1,1,0,0,0,0,1,0,0,0,1,0,1,1,0
1,0,0,1,1,1,1,0,0,0,0,1,0,0,0,1,0,1,1,0
1,0,0,1,1,1,1,0,0,0,0,1,0,0,0,1,0,1,1,0
1,0,0,1,1,1,1,0,0,0,0,1,0,0,0,1,0,1,1,0
1,0,0,1,1,1,1,0,0,0,0,1,0,0,0,1,0,1,1,0
1,0,0,1,1,1,1,0,0,0,0,1,0,0,0,1,0,1,1,0
1,0,0,1,1,1,1,0,0,0,0,1,0,0,0,1,0,1,1,0
9,3,0,5,5,4,4,6.95,27.62,5307.06,0.06,47,0.04,294.84,17,30,4,13,7,0
1,0,0,1,1,1,0,0,0,0,0,1,0,0,0,1,0,1,0,0
1,0,0,1,1,1,0,0,0,0,0,1,0,0,0,1,0,1,0,0
5,8,27,3,1,3,39,60.78,28.63,49824.37,0.58,301,0.03,2768.02,128,173,38,17,47,1
59,8,87,30,18,20,153,61.35,61.06,228723.65,1.25,622,0.02,12706.87,223,399,42,23,161,1
17,0,17,9,2,1,73,45.32,64.72,189857.5,0.98,544,0.02,10547.64,233,311,27,15,73,0
5,0,11,3,1,3,13,17.88,10.56,1994.94,0.06,43,0.09,110.83,13,30,8,13,13,0
1,0,0,1,1,1,4,16.84,1.5,37.9,0.01,9,0.67,2.11,4,5,4,3,4,0
7,0,1,4,4,1,20,31.8,8.68,2394.74,0.09,61,0.12,133.04,27,34,14,9,20,0
15,0,1,8,8,1,45,50.01,17.42,15175.54,0.29,166,0.06,843.09,67,99,25,13,45,0
11,0,3,6,5,1,27,37.4,12.3,5658,0.15,92,0.08,314.33,41,51,20,12,27,0
5,0,7,3,3,1,38,65.82,21.46,30308.48,0.47,249,0.05,1683.8,103,146,36,15,38,0
49,0,112,25,15,12,306,416.4,33.75,474307.58,4.68,1866,0.03,26350.42,765,1101,170,15,306,1
3,1,0,2,2,1,9,21.6,5,540,0.04,27,0.2,30,10,17,8,8,10,0
9,1,1,5,4,4,23,22.79,15.94,5788.44,0.12,72,0.06,321.58,30,42,16,17,24,0
1,0,0,1,1,1,0,0,0,0,0,1,0,0,0,1,0,1,0,0
1,0,0,1,1,1,4,16.84,1.5,37.9,0.01,9,0.67,2.11,4,5,4,3,4,0
1,0,0,1,1,1,0,0,0,0,0,1,0,0,0,1,0,1,0,0
1,0,0,1,1,1,2,0,0,0,0,3,0,0,0,3,0,3,2,0
1,0,0,1,1,1,2,0,0,0,0,3,0,0,0,3,0,3,2,0
1,0,0,1,1,1,2,0,0,0,0,3,0,0,0,3,0,3,2,0
1,0,0,1,1,1,2,0,0,0,0,3,0,0,0,3,0,3,2,0
1,0,0,1,1,1,2,0,0,0,0,3,0,0,0,3,0,3,2,0
1,0,0,1,1,1,2,0,0,0,0,3,0,0,0,3,0,3,2,0
1,0,0,1,1,1,2,0,0,0,0,3,0,0,0,3,0,3,2,0
1,0,0,1,1,1,2,0,0,0,0,3,0,0,0,3,0,3,2,0
1,0,0,1,1,1,2,0,0,0,0,3,0,0,0,3,0,3,2,0
1,0,0,1,1,1,2,0,0,0,0,3,0,0,0,3,0,3,2,0
1,0,0,1,1,1,2,0,0,0,0,3,0,0,0,3,0,3,2,0
1,0,0,1,1,1,3,11.63,2,46.53,0.01,9,0.5,2.58,4,5,3,3,3,0
1,0,0,1,1,1,0,5.33,1.5,12,0,4,0.67,0.67,1,3,1,3,0,0
1,0,0,1,1,1,0,5.33,1.5,12,0,4,0.67,0.67,1,3,1,3,0,0
1,0,0,1,1,1,0,5.33,1.5,12,0,4,0.67,0.67,1,3,1,3,0,0
1,0,0,1,1,1,2,0,0,0,0,3,0,0,0,3,0,3,2,0
1,0,0,1,1,1,2,5.33,1.5,12,0,4,0.67,0.67,1,3,1,3,2,0
1,0,0,1,1,1,2,0,0,0,0,3,0,0,0,3,0,3,2,0
1,0,0,1,1,1,2,0,0,0,0,3,0,0,0,3,0,3,2,0
1,0,0,1,1,1,2,0,0,0,0,3,0,0,0,3,0,3,2,0
1,0,0,1,1,1,2,0,0,0,0,3,0,0,0,3,0,3,2,0
1,0,0,1,1,1,2,0,0,0,0,3,0,0,0,3,0,3,2,0
1,0,0,1,1,1,2,0,0,0,0,3,0,0,0,3,0,3,2,0
1,0,0,1,1,1,2,0,0,0,0,3,0,0,0,3,0,3,2,0
1,0,0,1,1,1,2,0,0,0,0,3,0,0,0,3,0,3,2,0
1,0,0,1,1,1,2,0,0,0,0,3,0,0,0,3,0,3,2,0
1,0,0,1,1,1,2,0,0,0,0,3,0,0,0,3,0,3,2,0
1,0,0,1,1,1,2,0,0,0,0,3,0,0,0,3,0,3,2,0
1,0,0,1,1,1,0,7.74,1.5,17.41,0,5,0.67,0.97,2,3,2,3,0,0
1,0,0,1,1,1,0,7.74,1.5,17.41,0,5,0.67,0.97,2,3,2,3,0,0
1,0,0,1,1,1,0,0,0,0,0,3,0,0,0,3,0,3,0,0
1,0,0,1,1,1,0,5.33,1.5,12,0,4,0.67,0.67,1,3,1,3,0,0
1,0,0,1,1,1,2,0,0,0,0,3,0,0,0,3,0,3,2,0
1,0,0,1,1,1,2,0,0,0,0,3,0,0,0,3,0,3,2,0
1,0,0,1,1,1,2,0,0,0,0,3,0,0,0,3,0,3,2,0
1,0,0,1,1,1,2,0,0,0,0,3,0,0,0,3,0,3,2,0
1,0,0,1,1,1,2,0,0,0,0,3,0,0,0,3,0,3,2,0
1,0,0,1,1,1,2,0,0,0,0,3,0,0,0,3,0,3,2,0
1,0,0,1,1,1,2,0,0,0,0,3,0,0,0,3,0,3,2,0
1,0,0,1,1,1,2,0,0,0,0,3,0,0,0,3,0,3,2,0
1,0,0,1,1,1,2,0,0,0,0,3,0,0,0,3,0,3,2,0
1,0,0,1,1,1,2,0,0,0,0,3,0,0,0,3,0,3,2,0
1,0,0,1,1,1,2,0,0,0,0,3,0,0,0,3,0,3,2,0
1,0,0,1,1,1,0,0,0,0,0,1,0,0,0,1,0,1,0,0
5,0,5,3,1,1,7,13.32,13.71,2505.06,0.06,43,0.07,139.17,16,27,7,12,7,0
5,0,5,3,1,1,7,13.32,13.71,2505.06,0.06,43,0.07,139.17,16,27,7,12,7,0
9,2,1,8,1,1,27,34.09,9.88,3329.22,0.11,68,0.1,184.96,24,44,17,14,29,0
3,0,1,2,1,1,2,12.09,6.3,479.73,0.03,20,0.16,26.65,7,13,5,9,2,0
1,0,0,1,1,1,2,5.33,1.5,12,0,4,0.67,0.67,1,3,1,3,2,0
1,0,0,1,1,1,2,5.33,1.5,12,0,4,0.67,0.67,1,3,1,3,2,0
1,0,0,1,1,1,2,5.33,1.5,12,0,4,0.67,0.67,1,3,1,3,2,0
1,0,0,1,1,1,2,5.33,1.5,12,0,4,0.67,0.67,1,3,1,3,2,0
1,0,0,1,1,1,2,5.33,1.5,12,0,4,0.67,0.67,1,3,1,3,2,0
1,0,0,1,1,1,2,5.33,1.5,12,0,4,0.67,0.67,1,3,1,3,2,0
1,0,0,1,1,1,2,5.33,1.5,12,0,4,0.67,0.67,1,3,1,3,2,0
1,0,0,1,1,1,2,5.33,1.5,12,0,4,0.67,0.67,1,3,1,3,2,0
1,0,0,1,1,1,2,5.33,1.5,12,0,4,0.67,0.67,1,3,1,3,2,0
1,0,0,1,1,1,2,0,0,0,0,4,0,0,0,4,0,4,2,0
1,0,0,1,1,1,1,0,0,0,0,1,0,0,0,1,0,1,1,0
1,0,0,1,1,1,2,0,0,0,0,5,0,0,0,5,0,5,2,0
11,1,4,6,1,1,21,13.86,22.5,7014.99,0.1,68,0.04,389.72,27,41,9,15,22,0
1,0,0,1,1,1,2,20.97,3,188.72,0.02,17,0.33,10.48,7,10,7,6,2,0
1,0,0,1,1,1,2,20.97,3,188.72,0.02,17,0.33,10.48,7,10,7,6,2,0
1,0,0,1,1,1,2,27.35,3,246.13,0.03,21,0.33,13.67,9,12,9,6,2,0
1,0,0,1,1,1,3,30.67,3,276,0.03,23,0.33,15.33,10,13,10,6,3,0
1,0,0,1,1,1,3,30.67,3,276,0.03,23,0.33,15.33,10,13,10,6,3,0
1,0,0,1,1,1,3,30.67,3,276,0.03,23,0.33,15.33,10,13,10,6,3,0
1,0,0,1,1,1,2,27.35,3,246.13,0.03,21,0.33,13.67,9,12,9,6,2,0
1,0,0,1,1,1,3,27.35,3,246.13,0.03,21,0.33,13.67,9,12,9,6,3,0
1,0,0,1,1,1,2,20.97,3,188.72,0.02,17,0.33,10.48,7,10,7,6,2,0
1,0,0,1,1,1,2,20.97,3,188.72,0.02,17,0.33,10.48,7,10,7,6,2,0
1,0,0,1,1,1,2,20.97,3,188.72,0.02,17,0.33,10.48,7,10,7,6,2,0
1,0,0,1,1,1,2,17.92,3,161.32,0.02,15,0.33,8.96,6,9,6,6,2,0
1,0,0,1,1,1,2,17.92,3,161.32,0.02,15,0.33,8.96,6,9,6,6,2,0
1,0,0,1,1,1,2,14.99,3,134.92,0.01,13,0.33,7.5,5,8,5,6,2,0
1,0,0,1,1,1,2,14.99,3,134.92,0.01,13,0.33,7.5,5,8,5,6,2,0
1,0,0,1,1,1,2,14.99,3,134.92,0.01,13,0.33,7.5,5,8,5,6,2,0
1,0,0,1,1,1,2,14.99,3,134.92,0.01,13,0.33,7.5,5,8,5,6,2,0
1,0,0,1,1,1,2,14.99,3,134.92,0.01,13,0.33,7.5,5,8,5,6,2,0
1,0,0,1,1,1,2,17.92,3,161.32,0.02,15,0.33,8.96,6,9,6,6,2,0
1,0,0,1,1,1,2,17.92,3,161.32,0.02,15,0.33,8.96,6,9,6,6,2,0
1,0,0,1,1,1,2,20.97,3,188.72,0.02,17,0.33,10.48,7,10,7,6,2,0
1,0,0,1,1,1,2,20.97,3,188.72,0.02,17,0.33,10.48,7,10,7,6,2,0
1,0,0,1,1,1,1,0,0,0,0,0,0,0,0,0,0,0,1,0
1,0,0,1,1,1,1,0,0,0,0,1,0,0,0,1,0,1,1,0
1,0,0,1,1,1,2,5.33,1.5,12,0,4,0.67,0.67,1,3,1,3,2,0
1,0,0,1,1,1,2,5.33,1.5,12,0,4,0.67,0.67,1,3,1,3,2,0
1,9,0,1,1,1,2,0,0,0,0,9,0,0,9,0,1,0,11,0
1,0,0,1,1,1,1,0,0,0,0,0,0,0,0,0,0,0,1,0
1,0,0,1,1,1,1,0,0,0,0,0,0,0,0,0,0,0,1,0
1,0,0,1,1,1,1,0,0,0,0,1,0,0,0,1,0,1,1,0
1,0,0,1,1,1,4,18.49,2.4,106.51,0.01,14,0.42,5.92,6,8,5,4,4,0
1,0,0,1,1,1,2,5.33,1.5,12,0,4,0.67,0.67,1,3,1,3,2,0
1,0,0,1,1,1,5,8.45,0.75,4.75,0,4,1.33,0.26,3,1,2,1,5,0
1,0,0,1,1,1,1,0,0,0,0,0,0,0,0,0,0,0,1,0
1,0,0,1,1,1,1,0,0,0,0,1,0,0,0,1,0,1,1,0
1,0,0,1,1,1,3,10.8,2.5,67.5,0.01,9,0.4,3.75,3,6,3,5,3,0
1,0,0,1,1,1,2,5.33,1.5,12,0,4,0.67,0.67,1,3,1,3,2,0
1,0,0,1,1,1,2,6.2,2.5,38.77,0.01,6,0.4,2.15,1,5,1,5,2,0
1,0,0,1,1,1,4,9.51,0.5,2.38,0,3,2,0.13,2,1,2,1,4,0
1,0,0,1,1,1,1,0,0,0,0,1,0,0,0,1,0,1,1,0
1,0,0,1,1,1,2,5.33,1.5,12,0,4,0.67,0.67,1,3,1,3,2,0
1,0,0,1,1,1,2,5.33,1.5,12,0,4,0.67,0.67,1,3,1,3,2,0
1,0,0,1,1,1,2,0,0,0,0,4,0,0,0,4,0,4,2,0
1,0,0,1,1,1,1,0,0,0,0,1,0,0,0,1,0,1,1,0
1,0,0,1,1,1,2,0,0,0,0,5,0,0,0,5,0,5,2,0
1,0,0,1,1,1,1,0,0,0,0,1,0,0,0,1,0,1,1,0
1,0,0,1,1,1,2,5.33,1.5,12,0,4,0.67,0.67,1,3,1,3,2,0
1,0,0,1,1,1,2,5.33,1.5,12,0,4,0.67,0.67,1,3,1,3,2,0
1,0,0,1,1,1,1,0,0,0,0,1,0,0,0,1,0,1,1,0
1,0,0,1,1,1,0,0,0,0,0,1,0,0,0,1,0,1,0,0
1,0,0,1,1,1,0,0,0,0,0,1,0,0,0,1,0,1,0,0
1,0,0,1,1,1,1,0,0,0,0,1,0,0,0,1,0,1,1,0
1,0,0,1,1,1,1,0,0,0,0,1,0,0,0,1,0,1,1,0
1,0,0,1,1,1,1,0,0,0,0,1,0,0,0,1,0,1,1,0
1,0,0,1,1,1,1,0,0,0,0,1,0,0,0,1,0,1,1,0
1,0,0,1,1,1,1,0,0,0,0,1,0,0,0,1,0,1,1,0
1,0,0,1,1,1,1,0,0,0,0,1,0,0,0,1,0,1,1,0
1,0,0,1,1,1,0,0,0,0,0,1,0,0,0,1,0,1,0,0
9,3,0,5,5,4,4,6.95,27.62,5307.06,0.06,47,0.04,294.84,17,30,4,13,7,0
1,0,0,1,1,1,0,0,0,0,0,1,0,0,0,1,0,1,0,0
1,0,0,1,1,1,0,0,0,0,0,1,0,0,0,1,0,1,0,0
23,3,94,12,6,7,156,70.16,41.11,118581.81,0.96,506,0.02,6587.88,185,321,36,16,159,1
25,2,85,13,11,1,127,108.3,26.92,78461.55,0.97,474,0.04,4358.97,171,303,54,17,129,1
1,0,1,1,1,1,2,5.33,1.5,12,0,4,0.67,0.67,1,3,1,3,2,1
1,0,1,1,1,1,18,3.68,12,529.4,0.01,19,0.08,29.41,16,3,2,3,18,1
11,1,6,6,5,1,32,33.14,17.39,10016.44,0.19,109,0.06,556.47,45,64,22,17,33,1
27,0,13,14,13,3,54,60.11,19.09,21915.75,0.38,209,0.05,1217.54,94,115,32,13,54,1
21,0,13,11,10,3,47,57.27,21,25257.03,0.4,219,0.05,1403.17,93,126,31,14,47,1
1,0,1,1,1,1,2,5.33,1.5,12,0,4,0.67,0.67,1,3,1,3,2,1
3,0,7,2,2,1,21,38.64,18.67,13464.51,0.24,147,0.05,748.03,56,91,18,12,21,1
3,0,6,2,2,1,14,19.02,12.5,2971.33,0.08,55,0.08,165.07,25,30,10,10,14,1
65,57,205,33,30,6,522,366.37,38.22,535081.35,4.67,1903,0.03,29726.74,707,1196,148,16,579,1
7,0,9,4,4,1,23,58.64,6.33,2352.09,0.12,81,0.16,130.66,38,43,18,6,23,1
17,2,10,9,6,4,35,41.51,14.7,8965.1,0.2,118,0.07,498.06,52,66,23,13,37,1
1,0,1,1,1,1,2,5.33,1.5,12,0,4,0.67,0.67,1,3,1,3,2,0
1,0,0,1,1,1,0,0,0,0,0,1,0,0,0,1,0,1,0,0
1,0,1,1,1,1,3,7.74,1.5,17.41,0,5,0.67,0.97,2,3,2,3,3,0
1,0,1,1,1,1,2,5.33,1.5,12,0,4,0.67,0.67,1,3,1,3,2,0
1,0,0,1,1,1,0,0,0,0,0,1,0,0,0,1,0,1,0,0
1,0,1,1,1,1,3,7.74,1.5,17.41,0,5,0.67,0.97,2,3,2,3,3,0
1,0,1,1,1,1,2,5.33,1.5,12,0,4,0.67,0.67,1,3,1,3,2,0
1,0,0,1,1,1,0,0,0,0,0,1,0,0,0,1,0,1,0,0
1,0,1,1,1,1,3,7.74,1.5,17.41,0,5,0.67,0.97,2,3,2,3,3,0
1,0,1,1,1,1,2,5.33,1.5,12,0,4,0.67,0.67,1,3,1,3,2,0
1,0,0,1,1,1,0,0,0,0,0,1,0,0,0,1,0,1,0,0
1,0,0,1,1,1,0,0,0,0,0,1,0,0,0,1,0,1,0,0
1,0,0,1,1,1,2,0,0,0,0,3,0,0,0,3,0,3,2,0
1,0,0,1,1,1,2,0,0,0,0,3,0,0,0,3,0,3,2,0
1,0,0,1,1,1,2,0,0,0,0,3,0,0,0,3,0,3,2,0
1,0,0,1,1,1,2,0,0,0,0,3,0,0,0,3,0,3,2,0
1,0,0,1,1,1,2,0,0,0,0,3,0,0,0,3,0,3,2,0
1,0,0,1,1,1,2,0,0,0,0,3,0,0,0,3,0,3,2,0
1,0,0,1,1,1,2,0,0,0,0,3,0,0,0,3,0,3,2,0
1,0,0,1,1,1,2,0,0,0,0,3,0,0,0,3,0,3,2,0
1,0,0,1,1,1,2,0,0,0,0,3,0,0,0,3,0,3,2,0
1,0,0,1,1,1,2,0,0,0,0,3,0,0,0,3,0,3,2,0
1,0,0,1,1,1,2,0,0,0,0,3,0,0,0,3,0,3,2,0
1,0,0,1,1,1,3,11.63,2,46.53,0.01,9,0.5,2.58,4,5,3,3,3,0
1,0,0,1,1,1,0,5.33,1.5,12,0,4,0.67,0.67,1,3,1,3,0,0
1,0,0,1,1,1,0,5.33,1.5,12,0,4,0.67,0.67,1,3,1,3,0,0
1,0,0,1,1,1,0,5.33,1.5,12,0,4,0.67,0.67,1,3,1,3,0,0
1,0,0,1,1,1,2,0,0,0,0,3,0,0,0,3,0,3,2,0
1,0,0,1,1,1,2,5.33,1.5,12,0,4,0.67,0.67,1,3,1,3,2,0
1,0,0,1,1,1,2,0,0,0,0,3,0,0,0,3,0,3,2,0
1,0,0,1,1,1,2,0,0,0,0,3,0,0,0,3,0,3,2,0
1,0,0,1,1,1,2,0,0,0,0,3,0,0,0,3,0,3,2,0
1,0,0,1,1,1,2,0,0,0,0,3,0,0,0,3,0,3,2,0
1,0,0,1,1,1,2,0,0,0,0,3,0,0,0,3,0,3,2,0
1,0,0,1,1,1,2,0,0,0,0,3,0,0,0,3,0,3,2,0
1,0,0,1,1,1,2,0,0,0,0,3,0,0,0,3,0,3,2,0
1,0,0,1,1,1,2,0,0,0,0,3,0,0,0,3,0,3,2,0
1,0,0,1,1,1,2,0,0,0,0,3,0,0,0,3,0,3,2,0
1,0,0,1,1,1,2,0,0,0,0,3,0,0,0,3,0,3,2,0
1,0,0,1,1,1,2,0,0,0,0,3,0,0,0,3,0,3,2,0
1,0,0,1,1,1,0,7.74,1.5,17.41,0,5,0.67,0.97,2,3,2,3,0,0
1,0,0,1,1,1,0,7.74,1.5,17.41,0,5,0.67,0.97,2,3,2,3,0,0
1,0,0,1,1,1,0,0,0,0,0,3,0,0,0,3,0,3,0,0
1,0,0,1,1,1,0,5.33,1.5,12,0,4,0.67,0.67,1,3,1,3,0,0
1,0,0,1,1,1,2,0,0,0,0,3,0,0,0,3,0,3,2,0
1,0,0,1,1,1,2,0,0,0,0,3,0,0,0,3,0,3,2,0
1,0,0,1,1,1,2,0,0,0,0,3,0,0,0,3,0,3,2,0
1,0,0,1,1,1,2,0,0,0,0,3,0,0,0,3,0,3,2,0
1,0,0,1,1,1,2,0,0,0,0,3,0,0,0,3,0,3,2,0
1,0,0,1,1,1,2,0,0,0,0,3,0,0,0,3,0,3,2,0
1,0,0,1,1,1,2,0,0,0,0,3,0,0,0,3,0,3,2,0
1,0,0,1,1,1,2,0,0,0,0,3,0,0,0,3,0,3,2,0
1,0,0,1,1,1,2,0,0,0,0,3,0,0,0,3,0,3,2,0
1,0,0,1,1,1,2,0,0,0,0,3,0,0,0,3,0,3,2,0
1,0,0,1,1,1,2,0,0,0,0,3,0,0,0,3,0,3,2,0
1,0,0,1,1,1,0,0,0,0,0,1,0,0,0,1,0,1,0,0
1,0,0,1,1,1,0,0,0,0,0,1,0,0,0,1,0,1,0,0
5,0,5,3,1,1,7,13.32,13.71,2505.06,0.06,43,0.07,139.17,16,27,7,12,7,0
5,0,5,3,1,1,7,13.32,13.71,2505.06,0.06,43,0.07,139.17,16,27,7,12,7,0
1,0,0,1,1,1,0,0,0,0,0,1,0,0,0,1,0,1,0,0
9,2,1,8,1,1,27,34.09,9.88,3329.22,0.11,68,0.1,184.96,24,44,17,14,29,0
1,0,0,1,1,1,1,0,0,0,0,1,0,0,0,1,0,1,1,0
1,0,0,1,1,1,0,0,0,0,0,1,0,0,0,1,0,1,0,0
1,0,0,1,1,1,0,0,0,0,0,1,0,0,0,1,0,1,0,0
1,0,0,1,1,1,2,13.18,5.25,363.24,0.02,20,0.19,20.18,6,14,4,7,2,0
3,0,1,2,1,1,2,12.09,6.3,479.73,0.03,20,0.16,26.65,7,13,5,9,2,0
1,0,0,1,1,1,2,5.33,1.5,12,0,4,0.67,0.67,1,3,1,3,2,0
1,0,0,1,1,1,2,5.33,1.5,12,0,4,0.67,0.67,1,3,1,3,2,0
1,0,0,1,1,1,2,5.33,1.5,12,0,4,0.67,0.67,1,3,1,3,2,0
1,0,0,1,1,1,2,5.33,1.5,12,0,4,0.67,0.67,1,3,1,3,2,0
1,0,0,1,1,1,2,5.33,1.5,12,0,4,0.67,0.67,1,3,1,3,2,0
1,0,0,1,1,1,2,5.33,1.5,12,0,4,0.67,0.67,1,3,1,3,2,0
1,0,0,1,1,1,2,5.33,1.5,12,0,4,0.67,0.67,1,3,1,3,2,0
1,0,0,1,1,1,2,5.33,1.5,12,0,4,0.67,0.67,1,3,1,3,2,0
1,0,0,1,1,1,2,5.33,1.5,12,0,4,0.67,0.67,1,3,1,3,2,0
1,0,0,1,1,1,2,5.33,1.5,12,0,4,0.67,0.67,1,3,1,3,2,0
1,0,0,1,1,1,2,5.33,1.5,12,0,4,0.67,0.67,1,3,1,3,2,0
1,0,0,1,1,1,2,5.33,1.5,12,0,4,0.67,0.67,1,3,1,3,2,0
1,0,0,1,1,1,2,5.33,1.5,12,0,4,0.67,0.67,1,3,1,3,2,0
1,0,0,1,1,1,2,11.3,6.13,423.78,0.02,20,0.16,23.54,7,13,4,7,2,0
1,0,0,1,1,1,2,0,0,0,0,4,0,0,0,4,0,4,2,0
1,0,0,1,1,1,0,0,0,0,0,5,0,0,0,5,0,5,0,0
1,0,0,1,1,1,0,0,0,0,0,5,0,0,0,5,0,5,0,0
1,0,0,1,1,1,1,0,0,0,0,1,0,0,0,1,0,1,1,0
1,0,0,1,1,1,2,0,0,0,0,5,0,0,0,5,0,5,2,0
11,1,4,6,1,1,21,13.86,22.5,7014.99,0.1,68,0.04,389.72,27,41,9,15,22,0
1,0,0,1,1,1,2,7.74,1.5,17.41,0,5,0.67,0.97,2,3,2,3,2,0
1,0,0,1,1,1,4,16.05,3.75,225.86,0.02,19,0.27,12.55,6,13,4,5,4,0
1,0,0,1,1,1,2,7.74,1.5,17.41,0,5,0.67,0.97,2,3,2,3,2,0
1,0,0,1,1,1,2,7.74,1.5,17.41,0,5,0.67,0.97,2,3,2,3,2,0
1,0,0,1,1,1,2,7.74,1.5,17.41,0,5,0.67,0.97,2,3,2,3,2,0
1,0,0,1,1,1,2,20.97,3,188.72,0.02,17,0.33,10.48,7,10,7,6,2,0
1,0,0,1,1,1,2,20.97,3,188.72,0.02,17,0.33,10.48,7,10,7,6,2,0
1,0,0,1,1,1,2,27.35,3,246.13,0.03,21,0.33,13.67,9,12,9,6,2,0
1,0,0,1,1,1,3,30.67,3,276,0.03,23,0.33,15.33,10,13,10,6,3,0
1,0,0,1,1,1,3,30.67,3,276,0.03,23,0.33,15.33,10,13,10,6,3,0
1,0,0,1,1,1,3,30.67,3,276,0.03,23,0.33,15.33,10,13,10,6,3,0
1,0,0,1,1,1,2,27.35,3,246.13,0.03,21,0.33,13.67,9,12,9,6,2,0
1,0,0,1,1,1,3,27.35,3,246.13,0.03,21,0.33,13.67,9,12,9,6,3,0
1,0,0,1,1,1,2,20.97,3,188.72,0.02,17,0.33,10.48,7,10,7,6,2,0
1,0,0,1,1,1,2,20.97,3,188.72,0.02,17,0.33,10.48,7,10,7,6,2,0
1,0,0,1,1,1,2,20.97,3,188.72,0.02,17,0.33,10.48,7,10,7,6,2,0
1,0,0,1,1,1,2,17.92,3,161.32,0.02,15,0.33,8.96,6,9,6,6,2,0
1,0,0,1,1,1,2,17.92,3,161.32,0.02,15,0.33,8.96,6,9,6,6,2,0
1,0,0,1,1,1,2,14.99,3,134.92,0.01,13,0.33,7.5,5,8,5,6,2,0
1,0,0,1,1,1,2,14.99,3,134.92,0.01,13,0.33,7.5,5,8,5,6,2,0
1,0,0,1,1,1,2,14.99,3,134.92,0.01,13,0.33,7.5,5,8,5,6,2,0
1,0,0,1,1,1,2,14.99,3,134.92,0.01,13,0.33,7.5,5,8,5,6,2,0
1,0,0,1,1,1,2,14.99,3,134.92,0.01,13,0.33,7.5,5,8,5,6,2,0
1,0,0,1,1,1,2,17.92,3,161.32,0.02,15,0.33,8.96,6,9,6,6,2,0
1,0,0,1,1,1,2,17.92,3,161.32,0.02,15,0.33,8.96,6,9,6,6,2,0
1,0,0,1,1,1,2,20.97,3,188.72,0.02,17,0.33,10.48,7,10,7,6,2,0
1,0,0,1,1,1,2,20.97,3,188.72,0.02,17,0.33,10.48,7,10,7,6,2,0
1,0,0,1,1,1,1,0,0,0,0,0,0,0,0,0,0,0,1,0
1,0,0,1,1,1,1,0,0,0,0,1,0,0,0,1,0,1,1,0
1,0,0,1,1,1,2,5.33,1.5,12,0,4,0.67,0.67,1,3,1,3,2,0
1,0,0,1,1,1,2,5.33,1.5,12,0,4,0.67,0.67,1,3,1,3,2,0
1,9,0,1,1,1,2,0,0,0,0,9,0,0,9,0,1,0,11,0
1,0,0,1,1,1,1,0,0,0,0,0,0,0,0,0,0,0,1,0
1,0,0,1,1,1,1,0,0,0,0,0,0,0,0,0,0,0,1,0
1,0,0,1,1,1,1,0,0,0,0,1,0,0,0,1,0,1,1,0
1,0,0,1,1,1,4,18.49,2.4,106.51,0.01,14,0.42,5.92,6,8,5,4,4,0
1,0,0,1,1,1,2,5.33,1.5,12,0,4,0.67,0.67,1,3,1,3,2,0
1,0,0,1,1,1,5,8.45,0.75,4.75,0,4,1.33,0.26,3,1,2,1,5,0
1,0,0,1,1,1,1,0,0,0,0,0,0,0,0,0,0,0,1,0
1,0,0,1,1,1,1,0,0,0,0,1,0,0,0,1,0,1,1,0
1,0,0,1,1,1,3,10.8,2.5,67.5,0.01,9,0.4,3.75,3,6,3,5,3,0
1,0,0,1,1,1,2,5.33,1.5,12,0,4,0.67,0.67,1,3,1,3,2,0
1,0,0,1,1,1,2,6.2,2.5,38.77,0.01,6,0.4,2.15,1,5,1,5,2,0
1,0,0,1,1,1,4,9.51,0.5,2.38,0,3,2,0.13,2,1,2,1,4,0
1,0,0,1,1,1,1,0,0,0,0,1,0,0,0,1,0,1,1,0
1,0,0,1,1,1,2,5.33,1.5,12,0,4,0.67,0.67,1,3,1,3,2,0
1,0,0,1,1,1,2,5.33,1.5,12,0,4,0.67,0.67,1,3,1,3,2,0
1,0,0,1,1,1,2,0,0,0,0,4,0,0,0,4,0,4,2,0
1,0,0,1,1,1,1,0,0,0,0,1,0,0,0,1,0,1,1,0
1,0,0,1,1,1,2,0,0,0,0,5,0,0,0,5,0,5,2,0
1,0,0,1,1,1,1,0,0,0,0,1,0,0,0,1,0,1,1,0
1,0,0,1,1,1,2,5.33,1.5,12,0,4,0.67,0.67,1,3,1,3,2,0
1,0,0,1,1,1,2,5.33,1.5,12,0,4,0.67,0.67,1,3,1,3,2,0
1,0,0,1,1,1,1,0,0,0,0,1,0,0,0,1,0,1,1,0
1,0,0,1,1,1,6,16.68,7.5,938.23,0.04,30,0.13,52.12,12,18,8,10,6,0
1,0,0,1,1,1,2,5.33,1.5,12,0,4,0.67,0.67,1,3,1,3,2,0
1,0,0,1,1,1,2,10.44,3.5,127.89,0.01,11,0.29,7.11,3,8,3,7,2,0
1,0,0,1,1,1,1,0,0,0,0,1,0,0,0,1,0,1,1,0
1,0,0,1,1,1,1,0,0,0,0,1,0,0,0,1,0,1,1,0
1,0,0,1,1,1,1,0,0,0,0,1,0,0,0,1,0,1,1,0
1,0,0,1,1,1,1,0,0,0,0,1,0,0,0,1,0,1,1,0
1,0,0,1,1,1,0,0,0,0,0,1,0,0,0,1,0,1,0,0
1,0,1,1,1,1,3,7.24,2.5,45.24,0.01,7,0.4,2.51,1,6,1,5,3,0
109,4,98,55,17,26,339,111.51,109.02,1325447.92,4.05,1807,0.01,73636,745,1062,82,24,343,1
1,0,0,1,1,1,5,16.21,2.25,82.12,0.01,13,0.44,4.56,6,7,4,3,5,1
3,0,0,2,2,1,8,16.18,6.43,668.57,0.03,26,0.16,37.14,10,16,7,9,8,0
3,0,0,2,2,1,9,27.54,5.09,713.65,0.05,33,0.2,39.65,14,19,11,8,9,1
1,0,4,1,1,1,28,38.7,23.22,20870.43,0.3,185,0.04,1159.47,76,109,18,11,28,1
11,2,72,6,5,3,254,196.35,36.42,260397.42,2.38,1081,0.03,14466.52,437,644,84,14,256,1
62,0,42,52,52,1,316,48.92,176.42,1522430.81,2.88,1207,0.01,84579.49,511,696,84,58,316,1
9,0,1,6,4,4,60,37.8,32.22,39260.58,0.41,180,0.03,2181.14,61,119,53,56,60,0
1,0,0,1,1,1,0,0,0,0,0,1,0,0,0,1,0,1,0,0
1,0,0,1,1,1,2,0,0,0,0,3,0,0,0,3,0,3,2,0
1,0,0,1,1,1,2,0,0,0,0,3,0,0,0,3,0,3,2,0
1,0,0,1,1,1,2,0,0,0,0,3,0,0,0,3,0,3,2,0
1,0,0,1,1,1,2,0,0,0,0,3,0,0,0,3,0,3,2,0
1,0,0,1,1,1,2,0,0,0,0,3,0,0,0,3,0,3,2,0
1,0,0,1,1,1,2,0,0,0,0,3,0,0,0,3,0,3,2,0
1,0,0,1,1,1,2,0,0,0,0,3,0,0,0,3,0,3,2,0
1,0,0,1,1,1,2,0,0,0,0,3,0,0,0,3,0,3,2,0
1,0,0,1,1,1,2,0,0,0,0,3,0,0,0,3,0,3,2,0
1,0,0,1,1,1,2,0,0,0,0,3,0,0,0,3,0,3,2,0
1,0,0,1,1,1,2,0,0,0,0,3,0,0,0,3,0,3,2,0
1,0,0,1,1,1,3,11.63,2,46.53,0.01,9,0.5,2.58,4,5,3,3,3,0
1,0,0,1,1,1,0,5.33,1.5,12,0,4,0.67,0.67,1,3,1,3,0,0
1,0,0,1,1,1,0,5.33,1.5,12,0,4,0.67,0.67,1,3,1,3,0,0
1,0,0,1,1,1,0,5.33,1.5,12,0,4,0.67,0.67,1,3,1,3,0,0
1,0,0,1,1,1,2,0,0,0,0,3,0,0,0,3,0,3,2,0
1,0,0,1,1,1,2,5.33,1.5,12,0,4,0.67,0.67,1,3,1,3,2,0
1,0,0,1,1,1,2,0,0,0,0,3,0,0,0,3,0,3,2,0
1,0,0,1,1,1,2,0,0,0,0,3,0,0,0,3,0,3,2,0
1,0,0,1,1,1,2,0,0,0,0,3,0,0,0,3,0,3,2,0
1,0,0,1,1,1,2,0,0,0,0,3,0,0,0,3,0,3,2,0
1,0,0,1,1,1,2,0,0,0,0,3,0,0,0,3,0,3,2,0
1,0,0,1,1,1,2,0,0,0,0,3,0,0,0,3,0,3,2,0
1,0,0,1,1,1,2,0,0,0,0,3,0,0,0,3,0,3,2,0
1,0,0,1,1,1,2,0,0,0,0,3,0,0,0,3,0,3,2,0
1,0,0,1,1,1,2,0,0,0,0,3,0,0,0,3,0,3,2,0
1,0,0,1,1,1,2,0,0,0,0,3,0,0,0,3,0,3,2,0
1,0,0,1,1,1,2,0,0,0,0,3,0,0,0,3,0,3,2,0
1,0,0,1,1,1,0,7.74,1.5,17.41,0,5,0.67,0.97,2,3,2,3,0,0
1,0,0,1,1,1,0,7.74,1.5,17.41,0,5,0.67,0.97,2,3,2,3,0,0
1,0,0,1,1,1,0,0,0,0,0,3,0,0,0,3,0,3,0,0
1,0,0,1,1,1,0,5.33,1.5,12,0,4,0.67,0.67,1,3,1,3,0,0
1,0,0,1,1,1,2,0,0,0,0,3,0,0,0,3,0,3,2,0
1,0,0,1,1,1,2,0,0,0,0,3,0,0,0,3,0,3,2,0
1,0,0,1,1,1,2,0,0,0,0,3,0,0,0,3,0,3,2,0
1,0,0,1,1,1,2,0,0,0,0,3,0,0,0,3,0,3,2,0
1,0,0,1,1,1,2,0,0,0,0,3,0,0,0,3,0,3,2,0
1,0,0,1,1,1,2,0,0,0,0,3,0,0,0,3,0,3,2,0
1,0,0,1,1,1,2,0,0,0,0,3,0,0,0,3,0,3,2,0
1,0,0,1,1,1,2,0,0,0,0,3,0,0,0,3,0,3,2,0
1,0,0,1,1,1,2,0,0,0,0,3,0,0,0,3,0,3,2,0
1,0,0,1,1,1,2,0,0,0,0,3,0,0,0,3,0,3,2,0
1,0,0,1,1,1,2,0,0,0,0,3,0,0,0,3,0,3,2,0
1,0,0,1,1,1,0,0,0,0,0,1,0,0,0,1,0,1,0,0
5,0,5,3,1,1,7,13.32,13.71,2505.06,0.06,43,0.07,139.17,16,27,7,12,7,0
5,0,5,3,1,1,7,13.32,13.71,2505.06,0.06,43,0.07,139.17,16,27,7,12,7,0
63,0,0,32,12,13,114,97.68,28.65,80196.9,0.93,444,0.03,4455.38,209,235,62,17,114,1
9,2,1,8,1,1,27,34.09,9.88,3329.22,0.11,68,0.1,184.96,24,44,17,14,29,0
3,0,1,2,1,1,2,12.09,6.3,479.73,0.03,20,0.16,26.65,7,13,5,9,2,0
1,0,0,1,1,1,2,5.33,1.5,12,0,4,0.67,0.67,1,3,1,3,2,0
1,0,0,1,1,1,2,5.33,1.5,12,0,4,0.67,0.67,1,3,1,3,2,0
1,0,0,1,1,1,2,5.33,1.5,12,0,4,0.67,0.67,1,3,1,3,2,0
1,0,0,1,1,1,2,5.33,1.5,12,0,4,0.67,0.67,1,3,1,3,2,0
1,0,0,1,1,1,2,5.33,1.5,12,0,4,0.67,0.67,1,3,1,3,2,0
1,0,0,1,1,1,2,5.33,1.5,12,0,4,0.67,0.67,1,3,1,3,2,0
1,0,0,1,1,1,2,5.33,1.5,12,0,4,0.67,0.67,1,3,1,3,2,0
11,1,4,6,1,1,21,13.86,22.5,7014.99,0.1,68,0.04,389.72,27,41,9,15,22,0
1,0,0,1,1,1,2,20.97,3,188.72,0.02,17,0.33,10.48,7,10,7,6,2,0
1,0,0,1,1,1,2,20.97,3,188.72,0.02,17,0.33,10.48,7,10,7,6,2,0
1,0,0,1,1,1,2,27.35,3,246.13,0.03,21,0.33,13.67,9,12,9,6,2,0
1,0,0,1,1,1,3,30.67,3,276,0.03,23,0.33,15.33,10,13,10,6,3,0
1,0,0,1,1,1,3,30.67,3,276,0.03,23,0.33,15.33,10,13,10,6,3,0
1,0,0,1,1,1,3,30.67,3,276,0.03,23,0.33,15.33,10,13,10,6,3,0
1,0,0,1,1,1,2,27.35,3,246.13,0.03,21,0.33,13.67,9,12,9,6,2,0
1,0,0,1,1,1,3,27.35,3,246.13,0.03,21,0.33,13.67,9,12,9,6,3,0
1,0,0,1,1,1,2,20.97,3,188.72,0.02,17,0.33,10.48,7,10,7,6,2,0
1,0,0,1,1,1,2,20.97,3,188.72,0.02,17,0.33,10.48,7,10,7,6,2,0
1,0,0,1,1,1,2,20.97,3,188.72,0.02,17,0.33,10.48,7,10,7,6,2,0
1,0,0,1,1,1,2,17.92,3,161.32,0.02,15,0.33,8.96,6,9,6,6,2,0
1,0,0,1,1,1,2,17.92,3,161.32,0.02,15,0.33,8.96,6,9,6,6,2,0
1,0,0,1,1,1,2,14.99,3,134.92,0.01,13,0.33,7.5,5,8,5,6,2,0
1,0,0,1,1,1,2,14.99,3,134.92,0.01,13,0.33,7.5,5,8,5,6,2,0
1,0,0,1,1,1,2,14.99,3,134.92,0.01,13,0.33,7.5,5,8,5,6,2,0
1,0,0,1,1,1,2,14.99,3,134.92,0.01,13,0.33,7.5,5,8,5,6,2,0
1,0,0,1,1,1,2,14.99,3,134.92,0.01,13,0.33,7.5,5,8,5,6,2,0
1,0,0,1,1,1,2,17.92,3,161.32,0.02,15,0.33,8.96,6,9,6,6,2,0
1,0,0,1,1,1,2,17.92,3,161.32,0.02,15,0.33,8.96,6,9,6,6,2,0
1,0,0,1,1,1,2,20.97,3,188.72,0.02,17,0.33,10.48,7,10,7,6,2,0
1,0,0,1,1,1,2,20.97,3,188.72,0.02,17,0.33,10.48,7,10,7,6,2,0
1,0,0,1,1,1,1,0,0,0,0,0,0,0,0,0,0,0,1,0
1,0,0,1,1,1,1,0,0,0,0,1,0,0,0,1,0,1,1,0
1,0,0,1,1,1,2,5.33,1.5,12,0,4,0.67,0.67,1,3,1,3,2,0
1,0,0,1,1,1,2,5.33,1.5,12,0,4,0.67,0.67,1,3,1,3,2,0
1,9,0,1,1,1,2,0,0,0,0,9,0,0,9,0,1,0,11,0
1,0,0,1,1,1,1,0,0,0,0,0,0,0,0,0,0,0,1,0
1,0,0,1,1,1,1,0,0,0,0,0,0,0,0,0,0,0,1,0
1,0,0,1,1,1,1,0,0,0,0,1,0,0,0,1,0,1,1,0
1,0,0,1,1,1,4,18.49,2.4,106.51,0.01,14,0.42,5.92,6,8,5,4,4,0
1,0,0,1,1,1,2,5.33,1.5,12,0,4,0.67,0.67,1,3,1,3,2,0
1,0,0,1,1,1,5,8.45,0.75,4.75,0,4,1.33,0.26,3,1,2,1,5,0
1,0,0,1,1,1,1,0,0,0,0,0,0,0,0,0,0,0,1,0
1,0,0,1,1,1,1,0,0,0,0,1,0,0,0,1,0,1,1,0
1,0,0,1,1,1,3,10.8,2.5,67.5,0.01,9,0.4,3.75,3,6,3,5,3,0
1,0,0,1,1,1,2,5.33,1.5,12,0,4,0.67,0.67,1,3,1,3,2,0
1,0,0,1,1,1,2,6.2,2.5,38.77,0.01,6,0.4,2.15,1,5,1,5,2,0
1,0,0,1,1,1,4,9.51,0.5,2.38,0,3,2,0.13,2,1,2,1,4,0
1,0,0,1,1,1,1,0,0,0,0,1,0,0,0,1,0,1,1,0
1,0,0,1,1,1,2,7.86,2.5,49.13,0.01,7,0.4,2.73,2,5,2,5,2,0
1,0,0,1,1,1,2,7.49,3,67.38,0.01,8,0.33,3.74,1,7,1,6,2,0
1,0,0,1,1,1,2,7.49,3,67.38,0.01,8,0.33,3.74,1,7,1,6,2,0
1,0,0,1,1,1,2,7.49,3,67.38,0.01,8,0.33,3.74,1,7,1,6,2,0
1,0,0,1,1,1,2,7.49,3,67.38,0.01,8,0.33,3.74,1,7,1,6,2,0
1,0,0,1,1,1,2,7.49,3,67.38,0.01,8,0.33,3.74,1,7,1,6,2,0
1,0,0,1,1,1,2,7.49,3,67.38,0.01,8,0.33,3.74,1,7,1,6,2,0
1,0,0,1,1,1,2,7.49,3,67.38,0.01,8,0.33,3.74,1,7,1,6,2,0
1,0,0,1,1,1,2,10.57,3,95.1,0.01,10,0.33,5.28,3,7,3,6,2,0
1,0,0,1,1,1,0,0,0,0,0,1,0,0,0,1,0,1,0,0
1,0,0,1,1,1,2,5.33,1.5,12,0,4,0.67,0.67,1,3,1,3,2,0
1,0,0,1,1,1,2,5.33,1.5,12,0,4,0.67,0.67,1,3,1,3,2,0
1,0,0,1,1,1,2,5.33,1.5,12,0,4,0.67,0.67,1,3,1,3,2,0
1,0,0,1,1,1,2,5.33,1.5,12,0,4,0.67,0.67,1,3,1,3,2,0
1,0,0,1,1,1,2,5.33,1.5,12,0,4,0.67,0.67,1,3,1,3,2,0
1,0,0,1,1,1,2,5.33,1.5,12,0,4,0.67,0.67,1,3,1,3,2,0
1,0,0,1,1,1,2,5.33,1.5,12,0,4,0.67,0.67,1,3,1,3,2,0
1,0,0,1,1,1,2,13.95,2.5,87.17,0.01,11,0.4,4.84,4,7,4,5,2,0
1,0,0,1,1,1,0,0,0,0,0,1,0,0,0,1,0,1,0,0
1,0,0,1,1,1,2,0,0,0,0,3,0,0,0,3,0,3,2,0
1,0,0,1,1,1,2,0,0,0,0,3,0,0,0,3,0,3,2,0
1,0,0,1,1,1,2,0,0,0,0,3,0,0,0,3,0,3,2,0
1,0,0,1,1,1,2,0,0,0,0,3,0,0,0,3,0,3,2,0
1,0,0,1,1,1,2,0,0,0,0,3,0,0,0,3,0,3,2,0
1,0,0,1,1,1,2,0,0,0,0,3,0,0,0,3,0,3,2,0
1,0,0,1,1,1,2,0,0,0,0,3,0,0,0,3,0,3,2,0
1,0,0,1,1,1,2,0,0,0,0,3,0,0,0,3,0,3,2,0
1,0,0,1,1,1,2,0,0,0,0,3,0,0,0,3,0,3,2,0
1,0,0,1,1,1,2,0,0,0,0,3,0,0,0,3,0,3,2,0
1,0,0,1,1,1,2,0,0,0,0,3,0,0,0,3,0,3,2,0
7,3,13,4,2,3,19,20.81,13,3516.67,0.09,59,0.08,195.37,26,33,12,12,22,1
7,3,13,4,2,3,19,21.49,14,4211.59,0.1,64,0.07,233.98,28,36,13,13,22,1
9,4,16,5,2,5,16,23.55,13.93,4569.79,0.11,69,0.07,253.88,30,39,14,13,20,1
1,0,0,1,1,1,4,8.45,0.75,4.75,0,4,1.33,0.26,3,1,2,1,4,0
3,1,12,2,2,1,11,25.76,8.08,1680.68,0.07,46,0.12,93.37,21,25,13,10,12,1
11,1,1,6,6,6,18,23.46,10.83,2753.7,0.08,57,0.09,152.98,26,31,12,10,19,1
130,22,37,68,7,13,222,48.71,95.41,443400.26,1.55,729,0.01,24633.35,275,454,49,34,244,1
126,22,37,66,6,12,217,50.27,89.67,404175.61,1.5,713,0.01,22454.2,269,444,48,32,239,1
126,22,37,66,6,12,217,50.27,89.67,404175.61,1.5,713,0.01,22454.2,269,444,48,32,239,1
198,26,44,102,11,21,277,70.75,111.23,875340.89,2.62,1165,0.01,48630.05,464,701,73,35,303,1
198,26,44,102,11,21,277,70.75,111.23,875340.89,2.62,1165,0.01,48630.05,464,701,73,35,303,1
190,24,42,98,10,21,260,65.25,113.33,838056.02,2.46,1113,0.01,46558.67,440,673,66,34,284,1
190,24,42,98,10,21,260,65.25,113.33,838056.02,2.46,1113,0.01,46558.67,440,673,66,34,284,1
72,9,14,39,3,3,145,37.02,63.15,147591.36,0.78,399,0.02,8199.52,145,254,31,27,154,1
5,3,16,3,2,1,18,20,13,3380.73,0.09,56,0.08,187.82,24,32,12,13,21,1
7,1,11,4,2,4,13,18.66,10.91,2220.66,0.07,45,0.09,123.37,20,25,11,12,14,1
3,1,12,2,2,1,11,25.76,8.08,1680.68,0.07,46,0.12,93.37,21,25,13,10,12,1
7,2,18,4,2,1,26,20.11,16.73,5630.15,0.11,70,0.06,312.79,29,41,13,15,28,1
11,3,16,6,3,5,22,21.41,24.97,13350.93,0.18,106,0.04,741.72,47,59,16,17,25,1
9,1,23,5,2,1,22,15.66,18.2,5186.72,0.09,63,0.05,288.15,28,35,10,13,23,1
9,1,23,5,2,1,22,15.66,18.2,5186.72,0.09,63,0.05,288.15,28,35,10,13,23,1
1,0,0,1,1,1,3,11.63,2,46.53,0.01,9,0.5,2.58,4,5,3,3,3,0
1,0,0,1,1,1,0,5.33,1.5,12,0,4,0.67,0.67,1,3,1,3,0,0
1,0,0,1,1,1,0,5.33,1.5,12,0,4,0.67,0.67,1,3,1,3,0,0
1,0,0,1,1,1,0,5.33,1.5,12,0,4,0.67,0.67,1,3,1,3,0,0
1,0,0,1,1,1,2,0,0,0,0,3,0,0,0,3,0,3,2,0
1,0,0,1,1,1,2,5.33,1.5,12,0,4,0.67,0.67,1,3,1,3,2,0
1,0,0,1,1,1,2,0,0,0,0,3,0,0,0,3,0,3,2,0
1,0,0,1,1,1,2,0,0,0,0,3,0,0,0,3,0,3,2,0
1,0,0,1,1,1,2,0,0,0,0,3,0,0,0,3,0,3,2,0
1,0,0,1,1,1,2,0,0,0,0,3,0,0,0,3,0,3,2,0
1,0,0,1,1,1,2,0,0,0,0,3,0,0,0,3,0,3,2,0
1,0,0,1,1,1,2,0,0,0,0,3,0,0,0,3,0,3,2,0
1,0,0,1,1,1,2,0,0,0,0,3,0,0,0,3,0,3,2,0
1,0,0,1,1,1,2,0,0,0,0,3,0,0,0,3,0,3,2,0
1,0,0,1,1,1,2,0,0,0,0,3,0,0,0,3,0,3,2,0
1,0,0,1,1,1,2,0,0,0,0,3,0,0,0,3,0,3,2,0
1,0,0,1,1,1,2,0,0,0,0,3,0,0,0,3,0,3,2,0
1,0,0,1,1,1,0,7.74,1.5,17.41,0,5,0.67,0.97,2,3,2,3,0,0
5,2,15,3,2,1,19,32.28,9.38,2837.13,0.1,59,0.11,157.62,25,34,20,15,21,1
1,0,0,1,1,1,0,7.74,1.5,17.41,0,5,0.67,0.97,2,3,2,3,0,0
1,0,0,1,1,1,0,0,0,0,0,3,0,0,0,3,0,3,0,0
1,0,0,1,1,1,0,5.33,1.5,12,0,4,0.67,0.67,1,3,1,3,0,0
1,0,0,1,1,1,2,0,0,0,0,3,0,0,0,3,0,3,2,0
1,0,0,1,1,1,2,0,0,0,0,3,0,0,0,3,0,3,2,0
1,0,0,1,1,1,2,0,0,0,0,3,0,0,0,3,0,3,2,0
1,0,0,1,1,1,2,0,0,0,0,3,0,0,0,3,0,3,2,0
1,0,0,1,1,1,2,0,0,0,0,3,0,0,0,3,0,3,2,0
1,0,0,1,1,1,2,0,0,0,0,3,0,0,0,3,0,3,2,0
1,0,0,1,1,1,2,0,0,0,0,3,0,0,0,3,0,3,2,0
1,0,0,1,1,1,2,0,0,0,0,3,0,0,0,3,0,3,2,0
1,0,0,1,1,1,2,0,0,0,0,3,0,0,0,3,0,3,2,0
1,0,0,1,1,1,2,0,0,0,0,3,0,0,0,3,0,3,2,0
1,0,0,1,1,1,2,0,0,0,0,3,0,0,0,3,0,3,2,0
5,0,5,3,1,1,7,13.32,13.71,2505.06,0.06,43,0.07,139.17,16,27,7,12,7,0
5,0,5,3,1,1,7,13.32,13.71,2505.06,0.06,43,0.07,139.17,16,27,7,12,7,0
9,2,1,8,1,1,27,34.09,9.88,3329.22,0.11,68,0.1,184.96,24,44,17,14,29,0
3,0,1,2,1,1,2,12.09,6.3,479.73,0.03,20,0.16,26.65,7,13,5,9,2,0
11,1,4,6,1,1,21,13.86,22.5,7014.99,0.1,68,0.04,389.72,27,41,9,15,22,0
1,0,0,1,1,1,1,0,0,0,0,1,0,0,0,1,0,1,1,0
1,0,0,1,1,1,0,0,0,0,0,1,0,0,0,1,0,1,0,0
1,0,0,1,1,1,0,0,0,0,0,1,0,0,0,1,0,1,0,0
1,0,0,1,1,1,0,0,0,0,0,1,0,0,0,1,0,1,0,0
1,0,0,1,1,1,1,0,0,0,0,1,0,0,0,1,0,1,1,0
1,0,0,1,1,1,1,0,0,0,0,1,0,0,0,1,0,1,1,0
1,0,0,1,1,1,1,0,0,0,0,1,0,0,0,1,0,1,1,0
1,0,0,1,1,1,1,0,0,0,0,1,0,0,0,1,0,1,1,0
1,0,0,1,1,1,1,0,0,0,0,1,0,0,0,1,0,1,1,0
1,0,0,1,1,1,1,0,0,0,0,1,0,0,0,1,0,1,1,0
9,3,0,5,5,4,4,6.95,27.62,5307.06,0.06,47,0.04,294.84,17,30,4,13,7,0
1,0,0,1,1,1,0,0,0,0,0,1,0,0,0,1,0,1,0,0
1,0,0,1,1,1,0,0,0,0,0,1,0,0,0,1,0,1,0,0
1,0,0,1,1,1,2,0,0,0,0,3,0,0,0,3,0,3,2,0
1,0,0,1,1,1,2,0,0,0,0,3,0,0,0,3,0,3,2,0
1,0,0,1,1,1,2,0,0,0,0,3,0,0,0,3,0,3,2,0
1,0,0,1,1,1,2,0,0,0,0,3,0,0,0,3,0,3,2,0
1,0,0,1,1,1,2,0,0,0,0,3,0,0,0,3,0,3,2,0
1,0,0,1,1,1,2,0,0,0,0,3,0,0,0,3,0,3,2,0
1,0,0,1,1,1,2,0,0,0,0,3,0,0,0,3,0,3,2,0
1,0,0,1,1,1,2,0,0,0,0,3,0,0,0,3,0,3,2,0
1,0,0,1,1,1,2,0,0,0,0,3,0,0,0,3,0,3,2,0
1,0,0,1,1,1,2,0,0,0,0,3,0,0,0,3,0,3,2,0
1,0,0,1,1,1,2,0,0,0,0,3,0,0,0,3,0,3,2,0
1,0,0,1,1,1,3,11.63,2,46.53,0.01,9,0.5,2.58,4,5,3,3,3,0
1,0,0,1,1,1,0,5.33,1.5,12,0,4,0.67,0.67,1,3,1,3,0,0
1,0,0,1,1,1,0,5.33,1.5,12,0,4,0.67,0.67,1,3,1,3,0,0
1,0,0,1,1,1,0,5.33,1.5,12,0,4,0.67,0.67,1,3,1,3,0,0
1,0,0,1,1,1,2,0,0,0,0,3,0,0,0,3,0,3,2,0
1,0,0,1,1,1,2,5.33,1.5,12,0,4,0.67,0.67,1,3,1,3,2,0
1,0,0,1,1,1,2,0,0,0,0,3,0,0,0,3,0,3,2,0
1,0,0,1,1,1,2,0,0,0,0,3,0,0,0,3,0,3,2,0
1,0,0,1,1,1,2,0,0,0,0,3,0,0,0,3,0,3,2,0
1,0,0,1,1,1,2,0,0,0,0,3,0,0,0,3,0,3,2,0
1,0,0,1,1,1,2,0,0,0,0,3,0,0,0,3,0,3,2,0
1,0,0,1,1,1,2,0,0,0,0,3,0,0,0,3,0,3,2,0
1,0,0,1,1,1,2,0,0,0,0,3,0,0,0,3,0,3,2,0
1,0,0,1,1,1,2,0,0,0,0,3,0,0,0,3,0,3,2,0
1,0,0,1,1,1,2,0,0,0,0,3,0,0,0,3,0,3,2,0
1,0,0,1,1,1,2,0,0,0,0,3,0,0,0,3,0,3,2,0
1,0,0,1,1,1,2,0,0,0,0,3,0,0,0,3,0,3,2,0
1,0,0,1,1,1,0,7.74,1.5,17.41,0,5,0.67,0.97,2,3,2,3,0,0
1,0,0,1,1,1,0,7.74,1.5,17.41,0,5,0.67,0.97,2,3,2,3,0,0
1,0,0,1,1,1,0,0,0,0,0,3,0,0,0,3,0,3,0,0
1,0,0,1,1,1,0,5.33,1.5,12,0,4,0.67,0.67,1,3,1,3,0,0
1,0,0,1,1,1,2,0,0,0,0,3,0,0,0,3,0,3,2,0
1,0,0,1,1,1,2,0,0,0,0,3,0,0,0,3,0,3,2,0
1,0,0,1,1,1,2,0,0,0,0,3,0,0,0,3,0,3,2,0
1,0,0,1,1,1,2,0,0,0,0,3,0,0,0,3,0,3,2,0
1,0,0,1,1,1,2,0,0,0,0,3,0,0,0,3,0,3,2,0
1,0,0,1,1,1,2,0,0,0,0,3,0,0,0,3,0,3,2,0
1,0,0,1,1,1,2,0,0,0,0,3,0,0,0,3,0,3,2,0
1,0,0,1,1,1,2,0,0,0,0,3,0,0,0,3,0,3,2,0
1,0,0,1,1,1,2,0,0,0,0,3,0,0,0,3,0,3,2,0
1,0,0,1,1,1,2,0,0,0,0,3,0,0,0,3,0,3,2,0
1,0,0,1,1,1,2,0,0,0,0,3,0,0,0,3,0,3,2,0
1,0,0,1,1,1,0,0,0,0,0,1,0,0,0,1,0,1,0,0
51,5,62,26,13,16,243,82,65.18,348324.33,1.78,858,0.02,19351.35,277,581,51,24,248,1
29,3,25,15,4,12,100,46.96,56.64,150652.61,0.89,456,0.02,8369.59,145,311,32,25,103,0
1,0,0,1,1,1,15,6.05,10.67,688.74,0.02,23,0.09,38.26,16,7,3,4,15,0
3,1,1,2,2,1,11,18.1,8.86,1422.38,0.05,35,0.11,79.02,15,20,11,13,12,0
3,0,7,2,1,1,10,22.57,4.89,539.55,0.04,27,0.2,29.97,11,16,9,8,10,0
35,3,25,18,8,7,105,37.7,57,122502.67,0.72,419,0.02,6805.7,152,267,20,15,108,0
25,2,12,13,12,1,52,65.69,15.18,15134.65,0.33,190,0.07,840.81,85,105,28,10,54,0
11,2,3,6,5,1,27,35.38,13,5980,0.15,92,0.08,332.22,38,54,19,13,29,0
9,0,3,5,5,1,32,53.01,14.59,11280.01,0.26,152,0.07,626.67,61,91,23,11,32,0
7,3,15,4,3,1,35,33.4,23.24,18037.61,0.26,149,0.04,1002.09,61,88,21,16,38,0
47,8,132,25,15,13,536,241.4,58.28,819864.16,4.69,1931,0.02,45548.01,674,1257,133,23,544,1
7,1,6,4,1,1,18,24.65,8.59,1819.34,0.07,49,0.12,101.07,21,28,11,9,19,0
3,0,0,2,2,1,7,18.6,5.25,512.78,0.03,25,0.19,28.49,12,13,8,7,7,0
5,0,5,3,1,1,7,13.32,13.71,2505.06,0.06,43,0.07,139.17,16,27,7,12,7,0
5,0,5,3,1,1,7,13.32,13.71,2505.06,0.06,43,0.07,139.17,16,27,7,12,7,0
1,0,0,1,1,1,0,0,0,0,0,1,0,0,0,1,0,1,0,0
9,2,1,8,1,1,27,34.09,9.88,3329.22,0.11,68,0.1,184.96,24,44,17,14,29,0
1,0,0,1,1,1,1,0,0,0,0,1,0,0,0,1,0,1,1,0
7,1,14,4,4,4,34,39.81,22.65,20420.03,0.3,182,0.04,1134.45,55,127,17,14,35,0
5,0,1,3,1,1,15,22.01,10,2200.78,0.07,48,0.1,122.27,20,28,12,12,15,0
15,2,78,8,2,1,154,71.48,75.17,403919.33,1.79,957,0.01,22439.96,283,674,32,17,156,0
5,0,4,3,1,3,20,21.61,7.27,1143.08,0.05,37,0.14,63.5,20,17,11,8,20,0
41,3,0,21,15,21,72,73.98,24.85,45693.84,0.61,331,0.04,2538.55,130,201,34,13,75,0
29,1,147,16,11,7,763,360.31,50.19,907623.59,6.03,2419,0.02,50423.53,793,1626,158,20,764,0
1,0,2,1,1,1,37,31.15,27.56,23652.78,0.29,210,0.04,1314.04,62,148,9,8,37,0
1,0,0,1,1,1,0,0,0,0,0,1,0,0,0,1,0,1,0,0
1,0,0,1,1,1,0,0,0,0,0,1,0,0,0,1,0,1,0,0
1,0,0,1,1,1,2,13.18,5.25,363.24,0.02,20,0.19,20.18,6,14,4,7,2,0
3,0,1,2,1,1,2,12.09,6.3,479.73,0.03,20,0.16,26.65,7,13,5,9,2,0
1,0,0,1,1,1,2,5.33,1.5,12,0,4,0.67,0.67,1,3,1,3,2,0
1,0,0,1,1,1,2,5.33,1.5,12,0,4,0.67,0.67,1,3,1,3,2,0
1,0,0,1,1,1,2,5.33,1.5,12,0,4,0.67,0.67,1,3,1,3,2,0
1,0,0,1,1,1,2,5.33,1.5,12,0,4,0.67,0.67,1,3,1,3,2,0
1,0,0,1,1,1,2,5.33,1.5,12,0,4,0.67,0.67,1,3,1,3,2,0
1,0,0,1,1,1,2,5.33,1.5,12,0,4,0.67,0.67,1,3,1,3,2,0
1,0,0,1,1,1,2,5.33,1.5,12,0,4,0.67,0.67,1,3,1,3,2,0
1,0,0,1,1,1,2,5.33,1.5,12,0,4,0.67,0.67,1,3,1,3,2,0
1,0,0,1,1,1,2,5.33,1.5,12,0,4,0.67,0.67,1,3,1,3,2,0
1,0,0,1,1,1,2,5.33,1.5,12,0,4,0.67,0.67,1,3,1,3,2,0
1,0,0,1,1,1,2,5.33,1.5,12,0,4,0.67,0.67,1,3,1,3,2,0
1,0,0,1,1,1,2,5.33,1.5,12,0,4,0.67,0.67,1,3,1,3,2,0
1,0,0,1,1,1,2,5.33,1.5,12,0,4,0.67,0.67,1,3,1,3,2,0
1,0,0,1,1,1,2,11.3,6.13,423.78,0.02,20,0.16,23.54,7,13,4,7,2,0
1,0,0,1,1,1,2,0,0,0,0,4,0,0,0,4,0,4,2,0
1,0,0,1,1,1,1,0,0,0,0,1,0,0,0,1,0,1,1,0
1,0,0,1,1,1,2,0,0,0,0,5,0,0,0,5,0,5,2,0
11,1,4,6,1,1,21,13.86,22.5,7014.99,0.1,68,0.04,389.72,27,41,9,15,22,0
1,0,0,1,1,1,2,7.74,1.5,17.41,0,5,0.67,0.97,2,3,2,3,2,0
1,0,0,1,1,1,4,16.05,3.75,225.86,0.02,19,0.27,12.55,6,13,4,5,4,0
1,0,0,1,1,1,2,7.74,1.5,17.41,0,5,0.67,0.97,2,3,2,3,2,0
1,0,0,1,1,1,2,7.74,1.5,17.41,0,5,0.67,0.97,2,3,2,3,2,0
1,0,0,1,1,1,2,7.74,1.5,17.41,0,5,0.67,0.97,2,3,2,3,2,0
1,0,0,1,1,1,1,0,0,0,0,0,0,0,0,0,0,0,1,0
1,0,0,1,1,1,1,0,0,0,0,1,0,0,0,1,0,1,1,0
1,0,0,1,1,1,2,5.33,1.5,12,0,4,0.67,0.67,1,3,1,3,2,0
1,0,0,1,1,1,2,5.33,1.5,12,0,4,0.67,0.67,1,3,1,3,2,0
1,9,0,1,1,1,2,0,0,0,0,9,0,0,9,0,1,0,11,0
1,0,0,1,1,1,1,0,0,0,0,0,0,0,0,0,0,0,1,0
1,0,0,1,1,1,1,0,0,0,0,0,0,0,0,0,0,0,1,0
1,0,0,1,1,1,1,0,0,0,0,1,0,0,0,1,0,1,1,0
1,0,0,1,1,1,4,18.49,2.4,106.51,0.01,14,0.42,5.92,6,8,5,4,4,0
1,0,0,1,1,1,2,5.33,1.5,12,0,4,0.67,0.67,1,3,1,3,2,0
1,0,0,1,1,1,5,8.45,0.75,4.75,0,4,1.33,0.26,3,1,2,1,5,0
1,0,0,1,1,1,1,0,0,0,0,0,0,0,0,0,0,0,1,0
1,0,0,1,1,1,1,0,0,0,0,1,0,0,0,1,0,1,1,0
1,0,0,1,1,1,3,10.8,2.5,67.5,0.01,9,0.4,3.75,3,6,3,5,3,0
1,0,0,1,1,1,2,5.33,1.5,12,0,4,0.67,0.67,1,3,1,3,2,0
1,0,0,1,1,1,2,6.2,2.5,38.77,0.01,6,0.4,2.15,1,5,1,5,2,0
1,0,0,1,1,1,4,9.51,0.5,2.38,0,3,2,0.13,2,1,2,1,4,0
1,0,0,1,1,1,1,0,0,0,0,1,0,0,0,1,0,1,1,0
1,0,0,1,1,1,2,5.33,1.5,12,0,4,0.67,0.67,1,3,1,3,2,0
1,0,0,1,1,1,2,5.33,1.5,12,0,4,0.67,0.67,1,3,1,3,2,0
1,0,0,1,1,1,2,0,0,0,0,4,0,0,0,4,0,4,2,0
1,0,0,1,1,1,1,0,0,0,0,1,0,0,0,1,0,1,1,0
1,0,0,1,1,1,2,0,0,0,0,5,0,0,0,5,0,5,2,0
1,0,0,1,1,1,1,0,0,0,0,1,0,0,0,1,0,1,1,0
1,0,0,1,1,1,2,5.33,1.5,12,0,4,0.67,0.67,1,3,1,3,2,0
1,0,0,1,1,1,2,5.33,1.5,12,0,4,0.67,0.67,1,3,1,3,2,0
1,0,0,1,1,1,1,0,0,0,0,1,0,0,0,1,0,1,1,0
1,0,0,1,1,1,0,0,0,0,0,1,0,0,0,1,0,1,0,0
1,0,0,1,1,1,0,0,0,0,0,1,0,0,0,1,0,1,0,0
1,0,0,1,1,1,0,0,0,0,0,1,0,0,0,1,0,1,0,0
1,0,0,1,1,1,1,0,0,0,0,1,0,0,0,1,0,1,1,0
1,0,0,1,1,1,1,0,0,0,0,1,0,0,0,1,0,1,1,0
1,0,0,1,1,1,1,0,0,0,0,1,0,0,0,1,0,1,1,0
1,0,0,1,1,1,1,0,0,0,0,1,0,0,0,1,0,1,1,0
1,0,0,1,1,1,1,0,0,0,0,1,0,0,0,1,0,1,1,0
1,0,0,1,1,1,1,0,0,0,0,1,0,0,0,1,0,1,1,0
9,3,0,5,5,4,4,6.95,27.62,5307.06,0.06,47,0.04,294.84,17,30,4,13,7,0
1,0,0,1,1,1,0,0,0,0,0,1,0,0,0,1,0,1,0,0
1,0,0,1,1,1,0,0,0,0,0,1,0,0,0,1,0,1,0,0
1,0,0,1,1,1,2,0,0,0,0,3,0,0,0,3,0,3,2,0
1,0,0,1,1,1,2,0,0,0,0,3,0,0,0,3,0,3,2,0
1,0,0,1,1,1,2,0,0,0,0,3,0,0,0,3,0,3,2,0
1,0,0,1,1,1,2,0,0,0,0,3,0,0,0,3,0,3,2,0
1,0,0,1,1,1,2,0,0,0,0,3,0,0,0,3,0,3,2,0
1,0,0,1,1,1,2,0,0,0,0,3,0,0,0,3,0,3,2,0
1,0,0,1,1,1,2,0,0,0,0,3,0,0,0,3,0,3,2,0
1,0,0,1,1,1,2,0,0,0,0,3,0,0,0,3,0,3,2,0
1,0,0,1,1,1,2,0,0,0,0,3,0,0,0,3,0,3,2,0
1,0,0,1,1,1,2,0,0,0,0,3,0,0,0,3,0,3,2,0
1,0,0,1,1,1,2,0,0,0,0,3,0,0,0,3,0,3,2,0
1,0,0,1,1,1,3,11.63,2,46.53,0.01,9,0.5,2.58,4,5,3,3,3,0
1,0,0,1,1,1,0,5.33,1.5,12,0,4,0.67,0.67,1,3,1,3,0,0
1,0,0,1,1,1,0,5.33,1.5,12,0,4,0.67,0.67,1,3,1,3,0,0
1,0,0,1,1,1,0,5.33,1.5,12,0,4,0.67,0.67,1,3,1,3,0,0
1,0,0,1,1,1,2,0,0,0,0,3,0,0,0,3,0,3,2,0
1,0,0,1,1,1,2,5.33,1.5,12,0,4,0.67,0.67,1,3,1,3,2,0
1,0,0,1,1,1,2,0,0,0,0,3,0,0,0,3,0,3,2,0
1,0,0,1,1,1,2,0,0,0,0,3,0,0,0,3,0,3,2,0
1,0,0,1,1,1,2,0,0,0,0,3,0,0,0,3,0,3,2,0
1,0,0,1,1,1,2,0,0,0,0,3,0,0,0,3,0,3,2,0
1,0,0,1,1,1,2,0,0,0,0,3,0,0,0,3,0,3,2,0
1,0,0,1,1,1,2,0,0,0,0,3,0,0,0,3,0,3,2,0
1,0,0,1,1,1,2,0,0,0,0,3,0,0,0,3,0,3,2,0
1,0,0,1,1,1,2,0,0,0,0,3,0,0,0,3,0,3,2,0
1,0,0,1,1,1,2,0,0,0,0,3,0,0,0,3,0,3,2,0
1,0,0,1,1,1,2,0,0,0,0,3,0,0,0,3,0,3,2,0
1,0,0,1,1,1,2,0,0,0,0,3,0,0,0,3,0,3,2,0
1,0,0,1,1,1,0,7.74,1.5,17.41,0,5,0.67,0.97,2,3,2,3,0,0
1,0,0,1,1,1,0,7.74,1.5,17.41,0,5,0.67,0.97,2,3,2,3,0,0
1,0,0,1,1,1,0,0,0,0,0,3,0,0,0,3,0,3,0,0
1,0,0,1,1,1,0,5.33,1.5,12,0,4,0.67,0.67,1,3,1,3,0,0
1,0,0,1,1,1,2,0,0,0,0,3,0,0,0,3,0,3,2,0
1,0,0,1,1,1,2,0,0,0,0,3,0,0,0,3,0,3,2,0
1,0,0,1,1,1,2,0,0,0,0,3,0,0,0,3,0,3,2,0
1,0,0,1,1,1,2,0,0,0,0,3,0,0,0,3,0,3,2,0
1,0,0,1,1,1,2,0,0,0,0,3,0,0,0,3,0,3,2,0
1,0,0,1,1,1,2,0,0,0,0,3,0,0,0,3,0,3,2,0
1,0,0,1,1,1,2,0,0,0,0,3,0,0,0,3,0,3,2,0
1,0,0,1,1,1,2,0,0,0,0,3,0,0,0,3,0,3,2,0
1,0,0,1,1,1,2,0,0,0,0,3,0,0,0,3,0,3,2,0
1,0,0,1,1,1,2,0,0,0,0,3,0,0,0,3,0,3,2,0
1,0,0,1,1,1,2,0,0,0,0,3,0,0,0,3,0,3,2,0
1,0,0,1,1,1,0,0,0,0,0,1,0,0,0,1,0,1,0,0
1,0,0,1,1,1,0,0,0,0,0,1,0,0,0,1,0,1,0,0
1,0,0,1,1,1,3,7.74,1.5,17.41,0,5,0.67,0.97,2,3,2,3,3,0
1,0,0,1,1,1,34,35.96,13.3,6360.5,0.16,117,0.08,353.36,38,79,10,7,34,0
1,0,0,1,1,1,0,0,0,0,0,1,0,0,0,1,0,1,0,0
45,0,0,23,23,1,155,324.03,8.93,25825.49,0.96,463,0.11,1434.75,176,287,69,7,155,0
3,0,0,2,1,1,9,17.41,3.5,213.31,0.02,17,0.29,11.85,7,10,6,6,9,0
77,6,72,39,7,16,200,76.43,62.09,294691.02,1.58,794,0.02,16371.72,267,527,43,20,206,1
97,13,85,49,29,24,399,122.24,87.35,932608.14,3.56,1587,0.01,51811.56,566,1021,81,25,412,1
1,0,0,1,1,1,2,5.33,1.5,12,0,4,0.67,0.67,1,3,1,3,2,0
31,4,18,16,3,8,91,39.91,54.17,117104.81,0.72,396,0.02,6505.82,130,266,24,20,95,1
1,0,0,1,1,1,32,5.1,22,2470.47,0.04,40,0.05,137.25,33,7,3,4,32,0
97,14,20,51,17,27,249,88.62,65.64,381855.65,1.94,870,0.02,21214.2,335,535,74,29,263,1
35,4,42,18,4,12,68,53.72,20.28,22087.53,0.36,202,0.05,1227.09,73,129,27,15,72,0
27,1,37,14,3,9,83,69.4,25.68,45778.3,0.59,303,0.04,2543.24,117,186,41,18,84,0
35,2,14,18,13,1,65,65.2,24.5,39133.83,0.53,286,0.04,2174.1,119,167,34,14,67,0
41,2,9,21,14,1,61,69.03,20.28,28393.27,0.47,258,0.05,1577.4,118,140,32,11,63,0
33,3,0,17,12,1,52,54.8,20.17,22299.09,0.37,205,0.05,1238.84,90,115,29,13,55,1
1,0,0,1,1,1,2,10.04,5,250.95,0.02,14,0.2,13.94,5,9,4,8,2,0
1,0,0,1,1,1,3,9.32,6.75,424.63,0.02,17,0.15,23.59,6,11,4,9,3,0
49,6,34,25,9,11,134,64.97,41.08,109660.08,0.89,466,0.02,6092.23,174,292,36,17,140,1
7,0,3,4,4,1,35,48.17,25.43,31164.53,0.41,237,0.04,1731.36,90,147,23,13,35,0
5,0,0,3,1,1,14,22.93,6.3,909.91,0.05,34,0.16,50.55,14,20,10,9,14,0
61,5,276,31,5,28,1603,1077.39,42.81,1974074.32,15.37,5521,0.02,109670.8,1914,3607,313,14,1608,1
3,0,0,2,2,1,8,22.15,5.06,566.22,0.04,28,0.2,31.46,13,15,9,7,8,1
1,0,0,1,1,1,0,0,0,0,0,1,0,0,0,1,0,1,0,0
1,0,0,1,1,1,3,7.74,1.5,17.41,0,5,0.67,0.97,2,3,2,3,3,0
1,0,0,1,1,1,34,35.96,13.3,6360.5,0.16,117,0.08,353.36,38,79,10,7,34,0
1,0,0,1,1,1,0,0,0,0,0,1,0,0,0,1,0,1,0,0
1,0,0,1,1,1,3,7.74,1.5,17.41,0,5,0.67,0.97,2,3,2,3,3,0
1,0,0,1,1,1,34,35.96,13.3,6360.5,0.16,117,0.08,353.36,38,79,10,7,34,0
1,0,0,1,1,1,0,0,0,0,0,1,0,0,0,1,0,1,0,0
5,0,5,3,1,1,7,13.32,13.71,2505.06,0.06,43,0.07,139.17,16,27,7,12,7,0
5,0,5,3,1,1,7,13.32,13.71,2505.06,0.06,43,0.07,139.17,16,27,7,12,7,0
1,0,0,1,1,1,0,0,0,0,0,1,0,0,0,1,0,1,0,0
1,0,0,1,1,1,0,0,0,0,0,1,0,0,0,1,0,1,0,0
9,2,1,8,1,1,27,34.09,9.88,3329.22,0.11,68,0.1,184.96,24,44,17,14,29,0
1,0,0,1,1,1,1,0,0,0,0,1,0,0,0,1,0,1,1,0
1,0,0,1,1,1,0,0,0,0,0,1,0,0,0,1,0,1,0,0
1,0,0,1,1,1,0,0,0,0,0,1,0,0,0,1,0,1,0,0
1,0,0,1,1,1,2,13.18,5.25,363.24,0.02,20,0.19,20.18,6,14,4,7,2,0
3,0,1,2,1,1,2,12.09,6.3,479.73,0.03,20,0.16,26.65,7,13,5,9,2,0
1,0,0,1,1,1,2,5.33,1.5,12,0,4,0.67,0.67,1,3,1,3,2,0
1,0,0,1,1,1,2,5.33,1.5,12,0,4,0.67,0.67,1,3,1,3,2,0
1,0,0,1,1,1,2,5.33,1.5,12,0,4,0.67,0.67,1,3,1,3,2,0
1,0,0,1,1,1,2,5.33,1.5,12,0,4,0.67,0.67,1,3,1,3,2,0
1,0,0,1,1,1,2,5.33,1.5,12,0,4,0.67,0.67,1,3,1,3,2,0
1,0,0,1,1,1,2,5.33,1.5,12,0,4,0.67,0.67,1,3,1,3,2,0
1,0,0,1,1,1,2,5.33,1.5,12,0,4,0.67,0.67,1,3,1,3,2,0
1,0,0,1,1,1,2,5.33,1.5,12,0,4,0.67,0.67,1,3,1,3,2,0
1,0,0,1,1,1,2,5.33,1.5,12,0,4,0.67,0.67,1,3,1,3,2,0
1,0,0,1,1,1,2,5.33,1.5,12,0,4,0.67,0.67,1,3,1,3,2,0
1,0,0,1,1,1,2,5.33,1.5,12,0,4,0.67,0.67,1,3,1,3,2,0
1,0,0,1,1,1,2,5.33,1.5,12,0,4,0.67,0.67,1,3,1,3,2,0
1,0,0,1,1,1,2,5.33,1.5,12,0,4,0.67,0.67,1,3,1,3,2,0
1,0,0,1,1,1,2,11.3,6.13,423.78,0.02,20,0.16,23.54,7,13,4,7,2,0
1,0,0,1,1,1,2,0,0,0,0,4,0,0,0,4,0,4,2,0
1,0,0,1,1,1,1,0,0,0,0,1,0,0,0,1,0,1,1,0
1,0,0,1,1,1,2,0,0,0,0,5,0,0,0,5,0,5,2,0
11,1,4,6,1,1,21,13.86,22.5,7014.99,0.1,68,0.04,389.72,27,41,9,15,22,0
1,0,0,1,1,1,2,7.74,1.5,17.41,0,5,0.67,0.97,2,3,2,3,2,0
1,0,0,1,1,1,4,16.05,3.75,225.86,0.02,19,0.27,12.55,6,13,4,5,4,0
1,0,0,1,1,1,2,7.74,1.5,17.41,0,5,0.67,0.97,2,3,2,3,2,0
1,0,0,1,1,1,2,7.74,1.5,17.41,0,5,0.67,0.97,2,3,2,3,2,0
1,0,0,1,1,1,2,7.74,1.5,17.41,0,5,0.67,0.97,2,3,2,3,2,0
1,0,0,1,1,1,1,0,0,0,0,0,0,0,0,0,0,0,1,0
1,0,0,1,1,1,1,0,0,0,0,1,0,0,0,1,0,1,1,0
1,0,0,1,1,1,2,5.33,1.5,12,0,4,0.67,0.67,1,3,1,3,2,0
1,0,0,1,1,1,2,5.33,1.5,12,0,4,0.67,0.67,1,3,1,3,2,0
1,9,0,1,1,1,2,0,0,0,0,9,0,0,9,0,1,0,11,0
1,0,0,1,1,1,1,0,0,0,0,0,0,0,0,0,0,0,1,0
1,0,0,1,1,1,1,0,0,0,0,0,0,0,0,0,0,0,1,0
1,0,0,1,1,1,1,0,0,0,0,1,0,0,0,1,0,1,1,0
1,0,0,1,1,1,4,18.49,2.4,106.51,0.01,14,0.42,5.92,6,8,5,4,4,0
1,0,0,1,1,1,2,5.33,1.5,12,0,4,0.67,0.67,1,3,1,3,2,0
1,0,0,1,1,1,5,8.45,0.75,4.75,0,4,1.33,0.26,3,1,2,1,5,0
1,0,0,1,1,1,1,0,0,0,0,0,0,0,0,0,0,0,1,0
1,0,0,1,1,1,1,0,0,0,0,1,0,0,0,1,0,1,1,0
1,0,0,1,1,1,3,10.8,2.5,67.5,0.01,9,0.4,3.75,3,6,3,5,3,0
1,0,0,1,1,1,2,5.33,1.5,12,0,4,0.67,0.67,1,3,1,3,2,0
1,0,0,1,1,1,2,6.2,2.5,38.77,0.01,6,0.4,2.15,1,5,1,5,2,0
1,0,0,1,1,1,4,9.51,0.5,2.38,0,3,2,0.13,2,1,2,1,4,0
1,0,0,1,1,1,1,0,0,0,0,1,0,0,0,1,0,1,1,0
1,0,0,1,1,1,2,5.33,1.5,12,0,4,0.67,0.67,1,3,1,3,2,0
1,0,0,1,1,1,2,5.33,1.5,12,0,4,0.67,0.67,1,3,1,3,2,0
1,0,0,1,1,1,2,0,0,0,0,4,0,0,0,4,0,4,2,0
1,0,0,1,1,1,1,0,0,0,0,1,0,0,0,1,0,1,1,0
1,0,0,1,1,1,2,0,0,0,0,5,0,0,0,5,0,5,2,0
1,0,0,1,1,1,1,0,0,0,0,1,0,0,0,1,0,1,1,0
1,0,0,1,1,1,2,5.33,1.5,12,0,4,0.67,0.67,1,3,1,3,2,0
1,0,0,1,1,1,2,5.33,1.5,12,0,4,0.67,0.67,1,3,1,3,2,0
1,0,0,1,1,1,1,0,0,0,0,1,0,0,0,1,0,1,1,0
1,0,0,1,1,1,1,0,0,0,0,1,0,0,0,1,0,1,1,0
1,0,0,1,1,1,1,0,0,0,0,1,0,0,0,1,0,1,1,0
1,0,0,1,1,1,1,0,0,0,0,1,0,0,0,1,0,1,1,0
1,0,0,1,1,1,1,0,0,0,0,1,0,0,0,1,0,1,1,0
1,0,0,1,1,1,1,0,0,0,0,1,0,0,0,1,0,1,1,0
1,0,0,1,1,1,1,0,0,0,0,1,0,0,0,1,0,1,1,0
1,0,0,1,1,1,0,0,0,0,0,1,0,0,0,1,0,1,0,0
1,0,0,1,1,1,2,0,0,0,0,3,0,0,0,3,0,3,2,0
1,0,0,1,1,1,2,0,0,0,0,3,0,0,0,3,0,3,2,0
1,0,0,1,1,1,2,0,0,0,0,3,0,0,0,3,0,3,2,0
1,0,0,1,1,1,2,0,0,0,0,3,0,0,0,3,0,3,2,0
1,0,0,1,1,1,2,0,0,0,0,3,0,0,0,3,0,3,2,0
1,0,0,1,1,1,2,0,0,0,0,3,0,0,0,3,0,3,2,0
1,0,0,1,1,1,2,0,0,0,0,3,0,0,0,3,0,3,2,0
1,0,0,1,1,1,2,0,0,0,0,3,0,0,0,3,0,3,2,0
1,0,0,1,1,1,2,0,0,0,0,3,0,0,0,3,0,3,2,0
1,0,0,1,1,1,2,0,0,0,0,3,0,0,0,3,0,3,2,0
1,0,0,1,1,1,2,0,0,0,0,3,0,0,0,3,0,3,2,0
1,0,0,1,1,1,3,11.63,2,46.53,0.01,9,0.5,2.58,4,5,3,3,3,0
1,0,0,1,1,1,0,5.33,1.5,12,0,4,0.67,0.67,1,3,1,3,0,0
1,0,0,1,1,1,0,5.33,1.5,12,0,4,0.67,0.67,1,3,1,3,0,0
1,0,0,1,1,1,0,5.33,1.5,12,0,4,0.67,0.67,1,3,1,3,0,0
1,0,0,1,1,1,2,0,0,0,0,3,0,0,0,3,0,3,2,0
1,0,0,1,1,1,2,5.33,1.5,12,0,4,0.67,0.67,1,3,1,3,2,0
1,0,0,1,1,1,2,0,0,0,0,3,0,0,0,3,0,3,2,0
1,0,0,1,1,1,2,0,0,0,0,3,0,0,0,3,0,3,2,0
1,0,0,1,1,1,2,0,0,0,0,3,0,0,0,3,0,3,2,0
1,0,0,1,1,1,2,0,0,0,0,3,0,0,0,3,0,3,2,0
1,0,0,1,1,1,2,0,0,0,0,3,0,0,0,3,0,3,2,0
1,0,0,1,1,1,2,0,0,0,0,3,0,0,0,3,0,3,2,0
1,0,0,1,1,1,2,0,0,0,0,3,0,0,0,3,0,3,2,0
1,0,0,1,1,1,2,0,0,0,0,3,0,0,0,3,0,3,2,0
1,0,0,1,1,1,2,0,0,0,0,3,0,0,0,3,0,3,2,0
1,0,0,1,1,1,2,0,0,0,0,3,0,0,0,3,0,3,2,0
1,0,0,1,1,1,2,0,0,0,0,3,0,0,0,3,0,3,2,0
1,0,0,1,1,1,0,7.74,1.5,17.41,0,5,0.67,0.97,2,3,2,3,0,0
1,0,0,1,1,1,0,7.74,1.5,17.41,0,5,0.67,0.97,2,3,2,3,0,0
1,0,0,1,1,1,0,0,0,0,0,3,0,0,0,3,0,3,0,0
1,0,0,1,1,1,0,5.33,1.5,12,0,4,0.67,0.67,1,3,1,3,0,0
1,0,0,1,1,1,2,0,0,0,0,3,0,0,0,3,0,3,2,0
1,0,0,1,1,1,2,0,0,0,0,3,0,0,0,3,0,3,2,0
1,0,0,1,1,1,2,0,0,0,0,3,0,0,0,3,0,3,2,0
1,0,0,1,1,1,2,0,0,0,0,3,0,0,0,3,0,3,2,0
1,0,0,1,1,1,2,0,0,0,0,3,0,0,0,3,0,3,2,0
1,0,0,1,1,1,2,0,0,0,0,3,0,0,0,3,0,3,2,0
1,0,0,1,1,1,2,0,0,0,0,3,0,0,0,3,0,3,2,0
1,0,0,1,1,1,2,0,0,0,0,3,0,0,0,3,0,3,2,0
1,0,0,1,1,1,2,0,0,0,0,3,0,0,0,3,0,3,2,0
1,0,0,1,1,1,2,0,0,0,0,3,0,0,0,3,0,3,2,0
1,0,0,1,1,1,2,0,0,0,0,3,0,0,0,3,0,3,2,0
1,0,0,1,1,1,0,0,0,0,0,1,0,0,0,1,0,1,0,0
35,2,16,18,8,12,83,54.48,43.71,104105.19,0.79,394,0.02,5783.62,153,241,42,24,85,1
39,0,13,20,7,11,73,52.26,45.59,108615.04,0.79,414,0.02,6034.17,155,259,34,20,73,1
223,6,91,112,36,81,574,140.32,146.54,3013162.73,6.85,2856,0.01,167397.92,1143,1713,117,30,580,1
1,0,1,1,1,1,3,7.24,2.5,45.24,0.01,7,0.4,2.51,1,6,1,5,3,0
33,0,5,17,1,14,45,43.13,14.03,8485.92,0.2,121,0.07,471.44,41,80,19,13,45,1
1,0,1,1,1,1,32,229.37,2.73,1706.08,0.21,121,0.37,94.78,60,61,33,3,32,1
9,0,0,5,1,4,18,34.47,5.45,1025.57,0.06,46,0.18,56.98,20,26,11,6,18,0
29,1,5,15,12,5,67,60.34,19.46,22849.76,0.39,205,0.05,1269.43,90,115,37,16,68,1
39,0,11,20,13,9,65,60.65,23.78,34292.58,0.48,253,0.04,1905.14,107,146,36,16,65,1
39,0,10,20,12,9,64,58.3,24.23,34221.26,0.47,249,0.04,1901.18,106,143,35,16,64,1
39,0,10,20,12,9,64,58.3,24.23,34221.26,0.47,249,0.04,1901.18,106,143,35,16,64,1
3,0,1,2,2,1,8,16.18,6.43,668.57,0.03,26,0.16,37.14,10,16,7,9,8,0
19,0,4,10,10,1,40,47.71,15.78,11883.43,0.25,148,0.06,660.19,66,82,23,11,40,1
1,0,3,1,1,1,42,123.29,14.16,24718.06,0.58,298,0.07,1373.23,121,177,47,11,42,1
115,0,261,58,31,29,978,1318.96,44.81,2648522.51,19.7,6701,0.02,147140.15,2611,4090,437,15,978,1
47,0,4,41,32,5,157,51.17,115.74,685433.12,1.97,842,0.01,38079.62,375,467,81,50,157,1
38,0,7,20,11,9,101,45.34,47.44,102058.89,0.72,316,0.02,5669.94,122,194,63,49,101,0
1,0,0,1,1,1,0,0,0,0,0,1,0,0,0,1,0,1,0,0
1,0,0,1,1,1,4,16.84,1.5,37.9,0.01,9,0.67,2.11,4,5,4,3,4,0
1,0,0,1,1,1,0,0,0,0,0,1,0,0,0,1,0,1,0,0
5,0,5,3,1,1,7,13.32,13.71,2505.06,0.06,43,0.07,139.17,16,27,7,12,7,0
5,0,5,3,1,1,7,13.32,13.71,2505.06,0.06,43,0.07,139.17,16,27,7,12,7,0
1,0,0,1,1,1,0,0,0,0,0,1,0,0,0,1,0,1,0,0
9,2,1,8,1,1,27,34.09,9.88,3329.22,0.11,68,0.1,184.96,24,44,17,14,29,0
3,0,1,2,1,1,2,12.09,6.3,479.73,0.03,20,0.16,26.65,7,13,5,9,2,0
1,0,0,1,1,1,2,5.33,1.5,12,0,4,0.67,0.67,1,3,1,3,2,0
1,0,0,1,1,1,2,5.33,1.5,12,0,4,0.67,0.67,1,3,1,3,2,0
1,0,0,1,1,1,2,5.33,1.5,12,0,4,0.67,0.67,1,3,1,3,2,0
1,0,0,1,1,1,2,5.33,1.5,12,0,4,0.67,0.67,1,3,1,3,2,0
1,0,0,1,1,1,2,5.33,1.5,12,0,4,0.67,0.67,1,3,1,3,2,0
1,0,0,1,1,1,2,5.33,1.5,12,0,4,0.67,0.67,1,3,1,3,2,0
1,0,0,1,1,1,2,5.33,1.5,12,0,4,0.67,0.67,1,3,1,3,2,0
1,0,0,1,1,1,2,5.33,1.5,12,0,4,0.67,0.67,1,3,1,3,2,0
1,0,0,1,1,1,2,5.33,1.5,12,0,4,0.67,0.67,1,3,1,3,2,0
1,0,0,1,1,1,2,0,0,0,0,4,0,0,0,4,0,4,2,0
1,0,0,1,1,1,1,0,0,0,0,1,0,0,0,1,0,1,1,0
1,0,0,1,1,1,2,0,0,0,0,5,0,0,0,5,0,5,2,0
11,1,4,6,1,1,21,13.86,22.5,7014.99,0.1,68,0.04,389.72,27,41,9,15,22,0
1,0,0,1,1,1,2,20.97,3,188.72,0.02,17,0.33,10.48,7,10,7,6,2,0
1,0,0,1,1,1,2,20.97,3,188.72,0.02,17,0.33,10.48,7,10,7,6,2,0
1,0,0,1,1,1,2,27.35,3,246.13,0.03,21,0.33,13.67,9,12,9,6,2,0
1,0,0,1,1,1,3,30.67,3,276,0.03,23,0.33,15.33,10,13,10,6,3,0
1,0,0,1,1,1,3,30.67,3,276,0.03,23,0.33,15.33,10,13,10,6,3,0
1,0,0,1,1,1,3,30.67,3,276,0.03,23,0.33,15.33,10,13,10,6,3,0
1,0,0,1,1,1,2,27.35,3,246.13,0.03,21,0.33,13.67,9,12,9,6,2,0
1,0,0,1,1,1,3,27.35,3,246.13,0.03,21,0.33,13.67,9,12,9,6,3,0
1,0,0,1,1,1,2,20.97,3,188.72,0.02,17,0.33,10.48,7,10,7,6,2,0
1,0,0,1,1,1,2,20.97,3,188.72,0.02,17,0.33,10.48,7,10,7,6,2,0
1,0,0,1,1,1,2,20.97,3,188.72,0.02,17,0.33,10.48,7,10,7,6,2,0
1,0,0,1,1,1,2,17.92,3,161.32,0.02,15,0.33,8.96,6,9,6,6,2,0
1,0,0,1,1,1,2,17.92,3,161.32,0.02,15,0.33,8.96,6,9,6,6,2,0
1,0,0,1,1,1,2,14.99,3,134.92,0.01,13,0.33,7.5,5,8,5,6,2,0
1,0,0,1,1,1,2,14.99,3,134.92,0.01,13,0.33,7.5,5,8,5,6,2,0
1,0,0,1,1,1,2,14.99,3,134.92,0.01,13,0.33,7.5,5,8,5,6,2,0
1,0,0,1,1,1,2,14.99,3,134.92,0.01,13,0.33,7.5,5,8,5,6,2,0
1,0,0,1,1,1,2,14.99,3,134.92,0.01,13,0.33,7.5,5,8,5,6,2,0
1,0,0,1,1,1,2,17.92,3,161.32,0.02,15,0.33,8.96,6,9,6,6,2,0
1,0,0,1,1,1,2,17.92,3,161.32,0.02,15,0.33,8.96,6,9,6,6,2,0
1,0,0,1,1,1,2,20.97,3,188.72,0.02,17,0.33,10.48,7,10,7,6,2,0
1,0,0,1,1,1,2,20.97,3,188.72,0.02,17,0.33,10.48,7,10,7,6,2,0
1,0,0,1,1,1,1,0,0,0,0,0,0,0,0,0,0,0,1,0
1,0,0,1,1,1,2,8,3,72,0.01,8,0.33,4,2,6,2,6,2,0
1,0,0,1,1,1,2,8,3,72,0.01,8,0.33,4,2,6,2,6,2,0
1,0,0,1,1,1,2,8,3,72,0.01,8,0.33,4,2,6,2,6,2,0
1,0,0,1,1,1,2,8,3,72,0.01,8,0.33,4,2,6,2,6,2,0
1,0,0,1,1,1,2,8,3,72,0.01,8,0.33,4,2,6,2,6,2,0
1,0,0,1,1,1,2,8,3,72,0.01,8,0.33,4,2,6,2,6,2,0
1,0,0,1,1,1,2,8,3,72,0.01,8,0.33,4,2,6,2,6,2,0
1,0,0,1,1,1,2,8,3,72,0.01,8,0.33,4,2,6,2,6,2,0
1,0,0,1,1,1,2,8,3,72,0.01,8,0.33,4,2,6,2,6,2,0
1,0,0,1,1,1,2,8,3,72,0.01,8,0.33,4,2,6,2,6,2,0
1,0,0,1,1,1,1,0,0,0,0,1,0,0,0,1,0,1,1,0
1,0,0,1,1,1,2,5.33,1.5,12,0,4,0.67,0.67,1,3,1,3,2,0
1,0,0,1,1,1,2,5.33,1.5,12,0,4,0.67,0.67,1,3,1,3,2,0
1,9,0,1,1,1,2,0,0,0,0,9,0,0,9,0,1,0,11,0
1,0,0,1,1,1,2,8,3,72,0.01,8,0.33,4,2,6,2,6,2,0
1,0,0,1,1,1,2,8,3,72,0.01,8,0.33,4,2,6,2,6,2,0
1,0,0,1,1,1,3,21.46,5.5,649.15,0.04,31,0.18,36.06,11,20,7,7,3,0
1,0,0,1,1,1,3,21.46,5.5,649.15,0.04,31,0.18,36.06,11,20,7,7,3,0
1,0,0,1,1,1,3,21.46,5.5,649.15,0.04,31,0.18,36.06,11,20,7,7,3,0
1,0,0,1,1,1,3,21.46,5.5,649.15,0.04,31,0.18,36.06,11,20,7,7,3,0
1,0,0,1,1,1,3,21.46,5.5,649.15,0.04,31,0.18,36.06,11,20,7,7,3,0
1,0,0,1,1,1,3,21.46,5.5,649.15,0.04,31,0.18,36.06,11,20,7,7,3,0
1,0,0,1,1,1,2,8,3,72,0.01,8,0.33,4,2,6,2,6,2,0
1,0,0,1,1,1,2,8,3,72,0.01,8,0.33,4,2,6,2,6,2,0
1,0,0,1,1,1,1,0,0,0,0,0,0,0,0,0,0,0,1,0
1,0,0,1,1,1,1,0,0,0,0,0,0,0,0,0,0,0,1,0
1,0,0,1,1,1,1,0,0,0,0,1,0,0,0,1,0,1,1,0
1,0,0,1,1,1,4,18.49,2.4,106.51,0.01,14,0.42,5.92,6,8,5,4,4,0
1,0,0,1,1,1,2,5.33,1.5,12,0,4,0.67,0.67,1,3,1,3,2,0
1,0,0,1,1,1,5,8.45,0.75,4.75,0,4,1.33,0.26,3,1,2,1,5,0
1,0,0,1,1,1,1,0,0,0,0,0,0,0,0,0,0,0,1,0
1,0,0,1,1,1,1,0,0,0,0,1,0,0,0,1,0,1,1,0
1,0,0,1,1,1,3,10.8,2.5,67.5,0.01,9,0.4,3.75,3,6,3,5,3,0
1,0,0,1,1,1,2,5.33,1.5,12,0,4,0.67,0.67,1,3,1,3,2,0
1,0,0,1,1,1,2,6.2,2.5,38.77,0.01,6,0.4,2.15,1,5,1,5,2,0
1,0,0,1,1,1,4,9.51,0.5,2.38,0,3,2,0.13,2,1,2,1,4,0
1,0,0,1,1,1,1,0,0,0,0,1,0,0,0,1,0,1,1,0
1,0,0,1,1,1,2,5.33,1.5,12,0,4,0.67,0.67,1,3,1,3,2,0
1,0,0,1,1,1,2,5.33,1.5,12,0,4,0.67,0.67,1,3,1,3,2,0
1,0,0,1,1,1,2,0,0,0,0,4,0,0,0,4,0,4,2,0
1,0,0,1,1,1,1,0,0,0,0,1,0,0,0,1,0,1,1,0
1,0,0,1,1,1,2,0,0,0,0,5,0,0,0,5,0,5,2,0
1,0,0,1,1,1,1,0,0,0,0,1,0,0,0,1,0,1,1,0
1,0,0,1,1,1,2,5.33,1.5,12,0,4,0.67,0.67,1,3,1,3,2,0
1,0,0,1,1,1,2,5.33,1.5,12,0,4,0.67,0.67,1,3,1,3,2,0
1,0,0,1,1,1,1,0,0,0,0,1,0,0,0,1,0,1,1,0
1,0,0,1,1,1,1,0,0,0,0,1,0,0,0,1,0,1,1,0
1,0,0,1,1,1,1,0,0,0,0,1,0,0,0,1,0,1,1,0
1,0,0,1,1,1,1,0,0,0,0,1,0,0,0,1,0,1,1,0
1,0,0,1,1,1,1,0,0,0,0,1,0,0,0,1,0,1,1,0
1,0,0,1,1,1,0,0,0,0,0,1,0,0,0,1,0,1,0,0
1,0,0,1,1,1,2,0,0,0,0,3,0,0,0,3,0,3,2,0
1,0,0,1,1,1,2,0,0,0,0,3,0,0,0,3,0,3,2,0
1,0,0,1,1,1,2,0,0,0,0,3,0,0,0,3,0,3,2,0
1,0,0,1,1,1,2,0,0,0,0,3,0,0,0,3,0,3,2,0
1,0,0,1,1,1,2,0,0,0,0,3,0,0,0,3,0,3,2,0
1,0,0,1,1,1,2,0,0,0,0,3,0,0,0,3,0,3,2,0
1,0,0,1,1,1,2,0,0,0,0,3,0,0,0,3,0,3,2,0
1,0,0,1,1,1,2,0,0,0,0,3,0,0,0,3,0,3,2,0
1,0,0,1,1,1,2,0,0,0,0,3,0,0,0,3,0,3,2,0
1,0,0,1,1,1,2,0,0,0,0,3,0,0,0,3,0,3,2,0
1,0,0,1,1,1,2,0,0,0,0,3,0,0,0,3,0,3,2,0
1,0,0,1,1,1,3,11.63,2,46.53,0.01,9,0.5,2.58,4,5,3,3,3,0
1,0,0,1,1,1,0,5.33,1.5,12,0,4,0.67,0.67,1,3,1,3,0,0
1,0,0,1,1,1,0,5.33,1.5,12,0,4,0.67,0.67,1,3,1,3,0,0
1,0,0,1,1,1,0,5.33,1.5,12,0,4,0.67,0.67,1,3,1,3,0,0
1,0,0,1,1,1,2,0,0,0,0,3,0,0,0,3,0,3,2,0
1,0,0,1,1,1,2,5.33,1.5,12,0,4,0.67,0.67,1,3,1,3,2,0
1,0,0,1,1,1,2,0,0,0,0,3,0,0,0,3,0,3,2,0
1,0,0,1,1,1,2,0,0,0,0,3,0,0,0,3,0,3,2,0
1,0,0,1,1,1,2,0,0,0,0,3,0,0,0,3,0,3,2,0
1,0,0,1,1,1,2,0,0,0,0,3,0,0,0,3,0,3,2,0
1,0,0,1,1,1,2,0,0,0,0,3,0,0,0,3,0,3,2,0
1,0,0,1,1,1,2,0,0,0,0,3,0,0,0,3,0,3,2,0
1,0,0,1,1,1,2,0,0,0,0,3,0,0,0,3,0,3,2,0
1,0,0,1,1,1,2,0,0,0,0,3,0,0,0,3,0,3,2,0
1,0,0,1,1,1,2,0,0,0,0,3,0,0,0,3,0,3,2,0
1,0,0,1,1,1,2,0,0,0,0,3,0,0,0,3,0,3,2,0
1,0,0,1,1,1,2,0,0,0,0,3,0,0,0,3,0,3,2,0
1,0,0,1,1,1,0,7.74,1.5,17.41,0,5,0.67,0.97,2,3,2,3,0,0
1,0,0,1,1,1,0,7.74,1.5,17.41,0,5,0.67,0.97,2,3,2,3,0,0
1,0,0,1,1,1,0,0,0,0,0,3,0,0,0,3,0,3,0,0
1,0,0,1,1,1,0,5.33,1.5,12,0,4,0.67,0.67,1,3,1,3,0,0
1,0,0,1,1,1,2,0,0,0,0,3,0,0,0,3,0,3,2,0
1,0,0,1,1,1,2,0,0,0,0,3,0,0,0,3,0,3,2,0
1,0,0,1,1,1,2,0,0,0,0,3,0,0,0,3,0,3,2,0
1,0,0,1,1,1,2,0,0,0,0,3,0,0,0,3,0,3,2,0
1,0,0,1,1,1,2,0,0,0,0,3,0,0,0,3,0,3,2,0
1,0,0,1,1,1,2,0,0,0,0,3,0,0,0,3,0,3,2,0
1,0,0,1,1,1,2,0,0,0,0,3,0,0,0,3,0,3,2,0
1,0,0,1,1,1,2,0,0,0,0,3,0,0,0,3,0,3,2,0
1,0,0,1,1,1,2,0,0,0,0,3,0,0,0,3,0,3,2,0
1,0,0,1,1,1,2,0,0,0,0,3,0,0,0,3,0,3,2,0
1,0,0,1,1,1,2,0,0,0,0,3,0,0,0,3,0,3,2,0
1,0,0,1,1,1,0,0,0,0,0,1,0,0,0,1,0,1,0,0
1,0,2,1,1,1,2,7.74,1.5,17.41,0,5,0.67,0.97,2,3,2,3,2,0
1,0,2,1,1,1,2,7.74,1.5,17.41,0,5,0.67,0.97,2,3,2,3,2,0
1,0,6,1,1,1,20,86.01,6.09,3192.57,0.17,103,0.16,177.37,47,56,27,7,20,0
29,4,11,15,2,14,33,26.25,34.29,30859.5,0.3,168,0.03,1714.42,72,96,21,20,37,0
1,0,0,1,1,1,2,7.75,2,31.02,0.01,6,0.5,1.72,2,4,2,4,2,0
1,0,0,1,1,1,2,7.75,2,31.02,0.01,6,0.5,1.72,2,4,2,4,2,0
31,1,21,22,14,8,103,59.3,70.19,292157.05,1.39,635,0.01,16230.95,272,363,62,32,104,1
11,0,2,6,1,1,13,29.47,9.54,2681.34,0.09,64,0.1,148.96,31,33,13,8,13,0
1,0,0,1,1,1,2,5.33,1.5,12,0,4,0.67,0.67,1,3,1,3,2,0
1,0,0,1,1,1,2,5.33,1.5,12,0,4,0.67,0.67,1,3,1,3,2,0
1,0,0,1,1,1,2,5.33,1.5,12,0,4,0.67,0.67,1,3,1,3,2,0
1,0,0,1,1,1,2,5.33,1.5,12,0,4,0.67,0.67,1,3,1,3,2,0
1,0,0,1,1,1,2,5.33,1.5,12,0,4,0.67,0.67,1,3,1,3,2,0
1,0,0,1,1,1,2,5.33,1.5,12,0,4,0.67,0.67,1,3,1,3,2,0
1,0,0,1,1,1,2,5.33,1.5,12,0,4,0.67,0.67,1,3,1,3,2,0
1,0,0,1,1,1,1,0,0,0,0,0,0,0,0,0,0,0,1,0
1,0,0,1,1,1,1,0,0,0,0,1,0,0,0,1,0,1,1,0
1,0,0,1,1,1,2,5.33,1.5,12,0,4,0.67,0.67,1,3,1,3,2,0
1,0,0,1,1,1,2,5.33,1.5,12,0,4,0.67,0.67,1,3,1,3,2,0
1,9,0,1,1,1,2,0,0,0,0,9,0,0,9,0,1,0,11,0
1,0,0,1,1,1,1,0,0,0,0,0,0,0,0,0,0,0,1,0
1,0,0,1,1,1,1,0,0,0,0,0,0,0,0,0,0,0,1,0
1,0,0,1,1,1,1,0,0,0,0,1,0,0,0,1,0,1,1,0
1,0,0,1,1,1,4,18.49,2.4,106.51,0.01,14,0.42,5.92,6,8,5,4,4,0
1,0,0,1,1,1,2,5.33,1.5,12,0,4,0.67,0.67,1,3,1,3,2,0
1,0,0,1,1,1,5,8.45,0.75,4.75,0,4,1.33,0.26,3,1,2,1,5,0
1,0,0,1,1,1,1,0,0,0,0,0,0,0,0,0,0,0,1,0
1,0,0,1,1,1,1,0,0,0,0,1,0,0,0,1,0,1,1,0
1,0,0,1,1,1,3,10.8,2.5,67.5,0.01,9,0.4,3.75,3,6,3,5,3,0
1,0,0,1,1,1,2,5.33,1.5,12,0,4,0.67,0.67,1,3,1,3,2,0
1,0,0,1,1,1,2,6.2,2.5,38.77,0.01,6,0.4,2.15,1,5,1,5,2,0
1,0,0,1,1,1,4,9.51,0.5,2.38,0,3,2,0.13,2,1,2,1,4,0
1,0,0,1,1,1,1,0,0,0,0,1,0,0,0,1,0,1,1,0
1,0,0,1,1,1,1,0,0,0,0,1,0,0,0,1,0,1,1,0
1,0,0,1,1,1,1,0,0,0,0,1,0,0,0,1,0,1,1,0
1,0,0,1,1,1,1,0,0,0,0,1,0,0,0,1,0,1,1,0
1,0,0,1,1,1,1,0,0,0,0,1,0,0,0,1,0,1,1,0
1,0,0,1,1,1,1,0,0,0,0,1,0,0,0,1,0,1,1,0
1,0,0,1,1,1,1,0,0,0,0,1,0,0,0,1,0,1,1,0
9,3,0,5,5,4,4,6.95,27.62,5307.06,0.06,47,0.04,294.84,17,30,4,13,7,0
1,0,0,1,1,1,0,0,0,0,0,1,0,0,0,1,0,1,0,0
1,0,0,1,1,1,2,0,0,0,0,3,0,0,0,3,0,3,2,0
1,0,0,1,1,1,2,0,0,0,0,3,0,0,0,3,0,3,2,0
1,0,0,1,1,1,2,0,0,0,0,3,0,0,0,3,0,3,2,0
1,0,0,1,1,1,2,0,0,0,0,3,0,0,0,3,0,3,2,0
1,0,0,1,1,1,2,0,0,0,0,3,0,0,0,3,0,3,2,0
1,0,0,1,1,1,2,0,0,0,0,3,0,0,0,3,0,3,2,0
1,0,0,1,1,1,2,0,0,0,0,3,0,0,0,3,0,3,2,0
1,0,0,1,1,1,2,0,0,0,0,3,0,0,0,3,0,3,2,0
1,0,0,1,1,1,2,0,0,0,0,3,0,0,0,3,0,3,2,0
1,0,0,1,1,1,2,0,0,0,0,3,0,0,0,3,0,3,2,0
1,0,0,1,1,1,2,0,0,0,0,3,0,0,0,3,0,3,2,0
1,0,0,1,1,1,3,11.63,2,46.53,0.01,9,0.5,2.58,4,5,3,3,3,0
1,0,0,1,1,1,0,5.33,1.5,12,0,4,0.67,0.67,1,3,1,3,0,0
1,0,0,1,1,1,0,5.33,1.5,12,0,4,0.67,0.67,1,3,1,3,0,0
1,0,0,1,1,1,0,5.33,1.5,12,0,4,0.67,0.67,1,3,1,3,0,0
1,0,0,1,1,1,2,0,0,0,0,3,0,0,0,3,0,3,2,0
1,0,0,1,1,1,2,5.33,1.5,12,0,4,0.67,0.67,1,3,1,3,2,0
1,0,0,1,1,1,2,0,0,0,0,3,0,0,0,3,0,3,2,0
1,0,0,1,1,1,2,0,0,0,0,3,0,0,0,3,0,3,2,0
1,0,0,1,1,1,2,0,0,0,0,3,0,0,0,3,0,3,2,0
1,0,0,1,1,1,2,0,0,0,0,3,0,0,0,3,0,3,2,0
1,0,0,1,1,1,2,0,0,0,0,3,0,0,0,3,0,3,2,0
1,0,0,1,1,1,2,0,0,0,0,3,0,0,0,3,0,3,2,0
1,0,0,1,1,1,2,0,0,0,0,3,0,0,0,3,0,3,2,0
1,0,0,1,1,1,2,0,0,0,0,3,0,0,0,3,0,3,2,0
1,0,0,1,1,1,2,0,0,0,0,3,0,0,0,3,0,3,2,0
1,0,0,1,1,1,2,0,0,0,0,3,0,0,0,3,0,3,2,0
1,0,0,1,1,1,2,0,0,0,0,3,0,0,0,3,0,3,2,0
1,0,0,1,1,1,0,7.74,1.5,17.41,0,5,0.67,0.97,2,3,2,3,0,0
1,0,0,1,1,1,0,7.74,1.5,17.41,0,5,0.67,0.97,2,3,2,3,0,0
1,0,0,1,1,1,0,0,0,0,0,3,0,0,0,3,0,3,0,0
1,0,0,1,1,1,0,5.33,1.5,12,0,4,0.67,0.67,1,3,1,3,0,0
1,0,0,1,1,1,2,0,0,0,0,3,0,0,0,3,0,3,2,0
1,0,0,1,1,1,2,0,0,0,0,3,0,0,0,3,0,3,2,0
1,0,0,1,1,1,2,0,0,0,0,3,0,0,0,3,0,3,2,0
1,0,0,1,1,1,2,0,0,0,0,3,0,0,0,3,0,3,2,0
1,0,0,1,1,1,2,0,0,0,0,3,0,0,0,3,0,3,2,0
1,0,0,1,1,1,2,0,0,0,0,3,0,0,0,3,0,3,2,0
1,0,0,1,1,1,2,0,0,0,0,3,0,0,0,3,0,3,2,0
1,0,0,1,1,1,2,0,0,0,0,3,0,0,0,3,0,3,2,0
1,0,0,1,1,1,2,0,0,0,0,3,0,0,0,3,0,3,2,0
1,0,0,1,1,1,2,0,0,0,0,3,0,0,0,3,0,3,2,0
1,0,0,1,1,1,2,0,0,0,0,3,0,0,0,3,0,3,2,0
1,0,0,1,1,1,1,0,0,0,0,1,0,0,0,1,0,1,1,0
405,19,59,203,29,144,561,165.14,99.88,1647308.35,5.5,2360,0.01,91517.13,815,1545,102,25,580,1
89,1,11,45,2,44,115,28.33,74.12,155603.31,0.7,403,0.01,8644.63,126,277,17,20,116,1
1,0,0,1,1,1,14,2.17,6,78,0,13,0.17,4.33,12,1,1,1,14,0
16,5,12,10,10,1,45,43.52,22.2,21449.61,0.32,173,0.05,1191.64,74,99,30,18,50,0
15,5,10,8,7,5,31,44.15,13.83,8439.23,0.2,119,0.07,468.85,53,66,23,12,36,0
1,0,4,1,1,1,23,99.65,11.32,12774.69,0.38,212,0.09,709.7,78,134,31,9,23,0
51,13,155,26,15,13,715,634.12,34.41,750744.22,7.27,2816,0.03,41708.01,988,1828,201,14,728,1
9,3,7,5,4,3,20,30.19,11.37,3900.27,0.11,73,0.09,216.68,31,42,15,11,23,0
3,1,2,2,2,1,7,18,6,648,0.04,27,0.17,36,12,15,8,8,8,1
5,0,5,3,1,1,7,13.32,13.71,2505.06,0.06,43,0.07,139.17,16,27,7,12,7,0
5,0,5,3,1,1,7,13.32,13.71,2505.06,0.06,43,0.07,139.17,16,27,7,12,7,0
9,2,1,8,1,1,27,34.09,9.88,3329.22,0.11,68,0.1,184.96,24,44,17,14,29,0
3,0,1,2,1,1,2,12.09,6.3,479.73,0.03,20,0.16,26.65,7,13,5,9,2,0
1,0,0,1,1,1,2,5.33,1.5,12,0,4,0.67,0.67,1,3,1,3,2,0
1,0,0,1,1,1,2,5.33,1.5,12,0,4,0.67,0.67,1,3,1,3,2,0
1,0,0,1,1,1,2,5.33,1.5,12,0,4,0.67,0.67,1,3,1,3,2,0
1,0,0,1,1,1,2,5.33,1.5,12,0,4,0.67,0.67,1,3,1,3,2,0
1,0,0,1,1,1,2,5.33,1.5,12,0,4,0.67,0.67,1,3,1,3,2,0
1,0,0,1,1,1,2,5.33,1.5,12,0,4,0.67,0.67,1,3,1,3,2,0
1,0,0,1,1,1,2,5.33,1.5,12,0,4,0.67,0.67,1,3,1,3,2,0
1,0,0,1,1,1,2,5.33,1.5,12,0,4,0.67,0.67,1,3,1,3,2,0
1,0,0,1,1,1,2,5.33,1.5,12,0,4,0.67,0.67,1,3,1,3,2,0
1,0,0,1,1,1,2,0,0,0,0,4,0,0,0,4,0,4,2,0
1,0,0,1,1,1,1,0,0,0,0,1,0,0,0,1,0,1,1,0
1,0,0,1,1,1,2,0,0,0,0,5,0,0,0,5,0,5,2,0
11,1,4,6,1,1,21,13.86,22.5,7014.99,0.1,68,0.04,389.72,27,41,9,15,22,0
1,0,0,1,1,1,1,0,0,0,0,0,0,0,0,0,0,0,1,0
1,0,0,1,1,1,1,0,0,0,0,1,0,0,0,1,0,1,1,0
1,0,0,1,1,1,2,5.33,1.5,12,0,4,0.67,0.67,1,3,1,3,2,0
1,0,0,1,1,1,2,5.33,1.5,12,0,4,0.67,0.67,1,3,1,3,2,0
1,9,0,1,1,1,2,0,0,0,0,9,0,0,9,0,1,0,11,0
1,0,0,1,1,1,1,0,0,0,0,0,0,0,0,0,0,0,1,0
1,0,0,1,1,1,1,0,0,0,0,0,0,0,0,0,0,0,1,0
1,0,0,1,1,1,1,0,0,0,0,1,0,0,0,1,0,1,1,0
1,0,0,1,1,1,4,18.49,2.4,106.51,0.01,14,0.42,5.92,6,8,5,4,4,0
1,0,0,1,1,1,2,5.33,1.5,12,0,4,0.67,0.67,1,3,1,3,2,0
1,0,0,1,1,1,5,8.45,0.75,4.75,0,4,1.33,0.26,3,1,2,1,5,0
1,0,0,1,1,1,1,0,0,0,0,0,0,0,0,0,0,0,1,0
1,0,0,1,1,1,1,0,0,0,0,1,0,0,0,1,0,1,1,0
1,0,0,1,1,1,3,10.8,2.5,67.5,0.01,9,0.4,3.75,3,6,3,5,3,0
1,0,0,1,1,1,2,5.33,1.5,12,0,4,0.67,0.67,1,3,1,3,2,0
1,0,0,1,1,1,2,6.2,2.5,38.77,0.01,6,0.4,2.15,1,5,1,5,2,0
1,0,0,1,1,1,4,9.51,0.5,2.38,0,3,2,0.13,2,1,2,1,4,0
1,0,0,1,1,1,1,0,0,0,0,1,0,0,0,1,0,1,1,0
1,0,0,1,1,1,2,5.33,1.5,12,0,4,0.67,0.67,1,3,1,3,2,0
1,0,0,1,1,1,2,5.33,1.5,12,0,4,0.67,0.67,1,3,1,3,2,0
1,0,0,1,1,1,2,0,0,0,0,4,0,0,0,4,0,4,2,0
1,0,0,1,1,1,1,0,0,0,0,1,0,0,0,1,0,1,1,0
1,0,0,1,1,1,2,0,0,0,0,5,0,0,0,5,0,5,2,0
1,0,0,1,1,1,1,0,0,0,0,1,0,0,0,1,0,1,1,0
1,0,0,1,1,1,2,5.33,1.5,12,0,4,0.67,0.67,1,3,1,3,2,0
1,0,0,1,1,1,2,5.33,1.5,12,0,4,0.67,0.67,1,3,1,3,2,0
1,0,0,1,1,1,1,0,0,0,0,1,0,0,0,1,0,1,1,0
1,0,0,1,1,1,2,7.86,2.5,49.13,0.01,7,0.4,2.73,2,5,2,5,2,0
1,0,0,1,1,1,2,7.49,3,67.38,0.01,8,0.33,3.74,1,7,1,6,2,0
1,0,0,1,1,1,2,7.49,3,67.38,0.01,8,0.33,3.74,1,7,1,6,2,0
1,0,0,1,1,1,2,7.49,3,67.38,0.01,8,0.33,3.74,1,7,1,6,2,0
1,0,0,1,1,1,2,7.49,3,67.38,0.01,8,0.33,3.74,1,7,1,6,2,0
1,0,0,1,1,1,2,7.49,3,67.38,0.01,8,0.33,3.74,1,7,1,6,2,0
1,0,0,1,1,1,2,7.49,3,67.38,0.01,8,0.33,3.74,1,7,1,6,2,0
1,0,0,1,1,1,2,7.49,3,67.38,0.01,8,0.33,3.74,1,7,1,6,2,0
1,0,0,1,1,1,2,10.57,3,95.1,0.01,10,0.33,5.28,3,7,3,6,2,0
1,0,0,1,1,1,0,0,0,0,0,1,0,0,0,1,0,1,0,0
1,0,0,1,1,1,2,5.33,1.5,12,0,4,0.67,0.67,1,3,1,3,2,0
1,0,0,1,1,1,2,5.33,1.5,12,0,4,0.67,0.67,1,3,1,3,2,0
1,0,0,1,1,1,2,5.33,1.5,12,0,4,0.67,0.67,1,3,1,3,2,0
1,0,0,1,1,1,2,5.33,1.5,12,0,4,0.67,0.67,1,3,1,3,2,0
1,0,0,1,1,1,2,5.33,1.5,12,0,4,0.67,0.67,1,3,1,3,2,0
1,0,0,1,1,1,2,5.33,1.5,12,0,4,0.67,0.67,1,3,1,3,2,0
1,0,0,1,1,1,2,5.33,1.5,12,0,4,0.67,0.67,1,3,1,3,2,0
1,0,0,1,1,1,2,13.95,2.5,87.17,0.01,11,0.4,4.84,4,7,4,5,2,0
1,0,0,1,1,1,0,0,0,0,0,1,0,0,0,1,0,1,0,0
1,0,0,1,1,1,0,0,0,0,0,1,0,0,0,1,0,1,0,0
1,0,0,1,1,1,0,0,0,0,0,1,0,0,0,1,0,1,0,0
1,0,0,1,1,1,1,0,0,0,0,1,0,0,0,1,0,1,1,0
1,0,0,1,1,1,1,0,0,0,0,1,0,0,0,1,0,1,1,0
1,0,0,1,1,1,1,0,0,0,0,1,0,0,0,1,0,1,1,0
1,0,0,1,1,1,1,0,0,0,0,1,0,0,0,1,0,1,1,0
1,0,0,1,1,1,1,0,0,0,0,1,0,0,0,1,0,1,1,0
1,0,0,1,1,1,1,0,0,0,0,1,0,0,0,1,0,1,1,0
5,0,0,3,1,1,2,13.29,4.5,269.08,0.02,18,0.22,14.95,6,12,4,6,2,0
9,3,0,5,5,4,4,6.95,27.62,5307.06,0.06,47,0.04,294.84,17,30,4,13,7,0
1,0,1,1,1,1,2,16.92,3.5,207.22,0.02,16,0.29,11.51,6,10,6,7,2,0
1,0,0,1,1,1,0,0,0,0,0,1,0,0,0,1,0,1,0,0
1,0,0,1,1,1,0,0,0,0,0,1,0,0,0,1,0,1,0,0
7,1,0,4,2,3,15,14.41,13,2434.85,0.06,42,0.08,135.27,18,24,9,13,16,0
1,0,0,1,1,1,0,0,0,0,0,1,0,0,0,1,0,1,0,0
1,0,0,1,1,1,1,0,0,0,0,1,0,0,0,1,0,1,1,0
1,0,0,1,1,1,0,0,0,0,0,1,0,0,0,1,0,1,0,0
1,0,0,1,1,1,0,0,0,0,0,1,0,0,0,1,0,1,0,0
1,0,0,1,1,1,0,0,0,0,0,1,0,0,0,1,0,1,0,0
1,0,0,1,1,1,0,0,0,0,0,1,0,0,0,1,0,1,0,0
1,0,0,1,1,1,0,0,0,0,0,1,0,0,0,1,0,1,0,0
1,0,0,1,1,1,0,0,0,0,0,1,0,0,0,1,0,1,0,0
1,0,0,1,1,1,0,0,0,0,0,1,0,0,0,1,0,1,0,0
1,0,0,1,1,1,0,0,0,0,0,1,0,0,0,1,0,1,0,0
1,0,0,1,1,1,0,0,0,0,0,1,0,0,0,1,0,1,0,0
1,0,0,1,1,1,0,0,0,0,0,1,0,0,0,1,0,1,0,0
1,0,0,1,1,1,0,0,0,0,0,1,0,0,0,1,0,1,0,0
1,0,0,1,1,1,0,0,0,0,0,1,0,0,0,1,0,1,0,0
1,0,0,1,1,1,0,0,0,0,0,1,0,0,0,1,0,1,0,0
1,0,0,1,1,1,0,0,0,0,0,1,0,0,0,1,0,1,0,0
1,0,0,1,1,1,0,0,0,0,0,1,0,0,0,1,0,1,0,0
1,0,0,1,1,1,0,0,0,0,0,1,0,0,0,1,0,1,0,0
1,0,0,1,1,1,0,0,0,0,0,1,0,0,0,1,0,1,0,0
1,0,0,1,1,1,0,0,0,0,0,1,0,0,0,1,0,1,0,0
1,0,0,1,1,1,0,0,0,0,0,1,0,0,0,1,0,1,0,0
1,0,0,1,1,1,0,0,0,0,0,1,0,0,0,1,0,1,0,0
1,0,0,1,1,1,0,0,0,0,0,1,0,0,0,1,0,1,0,0
1,0,0,1,1,1,2,0,0,0,0,3,0,0,0,3,0,3,2,0
1,0,0,1,1,1,2,0,0,0,0,3,0,0,0,3,0,3,2,0
1,0,0,1,1,1,2,0,0,0,0,3,0,0,0,3,0,3,2,0
1,0,0,1,1,1,2,0,0,0,0,3,0,0,0,3,0,3,2,0
1,0,0,1,1,1,2,0,0,0,0,3,0,0,0,3,0,3,2,0
1,0,0,1,1,1,2,0,0,0,0,3,0,0,0,3,0,3,2,0
1,0,0,1,1,1,2,0,0,0,0,3,0,0,0,3,0,3,2,0
1,0,0,1,1,1,2,0,0,0,0,3,0,0,0,3,0,3,2,0
1,0,0,1,1,1,2,0,0,0,0,3,0,0,0,3,0,3,2,0
1,0,0,1,1,1,2,0,0,0,0,3,0,0,0,3,0,3,2,0
1,0,0,1,1,1,2,0,0,0,0,3,0,0,0,3,0,3,2,0
1,0,0,1,1,1,3,11.63,2,46.53,0.01,9,0.5,2.58,4,5,3,3,3,0
1,0,0,1,1,1,0,5.33,1.5,12,0,4,0.67,0.67,1,3,1,3,0,0
1,0,0,1,1,1,0,5.33,1.5,12,0,4,0.67,0.67,1,3,1,3,0,0
1,0,0,1,1,1,0,5.33,1.5,12,0,4,0.67,0.67,1,3,1,3,0,0
1,0,0,1,1,1,2,0,0,0,0,3,0,0,0,3,0,3,2,0
1,0,0,1,1,1,2,5.33,1.5,12,0,4,0.67,0.67,1,3,1,3,2,0
1,0,0,1,1,1,2,0,0,0,0,3,0,0,0,3,0,3,2,0
1,0,0,1,1,1,2,0,0,0,0,3,0,0,0,3,0,3,2,0
1,0,0,1,1,1,2,0,0,0,0,3,0,0,0,3,0,3,2,0
1,0,0,1,1,1,2,0,0,0,0,3,0,0,0,3,0,3,2,0
1,0,0,1,1,1,2,0,0,0,0,3,0,0,0,3,0,3,2,0
1,0,0,1,1,1,2,0,0,0,0,3,0,0,0,3,0,3,2,0
1,0,0,1,1,1,2,0,0,0,0,3,0,0,0,3,0,3,2,0
1,0,0,1,1,1,2,0,0,0,0,3,0,0,0,3,0,3,2,0
1,0,0,1,1,1,2,0,0,0,0,3,0,0,0,3,0,3,2,0
1,0,0,1,1,1,2,0,0,0,0,3,0,0,0,3,0,3,2,0
1,0,0,1,1,1,2,0,0,0,0,3,0,0,0,3,0,3,2,0
1,0,0,1,1,1,0,7.74,1.5,17.41,0,5,0.67,0.97,2,3,2,3,0,0
1,0,0,1,1,1,0,7.74,1.5,17.41,0,5,0.67,0.97,2,3,2,3,0,0
1,0,0,1,1,1,0,0,0,0,0,3,0,0,0,3,0,3,0,0
1,0,0,1,1,1,0,5.33,1.5,12,0,4,0.67,0.67,1,3,1,3,0,0
1,0,0,1,1,1,2,0,0,0,0,3,0,0,0,3,0,3,2,0
1,0,0,1,1,1,2,0,0,0,0,3,0,0,0,3,0,3,2,0
1,0,0,1,1,1,2,0,0,0,0,3,0,0,0,3,0,3,2,0
1,0,0,1,1,1,2,0,0,0,0,3,0,0,0,3,0,3,2,0
1,0,0,1,1,1,2,0,0,0,0,3,0,0,0,3,0,3,2,0
1,0,0,1,1,1,2,0,0,0,0,3,0,0,0,3,0,3,2,0
1,0,0,1,1,1,2,0,0,0,0,3,0,0,0,3,0,3,2,0
1,0,0,1,1,1,2,0,0,0,0,3,0,0,0,3,0,3,2,0
1,0,0,1,1,1,2,0,0,0,0,3,0,0,0,3,0,3,2,0
1,0,0,1,1,1,2,0,0,0,0,3,0,0,0,3,0,3,2,0
1,0,0,1,1,1,2,0,0,0,0,3,0,0,0,3,0,3,2,0
1,0,0,1,1,1,0,0,0,0,0,1,0,0,0,1,0,1,0,0
1,0,0,1,1,1,0,0,0,0,0,1,0,0,0,1,0,1,0,0
1,0,0,1,1,1,0,0,0,0,0,1,0,0,0,1,0,1,0,0
3,0,0,2,1,1,9,17.41,3.5,213.31,0.02,17,0.29,11.85,7,10,6,6,9,0
1,0,0,1,1,1,2,10.04,5,250.95,0.02,14,0.2,13.94,5,9,4,8,2,0
1,0,0,1,1,1,3,9.32,6.75,424.63,0.02,17,0.15,23.59,6,11,4,9,3,0
1,0,0,1,1,1,0,0,0,0,0,1,0,0,0,1,0,1,0,0
1,0,0,1,1,1,0,0,0,0,0,1,0,0,0,1,0,1,0,0
1,0,0,1,1,1,0,0,0,0,0,1,0,0,0,1,0,1,0,0
1,0,0,1,1,1,0,0,0,0,0,1,0,0,0,1,0,1,0,0
1,0,0,1,1,1,0,0,0,0,0,1,0,0,0,1,0,1,0,0
1,0,0,1,1,1,1,0,0,0,0,1,0,0,0,1,0,1,1,0
11,4,63,6,5,3,84,240.8,16.63,66624.85,1.34,583,0.06,3701.38,210,373,101,16,88,0
1,0,0,1,1,1,1,0,0,0,0,1,0,0,0,1,0,1,1,0
5,0,5,3,1,1,7,13.32,13.71,2505.06,0.06,43,0.07,139.17,16,27,7,12,7,0
5,0,5,3,1,1,7,13.32,13.71,2505.06,0.06,43,0.07,139.17,16,27,7,12,7,0
1,0,0,1,1,1,1,0,0,0,0,1,0,0,0,1,0,1,1,0
1,0,0,1,1,1,1,0,0,0,0,1,0,0,0,1,0,1,1,0
1,0,0,1,1,1,1,0,0,0,0,1,0,0,0,1,0,1,1,0
1,0,0,1,1,1,0,0,0,0,0,1,0,0,0,1,0,1,0,0
1,0,0,1,1,1,1,0,0,0,0,1,0,0,0,1,0,1,1,0
1,0,0,1,1,1,0,0,0,0,0,1,0,0,0,1,0,1,0,0
1,0,0,1,1,1,0,0,0,0,0,1,0,0,0,1,0,1,0,0
1,0,0,1,1,1,0,0,0,0,0,1,0,0,0,1,0,1,0,0
1,0,0,1,1,1,0,0,0,0,0,1,0,0,0,1,0,1,0,0
1,0,0,1,1,1,0,0,0,0,0,1,0,0,0,1,0,1,0,0
1,0,0,1,1,1,0,0,0,0,0,1,0,0,0,1,0,1,0,0
1,0,0,1,1,1,0,0,0,0,0,1,0,0,0,1,0,1,0,0
1,0,0,1,1,1,0,0,0,0,0,1,0,0,0,1,0,1,0,0
1,0,0,1,1,1,0,0,0,0,0,1,0,0,0,1,0,1,0,0
1,0,0,1,1,1,0,0,0,0,0,1,0,0,0,1,0,1,0,0
5,0,0,3,1,1,7,10.85,17,3136.11,0.06,42,0.06,174.23,17,25,7,14,7,0
5,0,1,3,1,1,6,12.57,13.13,2165.61,0.05,37,0.08,120.31,15,22,8,14,6,0
1,0,0,1,1,1,0,0,0,0,0,1,0,0,0,1,0,1,0,0
1,0,0,1,1,1,0,0,0,0,0,1,0,0,0,1,0,1,0,0
1,0,0,1,1,1,0,0,0,0,0,1,0,0,0,1,0,1,0,0
1,0,0,1,1,1,0,0,0,0,0,1,0,0,0,1,0,1,0,0
1,0,0,1,1,1,0,0,0,0,0,1,0,0,0,1,0,1,0,0
1,0,0,1,1,1,0,0,0,0,0,1,0,0,0,1,0,1,0,0
1,0,0,1,1,1,0,0,0,0,0,1,0,0,0,1,0,1,0,0
1,0,0,1,1,1,0,0,0,0,0,1,0,0,0,1,0,1,0,0
1,0,0,1,1,1,0,0,0,0,0,1,0,0,0,1,0,1,0,0
1,0,0,1,1,1,0,0,0,0,0,1,0,0,0,1,0,1,0,0
9,2,1,8,1,1,27,34.09,9.88,3329.22,0.11,68,0.1,184.96,24,44,17,14,29,0
1,0,0,1,1,1,0,0,0,0,0,1,0,0,0,1,0,1,0,0
1,0,0,1,1,1,0,0,0,0,0,1,0,0,0,1,0,1,0,0
1,0,0,1,1,1,0,0,0,0,0,1,0,0,0,1,0,1,0,0
1,0,0,1,1,1,0,0,0,0,0,1,0,0,0,1,0,1,0,0
1,0,0,1,1,1,0,0,0,0,0,1,0,0,0,1,0,1,0,0
1,0,0,1,1,1,0,0,0,0,0,1,0,0,0,1,0,1,0,0
1,0,0,1,1,1,0,0,0,0,0,1,0,0,0,1,0,1,0,0
1,0,0,1,1,1,0,0,0,0,0,1,0,0,0,1,0,1,0,0
1,0,0,1,1,1,0,0,0,0,0,1,0,0,0,1,0,1,0,0
1,0,0,1,1,1,1,0,0,0,0,1,0,0,0,1,0,1,1,0
1,0,0,1,1,1,0,0,0,0,0,1,0,0,0,1,0,1,0,0
1,0,0,1,1,1,0,0,0,0,0,1,0,0,0,1,0,1,0,0
1,0,0,1,1,1,0,0,0,0,0,1,0,0,0,1,0,1,0,0
1,0,0,1,1,1,0,0,0,0,0,1,0,0,0,1,0,1,0,0
1,0,0,1,1,1,0,0,0,0,0,1,0,0,0,1,0,1,0,0
1,0,0,1,1,1,0,0,0,0,0,1,0,0,0,1,0,1,0,0
1,0,0,1,1,1,0,0,0,0,0,1,0,0,0,1,0,1,0,0
1,0,0,1,1,1,0,0,0,0,0,1,0,0,0,1,0,1,0,0
1,0,0,1,1,1,0,0,0,0,0,1,0,0,0,1,0,1,0,0
1,0,0,1,1,1,1,0,0,0,0,1,0,0,0,1,0,1,1,0
1,0,0,1,1,1,0,0,0,0,0,1,0,0,0,1,0,1,0,0
1,0,0,1,1,1,0,0,0,0,0,1,0,0,0,1,0,1,0,0
1,0,0,1,1,1,1,0,0,0,0,1,0,0,0,1,0,1,1,0
1,0,0,1,1,1,0,0,0,0,0,1,0,0,0,1,0,1,0,0
1,0,0,1,1,1,0,0,0,0,0,1,0,0,0,1,0,1,0,0
1,0,0,1,1,1,0,0,0,0,0,1,0,0,0,1,0,1,0,0
1,0,0,1,1,1,0,0,0,0,0,1,0,0,0,1,0,1,0,0
1,0,0,1,1,1,1,0,0,0,0,1,0,0,0,1,0,1,1,0
1,0,0,1,1,1,1,0,0,0,0,1,0,0,0,1,0,1,1,0
1,0,0,1,1,1,1,0,0,0,0,1,0,0,0,1,0,1,1,0
1,0,0,1,1,1,0,5.33,1.5,12,0,4,0.67,0.67,1,3,1,3,0,0
1,0,0,1,1,1,0,7.74,1.5,17.41,0,5,0.67,0.97,2,3,2,3,0,0
1,0,0,1,1,1,2,13.18,5.25,363.24,0.02,20,0.19,20.18,6,14,4,7,2,0
3,0,1,2,1,1,2,12.09,6.3,479.73,0.03,20,0.16,26.65,7,13,5,9,2,0
1,0,0,1,1,1,2,5.33,1.5,12,0,4,0.67,0.67,1,3,1,3,2,0
1,0,0,1,1,1,2,5.33,1.5,12,0,4,0.67,0.67,1,3,1,3,2,0
1,0,0,1,1,1,2,5.33,1.5,12,0,4,0.67,0.67,1,3,1,3,2,0
1,0,0,1,1,1,2,5.33,1.5,12,0,4,0.67,0.67,1,3,1,3,2,0
1,0,0,1,1,1,2,5.33,1.5,12,0,4,0.67,0.67,1,3,1,3,2,0
1,0,0,1,1,1,2,5.33,1.5,12,0,4,0.67,0.67,1,3,1,3,2,0
1,0,0,1,1,1,2,5.33,1.5,12,0,4,0.67,0.67,1,3,1,3,2,0
1,0,0,1,1,1,2,5.33,1.5,12,0,4,0.67,0.67,1,3,1,3,2,0
1,0,0,1,1,1,2,5.33,1.5,12,0,4,0.67,0.67,1,3,1,3,2,0
1,0,0,1,1,1,2,5.33,1.5,12,0,4,0.67,0.67,1,3,1,3,2,0
1,0,0,1,1,1,2,5.33,1.5,12,0,4,0.67,0.67,1,3,1,3,2,0
1,0,0,1,1,1,2,5.33,1.5,12,0,4,0.67,0.67,1,3,1,3,2,0
1,0,0,1,1,1,2,5.33,1.5,12,0,4,0.67,0.67,1,3,1,3,2,0
1,0,0,1,1,1,2,13.88,4,222.03,0.02,15,0.25,12.33,5,10,5,8,2,0
1,0,0,1,1,1,2,11.3,6.13,423.78,0.02,20,0.16,23.54,7,13,4,7,2,0
1,0,0,1,1,1,2,0,0,0,0,4,0,0,0,4,0,4,2,0
1,0,0,1,1,1,1,0,0,0,0,1,0,0,0,1,0,1,1,0
1,0,0,1,1,1,0,0,0,0,0,1,0,0,0,1,0,1,0,0
1,0,0,1,1,1,2,0,0,0,0.01,6,0,0,0,6,0,6,2,0
1,0,0,1,1,1,2,0,0,0,0,5,0,0,0,5,0,5,2,0
11,1,4,6,1,1,21,13.86,22.5,7014.99,0.1,68,0.04,389.72,27,41,9,15,22,0
1,0,0,1,1,1,2,7.74,1.5,17.41,0,5,0.67,0.97,2,3,2,3,2,0
1,0,0,1,1,1,4,16.05,3.75,225.86,0.02,19,0.27,12.55,6,13,4,5,4,0
1,0,0,1,1,1,2,7.74,1.5,17.41,0,5,0.67,0.97,2,3,2,3,2,0
1,0,0,1,1,1,2,7.74,1.5,17.41,0,5,0.67,0.97,2,3,2,3,2,0
1,0,0,1,1,1,2,7.74,1.5,17.41,0,5,0.67,0.97,2,3,2,3,2,0
1,0,0,1,1,1,0,0,0,0,0,1,0,0,0,1,0,1,0,0
1,1,0,1,1,1,1,6.2,2.5,38.77,0.01,6,0.4,2.15,1,5,1,5,2,0
1,0,0,1,1,1,2,5.33,1.5,12,0,4,0.67,0.67,1,3,1,3,2,0
1,0,1,1,1,1,2,5.33,1.5,12,0,4,0.67,0.67,1,3,1,3,2,0
1,0,0,1,1,1,2,20.97,3,188.72,0.02,17,0.33,10.48,7,10,7,6,2,0
1,0,0,1,1,1,2,20.97,3,188.72,0.02,17,0.33,10.48,7,10,7,6,2,0
1,0,0,1,1,1,2,27.35,3,246.13,0.03,21,0.33,13.67,9,12,9,6,2,0
1,0,0,1,1,1,3,30.67,3,276,0.03,23,0.33,15.33,10,13,10,6,3,0
1,0,0,1,1,1,3,30.67,3,276,0.03,23,0.33,15.33,10,13,10,6,3,0
1,0,0,1,1,1,3,30.67,3,276,0.03,23,0.33,15.33,10,13,10,6,3,0
1,0,0,1,1,1,2,27.35,3,246.13,0.03,21,0.33,13.67,9,12,9,6,2,0
1,0,0,1,1,1,3,27.35,3,246.13,0.03,21,0.33,13.67,9,12,9,6,3,0
1,0,0,1,1,1,2,20.97,3,188.72,0.02,17,0.33,10.48,7,10,7,6,2,0
1,0,0,1,1,1,2,20.97,3,188.72,0.02,17,0.33,10.48,7,10,7,6,2,0
1,0,0,1,1,1,2,20.97,3,188.72,0.02,17,0.33,10.48,7,10,7,6,2,0
1,0,0,1,1,1,2,17.92,3,161.32,0.02,15,0.33,8.96,6,9,6,6,2,0
1,0,0,1,1,1,2,17.92,3,161.32,0.02,15,0.33,8.96,6,9,6,6,2,0
1,0,0,1,1,1,2,14.99,3,134.92,0.01,13,0.33,7.5,5,8,5,6,2,0
1,0,0,1,1,1,2,14.99,3,134.92,0.01,13,0.33,7.5,5,8,5,6,2,0
1,0,0,1,1,1,2,14.99,3,134.92,0.01,13,0.33,7.5,5,8,5,6,2,0
1,0,0,1,1,1,2,14.99,3,134.92,0.01,13,0.33,7.5,5,8,5,6,2,0
1,0,0,1,1,1,2,14.99,3,134.92,0.01,13,0.33,7.5,5,8,5,6,2,0
1,0,0,1,1,1,2,17.92,3,161.32,0.02,15,0.33,8.96,6,9,6,6,2,0
1,0,0,1,1,1,2,17.92,3,161.32,0.02,15,0.33,8.96,6,9,6,6,2,0
1,0,0,1,1,1,2,20.97,3,188.72,0.02,17,0.33,10.48,7,10,7,6,2,0
1,0,0,1,1,1,2,20.97,3,188.72,0.02,17,0.33,10.48,7,10,7,6,2,0
1,0,0,1,1,1,1,0,0,0,0,0,0,0,0,0,0,0,1,0
1,0,0,1,1,1,1,0,0,0,0,1,0,0,0,1,0,1,1,0
1,0,0,1,1,1,2,5.33,1.5,12,0,4,0.67,0.67,1,3,1,3,2,0
1,0,0,1,1,1,2,5.33,1.5,12,0,4,0.67,0.67,1,3,1,3,2,0
1,9,0,1,1,1,2,0,0,0,0,9,0,0,9,0,1,0,11,0
1,0,0,1,1,1,1,0,0,0,0,0,0,0,0,0,0,0,1,0
1,0,0,1,1,1,1,0,0,0,0,0,0,0,0,0,0,0,1,0
1,0,0,1,1,1,1,0,0,0,0,1,0,0,0,1,0,1,1,0
1,0,0,1,1,1,4,18.49,2.4,106.51,0.01,14,0.42,5.92,6,8,5,4,4,0
1,0,0,1,1,1,2,5.33,1.5,12,0,4,0.67,0.67,1,3,1,3,2,0
1,0,0,1,1,1,5,8.45,0.75,4.75,0,4,1.33,0.26,3,1,2,1,5,0
1,0,0,1,1,1,1,0,0,0,0,0,0,0,0,0,0,0,1,0
1,0,0,1,1,1,1,0,0,0,0,1,0,0,0,1,0,1,1,0
1,0,0,1,1,1,3,10.8,2.5,67.5,0.01,9,0.4,3.75,3,6,3,5,3,0
1,0,0,1,1,1,2,5.33,1.5,12,0,4,0.67,0.67,1,3,1,3,2,0
1,0,0,1,1,1,2,6.2,2.5,38.77,0.01,6,0.4,2.15,1,5,1,5,2,0
1,0,0,1,1,1,4,9.51,0.5,2.38,0,3,2,0.13,2,1,2,1,4,0
1,0,0,1,1,1,1,0,0,0,0,1,0,0,0,1,0,1,1,0
1,0,0,1,1,1,2,5.33,1.5,12,0,4,0.67,0.67,1,3,1,3,2,0
1,0,0,1,1,1,2,5.33,1.5,12,0,4,0.67,0.67,1,3,1,3,2,0
1,0,0,1,1,1,2,0,0,0,0,4,0,0,0,4,0,4,2,0
1,0,0,1,1,1,1,0,0,0,0,1,0,0,0,1,0,1,1,0
1,0,0,1,1,1,2,0,0,0,0,5,0,0,0,5,0,5,2,0
1,0,0,1,1,1,1,0,0,0,0,1,0,0,0,1,0,1,1,0
1,0,0,1,1,1,2,5.33,1.5,12,0,4,0.67,0.67,1,3,1,3,2,0
1,0,0,1,1,1,2,5.33,1.5,12,0,4,0.67,0.67,1,3,1,3,2,0
1,0,0,1,1,1,1,0,0,0,0,1,0,0,0,1,0,1,1,0
1,0,0,1,1,1,0,0,0,0,0,1,0,0,0,1,0,1,0,0
1,0,0,1,1,1,0,0,0,0,0,1,0,0,0,1,0,1,0,0
1,0,0,1,1,1,1,0,0,0,0,1,0,0,0,1,0,1,1,0
1,0,0,1,1,1,1,0,0,0,0,1,0,0,0,1,0,1,1,0
1,0,0,1,1,1,1,0,0,0,0,1,0,0,0,1,0,1,1,0
1,0,0,1,1,1,1,0,0,0,0,1,0,0,0,1,0,1,1,0
1,0,0,1,1,1,1,0,0,0,0,1,0,0,0,1,0,1,1,0
1,0,0,1,1,1,1,0,0,0,0,1,0,0,0,1,0,1,1,0
9,3,0,5,5,4,4,6.95,27.62,5307.06,0.06,47,0.04,294.84,17,30,4,13,7,0
1,0,0,1,1,1,1,0,0,0,0,1,0,0,0,1,0,1,1,0
1,0,0,1,1,1,0,0,0,0,0,1,0,0,0,1,0,1,0,0
1,0,0,1,1,1,0,0,0,0,0,1,0,0,0,1,0,1,0,0
1,0,0,1,1,1,0,0,0,0,0,1,0,0,0,1,0,1,0,0
1,0,0,1,1,1,0,0,0,0,0,1,0,0,0,1,0,1,0,0
1,0,0,1,1,1,0,0,0,0,0,1,0,0,0,1,0,1,0,0
1,0,0,1,1,1,0,0,0,0,0,1,0,0,0,1,0,1,0,0
1,0,0,1,1,1,0,0,0,0,0,1,0,0,0,1,0,1,0,0
1,0,0,1,1,1,0,0,0,0,0,1,0,0,0,1,0,1,0,0
1,0,0,1,1,1,0,0,0,0,0,1,0,0,0,1,0,1,0,0
1,0,0,1,1,1,0,0,0,0,0,1,0,0,0,1,0,1,0,0
1,0,0,1,1,1,0,0,0,0,0,1,0,0,0,1,0,1,0,0
1,0,0,1,1,1,0,0,0,0,0,1,0,0,0,1,0,1,0,0
1,0,0,1,1,1,0,0,0,0,0,1,0,0,0,1,0,1,0,0
1,0,0,1,1,1,2,0,0,0,0,3,0,0,0,3,0,3,2,0
1,0,0,1,1,1,2,0,0,0,0,3,0,0,0,3,0,3,2,0
1,0,0,1,1,1,2,0,0,0,0,3,0,0,0,3,0,3,2,0
1,0,0,1,1,1,2,0,0,0,0,3,0,0,0,3,0,3,2,0
1,0,0,1,1,1,2,0,0,0,0,3,0,0,0,3,0,3,2,0
1,0,0,1,1,1,2,0,0,0,0,3,0,0,0,3,0,3,2,0
1,0,0,1,1,1,2,0,0,0,0,3,0,0,0,3,0,3,2,0
1,0,0,1,1,1,2,0,0,0,0,3,0,0,0,3,0,3,2,0
1,0,0,1,1,1,2,0,0,0,0,3,0,0,0,3,0,3,2,0
1,0,0,1,1,1,2,0,0,0,0,3,0,0,0,3,0,3,2,0
1,0,0,1,1,1,2,0,0,0,0,3,0,0,0,3,0,3,2,0
1,0,0,1,1,1,3,11.63,2,46.53,0.01,9,0.5,2.58,4,5,3,3,3,0
1,0,0,1,1,1,0,5.33,1.5,12,0,4,0.67,0.67,1,3,1,3,0,0
1,0,0,1,1,1,0,5.33,1.5,12,0,4,0.67,0.67,1,3,1,3,0,0
1,0,0,1,1,1,0,5.33,1.5,12,0,4,0.67,0.67,1,3,1,3,0,0
1,0,0,1,1,1,2,0,0,0,0,3,0,0,0,3,0,3,2,0
1,0,0,1,1,1,2,5.33,1.5,12,0,4,0.67,0.67,1,3,1,3,2,0
1,0,0,1,1,1,2,0,0,0,0,3,0,0,0,3,0,3,2,0
1,0,0,1,1,1,2,0,0,0,0,3,0,0,0,3,0,3,2,0
1,0,0,1,1,1,2,0,0,0,0,3,0,0,0,3,0,3,2,0
1,0,0,1,1,1,2,0,0,0,0,3,0,0,0,3,0,3,2,0
1,0,0,1,1,1,2,0,0,0,0,3,0,0,0,3,0,3,2,0
1,0,0,1,1,1,2,0,0,0,0,3,0,0,0,3,0,3,2,0
1,0,0,1,1,1,2,0,0,0,0,3,0,0,0,3,0,3,2,0
1,0,0,1,1,1,2,0,0,0,0,3,0,0,0,3,0,3,2,0
1,0,0,1,1,1,2,0,0,0,0,3,0,0,0,3,0,3,2,0
1,0,0,1,1,1,2,0,0,0,0,3,0,0,0,3,0,3,2,0
1,0,0,1,1,1,2,0,0,0,0,3,0,0,0,3,0,3,2,0
1,0,0,1,1,1,0,7.74,1.5,17.41,0,5,0.67,0.97,2,3,2,3,0,0
1,0,0,1,1,1,0,7.74,1.5,17.41,0,5,0.67,0.97,2,3,2,3,0,0
1,0,0,1,1,1,0,0,0,0,0,3,0,0,0,3,0,3,0,0
1,0,0,1,1,1,0,5.33,1.5,12,0,4,0.67,0.67,1,3,1,3,0,0
1,0,0,1,1,1,2,0,0,0,0,3,0,0,0,3,0,3,2,0
1,0,0,1,1,1,2,0,0,0,0,3,0,0,0,3,0,3,2,0
1,0,0,1,1,1,2,0,0,0,0,3,0,0,0,3,0,3,2,0
1,0,0,1,1,1,2,0,0,0,0,3,0,0,0,3,0,3,2,0
1,0,0,1,1,1,2,0,0,0,0,3,0,0,0,3,0,3,2,0
1,0,0,1,1,1,2,0,0,0,0,3,0,0,0,3,0,3,2,0
1,0,0,1,1,1,2,0,0,0,0,3,0,0,0,3,0,3,2,0
1,0,0,1,1,1,2,0,0,0,0,3,0,0,0,3,0,3,2,0
1,0,0,1,1,1,2,0,0,0,0,3,0,0,0,3,0,3,2,0
1,0,0,1,1,1,2,0,0,0,0,3,0,0,0,3,0,3,2,0
1,0,0,1,1,1,2,0,0,0,0,3,0,0,0,3,0,3,2,0
1,0,0,1,1,1,0,0,0,0,0,1,0,0,0,1,0,1,0,0
1,0,0,1,1,1,0,0,0,0,0,1,0,0,0,1,0,1,0,0
1,0,0,1,1,1,0,0,0,0,0,1,0,0,0,1,0,1,0,0
23,10,86,12,9,6,151,420.73,16.3,111839.02,2.29,908,0.06,6213.28,328,580,171,17,161,0
1,0,0,1,1,1,0,0,0,0,0,1,0,0,0,1,0,1,0,0
1,0,0,1,1,1,0,0,0,0,0,1,0,0,0,1,0,1,0,0
1,0,0,1,1,1,0,0,0,0,0,1,0,0,0,1,0,1,0,0
1,0,0,1,1,1,1,0,0,0,0,1,0,0,0,1,0,1,1,0
5,0,5,3,1,1,7,13.32,13.71,2505.06,0.06,43,0.07,139.17,16,27,7,12,7,0
5,0,5,3,1,1,7,13.32,13.71,2505.06,0.06,43,0.07,139.17,16,27,7,12,7,0
1,0,0,1,1,1,1,0,0,0,0,1,0,0,0,1,0,1,1,0
1,0,0,1,1,1,0,0,0,0,0,1,0,0,0,1,0,1,0,0
1,0,0,1,1,1,0,0,0,0,0,1,0,0,0,1,0,1,0,0
1,0,0,1,1,1,1,0,0,0,0,1,0,0,0,1,0,1,1,0
1,0,0,1,1,1,0,0,0,0,0,1,0,0,0,1,0,1,0,0
1,0,0,1,1,1,1,0,0,0,0,1,0,0,0,1,0,1,1,0
1,0,0,1,1,1,1,0,0,0,0,1,0,0,0,1,0,1,1,0
1,0,0,1,1,1,1,0,0,0,0,1,0,0,0,1,0,1,1,0
1,0,0,1,1,1,0,0,0,0,0,1,0,0,0,1,0,1,0,0
1,0,0,1,1,1,0,0,0,0,0,1,0,0,0,1,0,1,0,0
1,0,0,1,1,1,0,0,0,0,0,1,0,0,0,1,0,1,0,0
1,0,0,1,1,1,0,0,0,0,0,1,0,0,0,1,0,1,0,0
1,0,0,1,1,1,0,0,0,0,0,1,0,0,0,1,0,1,0,0
1,0,0,1,1,1,0,0,0,0,0,1,0,0,0,1,0,1,0,0
1,0,0,1,1,1,0,0,0,0,0,1,0,0,0,1,0,1,0,0
5,0,0,3,1,1,7,10.85,17,3136.11,0.06,42,0.06,174.23,17,25,7,14,7,0
5,0,1,3,1,1,6,12.57,13.13,2165.61,0.05,37,0.08,120.31,15,22,8,14,6,0
1,0,0,1,1,1,0,0,0,0,0,1,0,0,0,1,0,1,0,0
1,0,0,1,1,1,1,0,0,0,0,1,0,0,0,1,0,1,1,0
1,0,0,1,1,1,1,0,0,0,0,1,0,0,0,1,0,1,1,0
1,0,0,1,1,1,1,0,0,0,0,1,0,0,0,1,0,1,1,0
1,0,0,1,1,1,1,0,0,0,0,1,0,0,0,1,0,1,1,0
1,0,0,1,1,1,1,0,0,0,0,1,0,0,0,1,0,1,1,0
1,0,0,1,1,1,0,0,0,0,0,1,0,0,0,1,0,1,0,0
1,0,0,1,1,1,0,0,0,0,0,1,0,0,0,1,0,1,0,0
1,0,0,1,1,1,0,0,0,0,0,1,0,0,0,1,0,1,0,0
1,0,0,1,1,1,0,0,0,0,0,1,0,0,0,1,0,1,0,0
1,0,0,1,1,1,0,0,0,0,0,1,0,0,0,1,0,1,0,0
1,0,0,1,1,1,0,0,0,0,0,1,0,0,0,1,0,1,0,0
1,0,0,1,1,1,0,0,0,0,0,1,0,0,0,1,0,1,0,0
1,0,0,1,1,1,0,0,0,0,0,1,0,0,0,1,0,1,0,0
1,0,0,1,1,1,1,0,0,0,0,1,0,0,0,1,0,1,1,0
1,0,0,1,1,1,0,0,0,0,0,1,0,0,0,1,0,1,0,0
1,0,0,1,1,1,0,0,0,0,0,1,0,0,0,1,0,1,0,0
9,2,1,8,1,1,27,34.09,9.88,3329.22,0.11,68,0.1,184.96,24,44,17,14,29,0
1,0,0,1,1,1,0,0,0,0,0,1,0,0,0,1,0,1,0,0
1,0,0,1,1,1,1,0,0,0,0,1,0,0,0,1,0,1,1,0
1,0,0,1,1,1,1,0,0,0,0,1,0,0,0,1,0,1,1,0
1,0,0,1,1,1,0,0,0,0,0,1,0,0,0,1,0,1,0,0
1,0,0,1,1,1,1,0,0,0,0,1,0,0,0,1,0,1,1,0
1,0,0,1,1,1,0,0,0,0,0,1,0,0,0,1,0,1,0,0
1,0,0,1,1,1,0,0,0,0,0,1,0,0,0,1,0,1,0,0
1,0,0,1,1,1,0,0,0,0,0,1,0,0,0,1,0,1,0,0
1,0,0,1,1,1,0,0,0,0,0,1,0,0,0,1,0,1,0,0
1,0,0,1,1,1,0,0,0,0,0,1,0,0,0,1,0,1,0,0
1,0,0,1,1,1,0,0,0,0,0,1,0,0,0,1,0,1,0,0
1,0,0,1,1,1,0,0,0,0,0,1,0,0,0,1,0,1,0,0
1,0,0,1,1,1,0,0,0,0,0,1,0,0,0,1,0,1,0,0
1,0,0,1,1,1,0,0,0,0,0,1,0,0,0,1,0,1,0,0
1,0,0,1,1,1,1,0,0,0,0,1,0,0,0,1,0,1,1,0
1,0,0,1,1,1,0,0,0,0,0,1,0,0,0,1,0,1,0,0
1,0,0,1,1,1,1,0,0,0,0,1,0,0,0,1,0,1,1,0
1,0,0,1,1,1,1,0,0,0,0,1,0,0,0,1,0,1,1,0
1,0,0,1,1,1,0,0,0,0,0,1,0,0,0,1,0,1,0,0
1,0,0,1,1,1,0,0,0,0,0,1,0,0,0,1,0,1,0,0
1,0,0,1,1,1,0,0,0,0,0,1,0,0,0,1,0,1,0,0
1,0,0,1,1,1,0,0,0,0,0,1,0,0,0,1,0,1,0,0
1,0,0,1,1,1,0,0,0,0,0,1,0,0,0,1,0,1,0,0
1,0,0,1,1,1,0,0,0,0,0,1,0,0,0,1,0,1,0,0
1,0,0,1,1,1,1,0,0,0,0,1,0,0,0,1,0,1,1,0
1,0,0,1,1,1,0,0,0,0,0,1,0,0,0,1,0,1,0,0
1,0,0,1,1,1,0,0,0,0,0,1,0,0,0,1,0,1,0,0
1,0,0,1,1,1,0,0,0,0,0,1,0,0,0,1,0,1,0,0
1,0,0,1,1,1,0,0,0,0,0,1,0,0,0,1,0,1,0,0
1,0,0,1,1,1,0,0,0,0,0,1,0,0,0,1,0,1,0,0
1,0,0,1,1,1,0,0,0,0,0,1,0,0,0,1,0,1,0,0
1,0,0,1,1,1,0,0,0,0,0,1,0,0,0,1,0,1,0,0
1,0,0,1,1,1,0,0,0,0,0,1,0,0,0,1,0,1,0,0
1,0,0,1,1,1,0,0,0,0,0,1,0,0,0,1,0,1,0,0
1,0,0,1,1,1,0,0,0,0,0,1,0,0,0,1,0,1,0,0
1,0,0,1,1,1,0,0,0,0,0,1,0,0,0,1,0,1,0,0
1,0,0,1,1,1,0,0,0,0,0,1,0,0,0,1,0,1,0,0
1,0,0,1,1,1,1,0,0,0,0,1,0,0,0,1,0,1,1,0
1,0,0,1,1,1,1,0,0,0,0,1,0,0,0,1,0,1,1,0
1,0,0,1,1,1,0,0,0,0,0,1,0,0,0,1,0,1,0,0
1,0,0,1,1,1,0,0,0,0,0,1,0,0,0,1,0,1,0,0
1,0,0,1,1,1,0,0,0,0,0,1,0,0,0,1,0,1,0,0
1,0,0,1,1,1,0,0,0,0,0,1,0,0,0,1,0,1,0,0
1,0,0,1,1,1,0,0,0,0,0,1,0,0,0,1,0,1,0,0
1,0,0,1,1,1,1,0,0,0,0,1,0,0,0,1,0,1,1,0
1,0,0,1,1,1,0,0,0,0,0,1,0,0,0,1,0,1,0,0
5,0,2,3,1,1,6,17.17,5,429.18,0.03,21,0.2,23.84,7,14,7,10,6,0
1,0,0,1,1,1,0,0,0,0,0,1,0,0,0,1,0,1,0,0
1,0,0,1,1,1,0,5.33,1.5,12,0,4,0.67,0.67,1,3,1,3,0,0
1,0,0,1,1,1,0,0,0,0,0,1,0,0,0,1,0,1,0,0
1,0,0,1,1,1,0,0,0,0,0,1,0,0,0,1,0,1,0,0
1,0,0,1,1,1,1,0,0,0,0,1,0,0,0,1,0,1,1,0
1,0,0,1,1,1,1,0,0,0,0,1,0,0,0,1,0,1,1,0
1,0,0,1,1,1,1,0,0,0,0,1,0,0,0,1,0,1,1,0
1,0,0,1,1,1,0,5.33,1.5,12,0,4,0.67,0.67,1,3,1,3,0,0
1,0,0,1,1,1,0,7.74,1.5,17.41,0,5,0.67,0.97,2,3,2,3,0,0
1,0,0,1,1,1,2,13.18,5.25,363.24,0.02,20,0.19,20.18,6,14,4,7,2,0
3,0,1,2,1,1,2,12.09,6.3,479.73,0.03,20,0.16,26.65,7,13,5,9,2,0
1,0,0,1,1,1,2,5.33,1.5,12,0,4,0.67,0.67,1,3,1,3,2,0
1,0,0,1,1,1,2,5.33,1.5,12,0,4,0.67,0.67,1,3,1,3,2,0
1,0,0,1,1,1,2,5.33,1.5,12,0,4,0.67,0.67,1,3,1,3,2,0
1,0,0,1,1,1,2,5.33,1.5,12,0,4,0.67,0.67,1,3,1,3,2,0
1,0,0,1,1,1,2,5.33,1.5,12,0,4,0.67,0.67,1,3,1,3,2,0
1,0,0,1,1,1,2,5.33,1.5,12,0,4,0.67,0.67,1,3,1,3,2,0
1,0,0,1,1,1,2,5.33,1.5,12,0,4,0.67,0.67,1,3,1,3,2,0
1,0,0,1,1,1,2,5.33,1.5,12,0,4,0.67,0.67,1,3,1,3,2,0
1,0,0,1,1,1,2,5.33,1.5,12,0,4,0.67,0.67,1,3,1,3,2,0
1,0,0,1,1,1,2,5.33,1.5,12,0,4,0.67,0.67,1,3,1,3,2,0
1,0,0,1,1,1,2,5.33,1.5,12,0,4,0.67,0.67,1,3,1,3,2,0
1,0,0,1,1,1,2,5.33,1.5,12,0,4,0.67,0.67,1,3,1,3,2,0
1,0,0,1,1,1,2,11.3,6.13,423.78,0.02,20,0.16,23.54,7,13,4,7,2,0
1,0,0,1,1,1,2,0,0,0,0,4,0,0,0,4,0,4,2,0
1,0,0,1,1,1,1,0,0,0,0,1,0,0,0,1,0,1,1,0
1,0,0,1,1,1,2,0,0,0,0,5,0,0,0,5,0,5,2,0
11,1,4,6,1,1,21,13.86,22.5,7014.99,0.1,68,0.04,389.72,27,41,9,15,22,0
1,0,0,1,1,1,2,7.74,1.5,17.41,0,5,0.67,0.97,2,3,2,3,2,0
1,0,0,1,1,1,2,7.74,1.5,17.41,0,5,0.67,0.97,2,3,2,3,2,0
1,0,0,1,1,1,2,7.74,1.5,17.41,0,5,0.67,0.97,2,3,2,3,2,0
1,0,0,1,1,1,2,20.97,3,188.72,0.02,17,0.33,10.48,7,10,7,6,2,0
1,0,0,1,1,1,2,20.97,3,188.72,0.02,17,0.33,10.48,7,10,7,6,2,0
1,0,0,1,1,1,2,27.35,3,246.13,0.03,21,0.33,13.67,9,12,9,6,2,0
1,0,0,1,1,1,3,30.67,3,276,0.03,23,0.33,15.33,10,13,10,6,3,0
1,0,0,1,1,1,3,30.67,3,276,0.03,23,0.33,15.33,10,13,10,6,3,0
1,0,0,1,1,1,3,30.67,3,276,0.03,23,0.33,15.33,10,13,10,6,3,0
1,0,0,1,1,1,2,27.35,3,246.13,0.03,21,0.33,13.67,9,12,9,6,2,0
1,0,0,1,1,1,3,27.35,3,246.13,0.03,21,0.33,13.67,9,12,9,6,3,0
1,0,0,1,1,1,2,20.97,3,188.72,0.02,17,0.33,10.48,7,10,7,6,2,0
1,0,0,1,1,1,2,20.97,3,188.72,0.02,17,0.33,10.48,7,10,7,6,2,0
1,0,0,1,1,1,2,20.97,3,188.72,0.02,17,0.33,10.48,7,10,7,6,2,0
1,0,0,1,1,1,2,17.92,3,161.32,0.02,15,0.33,8.96,6,9,6,6,2,0
1,0,0,1,1,1,2,17.92,3,161.32,0.02,15,0.33,8.96,6,9,6,6,2,0
1,0,0,1,1,1,2,14.99,3,134.92,0.01,13,0.33,7.5,5,8,5,6,2,0
1,0,0,1,1,1,2,14.99,3,134.92,0.01,13,0.33,7.5,5,8,5,6,2,0
1,0,0,1,1,1,2,14.99,3,134.92,0.01,13,0.33,7.5,5,8,5,6,2,0
1,0,0,1,1,1,2,14.99,3,134.92,0.01,13,0.33,7.5,5,8,5,6,2,0
1,0,0,1,1,1,2,14.99,3,134.92,0.01,13,0.33,7.5,5,8,5,6,2,0
1,0,0,1,1,1,2,17.92,3,161.32,0.02,15,0.33,8.96,6,9,6,6,2,0
1,0,0,1,1,1,2,17.92,3,161.32,0.02,15,0.33,8.96,6,9,6,6,2,0
1,0,0,1,1,1,2,20.97,3,188.72,0.02,17,0.33,10.48,7,10,7,6,2,0
1,0,0,1,1,1,2,20.97,3,188.72,0.02,17,0.33,10.48,7,10,7,6,2,0
1,0,0,1,1,1,1,0,0,0,0,0,0,0,0,0,0,0,1,0
1,0,0,1,1,1,1,0,0,0,0,1,0,0,0,1,0,1,1,0
1,0,0,1,1,1,2,5.33,1.5,12,0,4,0.67,0.67,1,3,1,3,2,0
1,0,0,1,1,1,2,5.33,1.5,12,0,4,0.67,0.67,1,3,1,3,2,0
1,9,0,1,1,1,2,0,0,0,0,9,0,0,9,0,1,0,11,0
1,0,0,1,1,1,1,0,0,0,0,0,0,0,0,0,0,0,1,0
1,0,0,1,1,1,1,0,0,0,0,0,0,0,0,0,0,0,1,0
1,0,0,1,1,1,1,0,0,0,0,1,0,0,0,1,0,1,1,0
1,0,0,1,1,1,4,18.49,2.4,106.51,0.01,14,0.42,5.92,6,8,5,4,4,0
1,0,0,1,1,1,2,5.33,1.5,12,0,4,0.67,0.67,1,3,1,3,2,0
1,0,0,1,1,1,5,8.45,0.75,4.75,0,4,1.33,0.26,3,1,2,1,5,0
1,0,0,1,1,1,1,0,0,0,0,0,0,0,0,0,0,0,1,0
1,0,0,1,1,1,1,0,0,0,0,1,0,0,0,1,0,1,1,0
1,0,0,1,1,1,3,10.8,2.5,67.5,0.01,9,0.4,3.75,3,6,3,5,3,0
1,0,0,1,1,1,2,5.33,1.5,12,0,4,0.67,0.67,1,3,1,3,2,0
1,0,0,1,1,1,2,6.2,2.5,38.77,0.01,6,0.4,2.15,1,5,1,5,2,0
1,0,0,1,1,1,4,9.51,0.5,2.38,0,3,2,0.13,2,1,2,1,4,0
1,0,0,1,1,1,1,0,0,0,0,1,0,0,0,1,0,1,1,0
1,0,0,1,1,1,2,5.33,1.5,12,0,4,0.67,0.67,1,3,1,3,2,0
1,0,0,1,1,1,2,5.33,1.5,12,0,4,0.67,0.67,1,3,1,3,2,0
1,0,0,1,1,1,2,0,0,0,0,4,0,0,0,4,0,4,2,0
1,0,0,1,1,1,1,0,0,0,0,1,0,0,0,1,0,1,1,0
1,0,0,1,1,1,2,0,0,0,0,5,0,0,0,5,0,5,2,0
1,0,0,1,1,1,1,0,0,0,0,1,0,0,0,1,0,1,1,0
1,0,0,1,1,1,2,5.33,1.5,12,0,4,0.67,0.67,1,3,1,3,2,0
1,0,0,1,1,1,2,5.33,1.5,12,0,4,0.67,0.67,1,3,1,3,2,0
1,0,0,1,1,1,1,0,0,0,0,1,0,0,0,1,0,1,1,0
1,0,0,1,1,1,1,0,0,0,0,1,0,0,0,1,0,1,1,0
1,0,0,1,1,1,1,0,0,0,0,1,0,0,0,1,0,1,1,0
1,0,0,1,1,1,1,0,0,0,0,1,0,0,0,1,0,1,1,0
1,0,0,1,1,1,1,0,0,0,0,1,0,0,0,1,0,1,1,0
1,0,0,1,1,1,1,0,0,0,0,1,0,0,0,1,0,1,1,0
1,0,0,1,1,1,1,0,0,0,0,1,0,0,0,1,0,1,1,0
1,0,0,1,1,1,0,0,0,0,0,1,0,0,0,1,0,1,0,0
1,0,0,1,1,1,2,0,0,0,0,3,0,0,0,3,0,3,2,0
1,0,0,1,1,1,2,0,0,0,0,3,0,0,0,3,0,3,2,0
1,0,0,1,1,1,2,0,0,0,0,3,0,0,0,3,0,3,2,0
1,0,0,1,1,1,2,0,0,0,0,3,0,0,0,3,0,3,2,0
1,0,0,1,1,1,2,0,0,0,0,3,0,0,0,3,0,3,2,0
1,0,0,1,1,1,2,0,0,0,0,3,0,0,0,3,0,3,2,0
1,0,0,1,1,1,2,0,0,0,0,3,0,0,0,3,0,3,2,0
1,0,0,1,1,1,2,0,0,0,0,3,0,0,0,3,0,3,2,0
1,0,0,1,1,1,2,0,0,0,0,3,0,0,0,3,0,3,2,0
1,0,0,1,1,1,2,0,0,0,0,3,0,0,0,3,0,3,2,0
1,0,0,1,1,1,2,0,0,0,0,3,0,0,0,3,0,3,2,0
1,0,0,1,1,1,3,11.63,2,46.53,0.01,9,0.5,2.58,4,5,3,3,3,0
1,0,0,1,1,1,0,5.33,1.5,12,0,4,0.67,0.67,1,3,1,3,0,0
1,0,0,1,1,1,0,5.33,1.5,12,0,4,0.67,0.67,1,3,1,3,0,0
1,0,0,1,1,1,0,5.33,1.5,12,0,4,0.67,0.67,1,3,1,3,0,0
1,0,0,1,1,1,2,0,0,0,0,3,0,0,0,3,0,3,2,0
1,0,0,1,1,1,2,5.33,1.5,12,0,4,0.67,0.67,1,3,1,3,2,0
1,0,0,1,1,1,2,0,0,0,0,3,0,0,0,3,0,3,2,0
1,0,0,1,1,1,2,0,0,0,0,3,0,0,0,3,0,3,2,0
1,0,0,1,1,1,2,0,0,0,0,3,0,0,0,3,0,3,2,0
1,0,0,1,1,1,2,0,0,0,0,3,0,0,0,3,0,3,2,0
1,0,0,1,1,1,2,0,0,0,0,3,0,0,0,3,0,3,2,0
1,0,0,1,1,1,2,0,0,0,0,3,0,0,0,3,0,3,2,0
1,0,0,1,1,1,2,0,0,0,0,3,0,0,0,3,0,3,2,0
1,0,0,1,1,1,2,0,0,0,0,3,0,0,0,3,0,3,2,0
1,0,0,1,1,1,2,0,0,0,0,3,0,0,0,3,0,3,2,0
1,0,0,1,1,1,2,0,0,0,0,3,0,0,0,3,0,3,2,0
1,0,0,1,1,1,2,0,0,0,0,3,0,0,0,3,0,3,2,0
1,0,0,1,1,1,0,7.74,1.5,17.41,0,5,0.67,0.97,2,3,2,3,0,0
1,0,0,1,1,1,0,7.74,1.5,17.41,0,5,0.67,0.97,2,3,2,3,0,0
1,0,0,1,1,1,0,0,0,0,0,3,0,0,0,3,0,3,0,0
1,0,0,1,1,1,0,5.33,1.5,12,0,4,0.67,0.67,1,3,1,3,0,0
1,0,0,1,1,1,2,0,0,0,0,3,0,0,0,3,0,3,2,0
1,0,0,1,1,1,2,0,0,0,0,3,0,0,0,3,0,3,2,0
1,0,0,1,1,1,2,0,0,0,0,3,0,0,0,3,0,3,2,0
1,0,0,1,1,1,2,0,0,0,0,3,0,0,0,3,0,3,2,0
1,0,0,1,1,1,2,0,0,0,0,3,0,0,0,3,0,3,2,0
1,0,0,1,1,1,2,0,0,0,0,3,0,0,0,3,0,3,2,0
1,0,0,1,1,1,2,0,0,0,0,3,0,0,0,3,0,3,2,0
1,0,0,1,1,1,2,0,0,0,0,3,0,0,0,3,0,3,2,0
1,0,0,1,1,1,2,0,0,0,0,3,0,0,0,3,0,3,2,0
1,0,0,1,1,1,2,0,0,0,0,3,0,0,0,3,0,3,2,0
1,0,0,1,1,1,2,0,0,0,0,3,0,0,0,3,0,3,2,0
1,0,0,1,1,1,0,0,0,0,0,1,0,0,0,1,0,1,0,0
73,0,94,37,16,21,388,57.96,215.76,2698055.56,4.17,2163,0,149891.99,887,1276,37,18,388,0
1,0,0,1,1,1,5,2.67,1.5,6,0,4,0.67,0.33,3,1,1,1,5,0
5,0,4,4,4,1,17,26.15,9.17,2197.7,0.08,53,0.11,122.09,20,33,12,11,17,0
3,0,3,2,1,1,12,25.38,3.75,356.94,0.03,25,0.27,19.83,10,15,8,6,12,0
13,0,0,7,7,1,29,43.49,12.75,7069.6,0.18,113,0.08,392.76,51,62,20,10,29,0
1,0,8,1,1,1,10,11.21,18,3632.22,0.07,53,0.06,201.79,20,33,5,9,10,0
13,1,98,7,5,4,348,303.64,36.88,412991.15,3.73,1580,0.03,22943.95,595,985,121,15,349,0
66,0,65,65,65,1,485,48.35,256.95,3192281.43,4.14,1671,0,177348.99,704,967,100,73,485,0
5,0,5,3,1,1,7,13.32,13.71,2505.06,0.06,43,0.07,139.17,16,27,7,12,7,0
5,0,5,3,1,1,7,13.32,13.71,2505.06,0.06,43,0.07,139.17,16,27,7,12,7,0
9,2,1,8,1,1,27,34.09,9.88,3329.22,0.11,68,0.1,184.96,24,44,17,14,29,0
3,0,1,2,1,1,2,12.09,6.3,479.73,0.03,20,0.16,26.65,7,13,5,9,2,0
1,0,0,1,1,1,2,5.33,1.5,12,0,4,0.67,0.67,1,3,1,3,2,0
1,0,0,1,1,1,2,5.33,1.5,12,0,4,0.67,0.67,1,3,1,3,2,0
1,0,0,1,1,1,2,5.33,1.5,12,0,4,0.67,0.67,1,3,1,3,2,0
1,0,0,1,1,1,2,5.33,1.5,12,0,4,0.67,0.67,1,3,1,3,2,0
1,0,0,1,1,1,2,5.33,1.5,12,0,4,0.67,0.67,1,3,1,3,2,0
1,0,0,1,1,1,2,5.33,1.5,12,0,4,0.67,0.67,1,3,1,3,2,0
1,0,0,1,1,1,2,5.33,1.5,12,0,4,0.67,0.67,1,3,1,3,2,0
1,0,0,1,1,1,2,5.33,1.5,12,0,4,0.67,0.67,1,3,1,3,2,0
1,0,0,1,1,1,2,5.33,1.5,12,0,4,0.67,0.67,1,3,1,3,2,0
1,0,0,1,1,1,2,0,0,0,0,4,0,0,0,4,0,4,2,0
1,0,0,1,1,1,1,0,0,0,0,1,0,0,0,1,0,1,1,0
1,0,0,1,1,1,2,0,0,0,0,5,0,0,0,5,0,5,2,0
11,1,4,6,1,1,21,13.86,22.5,7014.99,0.1,68,0.04,389.72,27,41,9,15,22,0
1,0,0,1,1,1,2,20.97,3,188.72,0.02,17,0.33,10.48,7,10,7,6,2,0
1,0,0,1,1,1,2,20.97,3,188.72,0.02,17,0.33,10.48,7,10,7,6,2,0
1,0,0,1,1,1,2,27.35,3,246.13,0.03,21,0.33,13.67,9,12,9,6,2,0
1,0,0,1,1,1,3,30.67,3,276,0.03,23,0.33,15.33,10,13,10,6,3,0
1,0,0,1,1,1,3,30.67,3,276,0.03,23,0.33,15.33,10,13,10,6,3,0
1,0,0,1,1,1,3,30.67,3,276,0.03,23,0.33,15.33,10,13,10,6,3,0
1,0,0,1,1,1,2,27.35,3,246.13,0.03,21,0.33,13.67,9,12,9,6,2,0
1,0,0,1,1,1,3,27.35,3,246.13,0.03,21,0.33,13.67,9,12,9,6,3,0
1,0,0,1,1,1,2,20.97,3,188.72,0.02,17,0.33,10.48,7,10,7,6,2,0
1,0,0,1,1,1,2,20.97,3,188.72,0.02,17,0.33,10.48,7,10,7,6,2,0
1,0,0,1,1,1,2,20.97,3,188.72,0.02,17,0.33,10.48,7,10,7,6,2,0
1,0,0,1,1,1,2,17.92,3,161.32,0.02,15,0.33,8.96,6,9,6,6,2,0
1,0,0,1,1,1,2,17.92,3,161.32,0.02,15,0.33,8.96,6,9,6,6,2,0
1,0,0,1,1,1,2,14.99,3,134.92,0.01,13,0.33,7.5,5,8,5,6,2,0
1,0,0,1,1,1,2,14.99,3,134.92,0.01,13,0.33,7.5,5,8,5,6,2,0
1,0,0,1,1,1,2,14.99,3,134.92,0.01,13,0.33,7.5,5,8,5,6,2,0
1,0,0,1,1,1,2,14.99,3,134.92,0.01,13,0.33,7.5,5,8,5,6,2,0
1,0,0,1,1,1,2,14.99,3,134.92,0.01,13,0.33,7.5,5,8,5,6,2,0
1,0,0,1,1,1,2,17.92,3,161.32,0.02,15,0.33,8.96,6,9,6,6,2,0
1,0,0,1,1,1,2,17.92,3,161.32,0.02,15,0.33,8.96,6,9,6,6,2,0
1,0,0,1,1,1,2,20.97,3,188.72,0.02,17,0.33,10.48,7,10,7,6,2,0
1,0,0,1,1,1,2,20.97,3,188.72,0.02,17,0.33,10.48,7,10,7,6,2,0
1,0,0,1,1,1,1,0,0,0,0,0,0,0,0,0,0,0,1,0
1,0,0,1,1,1,1,0,0,0,0,1,0,0,0,1,0,1,1,0
1,0,0,1,1,1,2,5.33,1.5,12,0,4,0.67,0.67,1,3,1,3,2,0
1,0,0,1,1,1,2,5.33,1.5,12,0,4,0.67,0.67,1,3,1,3,2,0
1,9,0,1,1,1,2,0,0,0,0,9,0,0,9,0,1,0,11,0
1,0,0,1,1,1,1,0,0,0,0,0,0,0,0,0,0,0,1,0
1,0,0,1,1,1,1,0,0,0,0,0,0,0,0,0,0,0,1,0
1,0,0,1,1,1,1,0,0,0,0,1,0,0,0,1,0,1,1,0
1,0,0,1,1,1,4,18.49,2.4,106.51,0.01,14,0.42,5.92,6,8,5,4,4,0
1,0,0,1,1,1,2,5.33,1.5,12,0,4,0.67,0.67,1,3,1,3,2,0
1,0,0,1,1,1,5,8.45,0.75,4.75,0,4,1.33,0.26,3,1,2,1,5,0
1,0,0,1,1,1,1,0,0,0,0,0,0,0,0,0,0,0,1,0
1,0,0,1,1,1,1,0,0,0,0,1,0,0,0,1,0,1,1,0
1,0,0,1,1,1,3,10.8,2.5,67.5,0.01,9,0.4,3.75,3,6,3,5,3,0
1,0,0,1,1,1,2,5.33,1.5,12,0,4,0.67,0.67,1,3,1,3,2,0
1,0,0,1,1,1,2,6.2,2.5,38.77,0.01,6,0.4,2.15,1,5,1,5,2,0
1,0,0,1,1,1,4,9.51,0.5,2.38,0,3,2,0.13,2,1,2,1,4,0
1,0,0,1,1,1,1,0,0,0,0,1,0,0,0,1,0,1,1,0
1,0,0,1,1,1,2,5.33,1.5,12,0,4,0.67,0.67,1,3,1,3,2,0
1,0,0,1,1,1,2,5.33,1.5,12,0,4,0.67,0.67,1,3,1,3,2,0
1,0,0,1,1,1,2,0,0,0,0,4,0,0,0,4,0,4,2,0
1,0,0,1,1,1,1,0,0,0,0,1,0,0,0,1,0,1,1,0
1,0,0,1,1,1,2,0,0,0,0,5,0,0,0,5,0,5,2,0
1,0,0,1,1,1,1,0,0,0,0,1,0,0,0,1,0,1,1,0
1,0,0,1,1,1,2,5.33,1.5,12,0,4,0.67,0.67,1,3,1,3,2,0
1,0,0,1,1,1,2,5.33,1.5,12,0,4,0.67,0.67,1,3,1,3,2,0
1,0,0,1,1,1,1,0,0,0,0,1,0,0,0,1,0,1,1,0
1,0,0,1,1,1,1,0,0,0,0,1,0,0,0,1,0,1,1,0
1,0,0,1,1,1,1,0,0,0,0,1,0,0,0,1,0,1,1,0
1,0,0,1,1,1,1,0,0,0,0,1,0,0,0,1,0,1,1,0
1,0,0,1,1,1,1,0,0,0,0,1,0,0,0,1,0,1,1,0
1,0,0,1,1,1,1,0,0,0,0,1,0,0,0,1,0,1,1,0
1,0,0,1,1,1,1,0,0,0,0,1,0,0,0,1,0,1,1,0
1,0,0,1,1,1,0,0,0,0,0,1,0,0,0,1,0,1,0,0
1,0,0,1,1,1,2,0,0,0,0,3,0,0,0,3,0,3,2,0
1,0,0,1,1,1,2,0,0,0,0,3,0,0,0,3,0,3,2,0
1,0,0,1,1,1,2,0,0,0,0,3,0,0,0,3,0,3,2,0
1,0,0,1,1,1,2,0,0,0,0,3,0,0,0,3,0,3,2,0
1,0,0,1,1,1,2,0,0,0,0,3,0,0,0,3,0,3,2,0
1,0,0,1,1,1,2,0,0,0,0,3,0,0,0,3,0,3,2,0
1,0,0,1,1,1,2,0,0,0,0,3,0,0,0,3,0,3,2,0
1,0,0,1,1,1,2,0,0,0,0,3,0,0,0,3,0,3,2,0
1,0,0,1,1,1,2,0,0,0,0,3,0,0,0,3,0,3,2,0
1,0,0,1,1,1,2,0,0,0,0,3,0,0,0,3,0,3,2,0
1,0,0,1,1,1,2,0,0,0,0,3,0,0,0,3,0,3,2,0
1,0,0,1,1,1,3,11.63,2,46.53,0.01,9,0.5,2.58,4,5,3,3,3,0
1,0,0,1,1,1,0,5.33,1.5,12,0,4,0.67,0.67,1,3,1,3,0,0
1,0,0,1,1,1,0,5.33,1.5,12,0,4,0.67,0.67,1,3,1,3,0,0
1,0,0,1,1,1,0,5.33,1.5,12,0,4,0.67,0.67,1,3,1,3,0,0
1,0,0,1,1,1,2,0,0,0,0,3,0,0,0,3,0,3,2,0
1,0,0,1,1,1,2,5.33,1.5,12,0,4,0.67,0.67,1,3,1,3,2,0
1,0,0,1,1,1,2,0,0,0,0,3,0,0,0,3,0,3,2,0
1,0,0,1,1,1,2,0,0,0,0,3,0,0,0,3,0,3,2,0
1,0,0,1,1,1,2,0,0,0,0,3,0,0,0,3,0,3,2,0
1,0,0,1,1,1,2,0,0,0,0,3,0,0,0,3,0,3,2,0
1,0,0,1,1,1,2,0,0,0,0,3,0,0,0,3,0,3,2,0
1,0,0,1,1,1,2,0,0,0,0,3,0,0,0,3,0,3,2,0
1,0,0,1,1,1,2,0,0,0,0,3,0,0,0,3,0,3,2,0
1,0,0,1,1,1,2,0,0,0,0,3,0,0,0,3,0,3,2,0
1,0,0,1,1,1,2,0,0,0,0,3,0,0,0,3,0,3,2,0
1,0,0,1,1,1,2,0,0,0,0,3,0,0,0,3,0,3,2,0
1,0,0,1,1,1,2,0,0,0,0,3,0,0,0,3,0,3,2,0
1,0,0,1,1,1,0,7.74,1.5,17.41,0,5,0.67,0.97,2,3,2,3,0,0
1,0,0,1,1,1,0,7.74,1.5,17.41,0,5,0.67,0.97,2,3,2,3,0,0
1,0,0,1,1,1,0,0,0,0,0,3,0,0,0,3,0,3,0,0
1,0,0,1,1,1,0,5.33,1.5,12,0,4,0.67,0.67,1,3,1,3,0,0
1,0,0,1,1,1,2,0,0,0,0,3,0,0,0,3,0,3,2,0
1,0,0,1,1,1,2,0,0,0,0,3,0,0,0,3,0,3,2,0
1,0,0,1,1,1,2,0,0,0,0,3,0,0,0,3,0,3,2,0
1,0,0,1,1,1,2,0,0,0,0,3,0,0,0,3,0,3,2,0
1,0,0,1,1,1,2,0,0,0,0,3,0,0,0,3,0,3,2,0
1,0,0,1,1,1,2,0,0,0,0,3,0,0,0,3,0,3,2,0
1,0,0,1,1,1,2,0,0,0,0,3,0,0,0,3,0,3,2,0
1,0,0,1,1,1,2,0,0,0,0,3,0,0,0,3,0,3,2,0
1,0,0,1,1,1,2,0,0,0,0,3,0,0,0,3,0,3,2,0
1,0,0,1,1,1,2,0,0,0,0,3,0,0,0,3,0,3,2,0
1,0,0,1,1,1,2,0,0,0,0,3,0,0,0,3,0,3,2,0
1,0,0,1,1,1,0,0,0,0,0,1,0,0,0,1,0,1,0,0
55,23,100,28,8,13,219,162.58,44.85,327028.86,2.43,1178,0.02,18168.27,414,764,60,13,242,1
1,0,0,1,1,1,11,2.22,4.5,45,0,10,0.22,2.5,9,1,1,1,11,1
1,0,7,1,1,1,28,14.07,29.75,12453.09,0.14,121,0.03,691.84,34,87,4,7,28,0
49,8,23,25,19,7,93,88.41,27.3,65888.22,0.8,412,0.04,3660.46,189,223,45,13,101,1
1,2,4,1,1,1,30,87.18,11.51,11559.14,0.33,185,0.09,642.17,87,98,34,9,32,0
5,0,6,3,1,3,10,16.2,6.67,720,0.04,27,0.15,40,8,19,6,10,10,1
37,5,274,19,11,10,971,591.96,38.58,881072.39,7.61,2904,0.03,48948.47,1207,1697,219,14,976,1
24,7,2,20,19,1,61,40.79,42.5,73684.33,0.58,281,0.02,4093.57,119,162,42,30,68,1
11,0,5,6,3,5,17,30.74,10.59,3446.31,0.11,67,0.09,191.46,30,37,17,12,17,0
5,0,5,3,1,1,7,13.32,13.71,2505.06,0.06,43,0.07,139.17,16,27,7,12,7,0
5,0,5,3,1,1,7,13.32,13.71,2505.06,0.06,43,0.07,139.17,16,27,7,12,7,0
9,2,1,8,1,1,27,34.09,9.88,3329.22,0.11,68,0.1,184.96,24,44,17,14,29,0
1,0,0,1,1,1,0,0,0,0,0,1,0,0,0,1,0,1,0,0
5,0,2,3,1,1,6,17.17,5,429.18,0.03,21,0.2,23.84,7,14,7,10,6,0
1,0,0,1,1,1,0,0,0,0,0,1,0,0,0,1,0,1,0,0
1,0,0,1,1,1,0,5.33,1.5,12,0,4,0.67,0.67,1,3,1,3,0,0
3,0,1,2,1,1,2,12.09,6.3,479.73,0.03,20,0.16,26.65,7,13,5,9,2,0
1,0,0,1,1,1,2,5.33,1.5,12,0,4,0.67,0.67,1,3,1,3,2,0
1,0,0,1,1,1,2,5.33,1.5,12,0,4,0.67,0.67,1,3,1,3,2,0
1,0,0,1,1,1,2,5.33,1.5,12,0,4,0.67,0.67,1,3,1,3,2,0
1,0,0,1,1,1,2,5.33,1.5,12,0,4,0.67,0.67,1,3,1,3,2,0
1,0,0,1,1,1,2,5.33,1.5,12,0,4,0.67,0.67,1,3,1,3,2,0
1,0,0,1,1,1,2,5.33,1.5,12,0,4,0.67,0.67,1,3,1,3,2,0
1,0,0,1,1,1,2,5.33,1.5,12,0,4,0.67,0.67,1,3,1,3,2,0
1,0,0,1,1,1,2,5.33,1.5,12,0,4,0.67,0.67,1,3,1,3,2,0
1,0,0,1,1,1,2,5.33,1.5,12,0,4,0.67,0.67,1,3,1,3,2,0
1,0,0,1,1,1,2,0,0,0,0,4,0,0,0,4,0,4,2,0
1,0,0,1,1,1,1,0,0,0,0,1,0,0,0,1,0,1,1,0
1,0,0,1,1,1,2,0,0,0,0,5,0,0,0,5,0,5,2,0
11,1,4,6,1,1,21,13.86,22.5,7014.99,0.1,68,0.04,389.72,27,41,9,15,22,0
1,0,0,1,1,1,2,20.97,3,188.72,0.02,17,0.33,10.48,7,10,7,6,2,0
1,0,0,1,1,1,2,20.97,3,188.72,0.02,17,0.33,10.48,7,10,7,6,2,0
1,0,0,1,1,1,2,27.35,3,246.13,0.03,21,0.33,13.67,9,12,9,6,2,0
1,0,0,1,1,1,3,30.67,3,276,0.03,23,0.33,15.33,10,13,10,6,3,0
1,0,0,1,1,1,3,30.67,3,276,0.03,23,0.33,15.33,10,13,10,6,3,0
1,0,0,1,1,1,3,30.67,3,276,0.03,23,0.33,15.33,10,13,10,6,3,0
1,0,0,1,1,1,2,27.35,3,246.13,0.03,21,0.33,13.67,9,12,9,6,2,0
1,0,0,1,1,1,3,27.35,3,246.13,0.03,21,0.33,13.67,9,12,9,6,3,0
1,0,0,1,1,1,2,20.97,3,188.72,0.02,17,0.33,10.48,7,10,7,6,2,0
1,0,0,1,1,1,2,20.97,3,188.72,0.02,17,0.33,10.48,7,10,7,6,2,0
1,0,0,1,1,1,2,20.97,3,188.72,0.02,17,0.33,10.48,7,10,7,6,2,0
1,0,0,1,1,1,2,17.92,3,161.32,0.02,15,0.33,8.96,6,9,6,6,2,0
1,0,0,1,1,1,2,17.92,3,161.32,0.02,15,0.33,8.96,6,9,6,6,2,0
1,0,0,1,1,1,2,14.99,3,134.92,0.01,13,0.33,7.5,5,8,5,6,2,0
1,0,0,1,1,1,2,14.99,3,134.92,0.01,13,0.33,7.5,5,8,5,6,2,0
1,0,0,1,1,1,2,14.99,3,134.92,0.01,13,0.33,7.5,5,8,5,6,2,0
1,0,0,1,1,1,2,14.99,3,134.92,0.01,13,0.33,7.5,5,8,5,6,2,0
1,0,0,1,1,1,2,14.99,3,134.92,0.01,13,0.33,7.5,5,8,5,6,2,0
1,0,0,1,1,1,2,17.92,3,161.32,0.02,15,0.33,8.96,6,9,6,6,2,0
1,0,0,1,1,1,2,17.92,3,161.32,0.02,15,0.33,8.96,6,9,6,6,2,0
1,0,0,1,1,1,2,20.97,3,188.72,0.02,17,0.33,10.48,7,10,7,6,2,0
1,0,0,1,1,1,2,20.97,3,188.72,0.02,17,0.33,10.48,7,10,7,6,2,0
1,0,0,1,1,1,1,0,0,0,0,0,0,0,0,0,0,0,1,0
1,0,0,1,1,1,1,0,0,0,0,1,0,0,0,1,0,1,1,0
1,0,0,1,1,1,2,5.33,1.5,12,0,4,0.67,0.67,1,3,1,3,2,0
1,0,0,1,1,1,2,5.33,1.5,12,0,4,0.67,0.67,1,3,1,3,2,0
1,9,0,1,1,1,2,0,0,0,0,9,0,0,9,0,1,0,11,0
1,0,0,1,1,1,1,0,0,0,0,0,0,0,0,0,0,0,1,0
1,0,0,1,1,1,1,0,0,0,0,0,0,0,0,0,0,0,1,0
1,0,0,1,1,1,1,0,0,0,0,1,0,0,0,1,0,1,1,0
1,0,0,1,1,1,4,18.49,2.4,106.51,0.01,14,0.42,5.92,6,8,5,4,4,0
1,0,0,1,1,1,2,5.33,1.5,12,0,4,0.67,0.67,1,3,1,3,2,0
1,0,0,1,1,1,5,8.45,0.75,4.75,0,4,1.33,0.26,3,1,2,1,5,0
1,0,0,1,1,1,1,0,0,0,0,0,0,0,0,0,0,0,1,0
1,0,0,1,1,1,1,0,0,0,0,1,0,0,0,1,0,1,1,0
1,0,0,1,1,1,3,10.8,2.5,67.5,0.01,9,0.4,3.75,3,6,3,5,3,0
1,0,0,1,1,1,2,5.33,1.5,12,0,4,0.67,0.67,1,3,1,3,2,0
1,0,0,1,1,1,2,6.2,2.5,38.77,0.01,6,0.4,2.15,1,5,1,5,2,0
1,0,0,1,1,1,4,9.51,0.5,2.38,0,3,2,0.13,2,1,2,1,4,0
1,0,0,1,1,1,1,0,0,0,0,1,0,0,0,1,0,1,1,0
1,0,0,1,1,1,2,5.33,1.5,12,0,4,0.67,0.67,1,3,1,3,2,0
1,0,0,1,1,1,2,5.33,1.5,12,0,4,0.67,0.67,1,3,1,3,2,0
1,0,0,1,1,1,2,0,0,0,0,4,0,0,0,4,0,4,2,0
1,0,0,1,1,1,1,0,0,0,0,1,0,0,0,1,0,1,1,0
1,0,0,1,1,1,2,0,0,0,0,5,0,0,0,5,0,5,2,0
1,0,0,1,1,1,1,0,0,0,0,1,0,0,0,1,0,1,1,0
1,0,0,1,1,1,2,5.33,1.5,12,0,4,0.67,0.67,1,3,1,3,2,0
1,0,0,1,1,1,2,5.33,1.5,12,0,4,0.67,0.67,1,3,1,3,2,0
1,0,0,1,1,1,1,0,0,0,0,1,0,0,0,1,0,1,1,0
1,0,0,1,1,1,1,0,0,0,0,1,0,0,0,1,0,1,1,0
1,0,0,1,1,1,1,0,0,0,0,1,0,0,0,1,0,1,1,0
1,0,0,1,1,1,1,0,0,0,0,1,0,0,0,1,0,1,1,0
1,0,0,1,1,1,1,0,0,0,0,1,0,0,0,1,0,1,1,0
1,0,0,1,1,1,1,0,0,0,0,1,0,0,0,1,0,1,1,0
1,0,0,1,1,1,1,0,0,0,0,1,0,0,0,1,0,1,1,0
1,0,0,1,1,1,0,0,0,0,0,1,0,0,0,1,0,1,0,0
1,0,0,1,1,1,2,0,0,0,0,3,0,0,0,3,0,3,2,0
1,0,0,1,1,1,2,0,0,0,0,3,0,0,0,3,0,3,2,0
1,0,0,1,1,1,2,0,0,0,0,3,0,0,0,3,0,3,2,0
1,0,0,1,1,1,2,0,0,0,0,3,0,0,0,3,0,3,2,0
1,0,0,1,1,1,2,0,0,0,0,3,0,0,0,3,0,3,2,0
1,0,0,1,1,1,2,0,0,0,0,3,0,0,0,3,0,3,2,0
1,0,0,1,1,1,2,0,0,0,0,3,0,0,0,3,0,3,2,0
1,0,0,1,1,1,2,0,0,0,0,3,0,0,0,3,0,3,2,0
1,0,0,1,1,1,2,0,0,0,0,3,0,0,0,3,0,3,2,0
1,0,0,1,1,1,2,0,0,0,0,3,0,0,0,3,0,3,2,0
1,0,0,1,1,1,2,0,0,0,0,3,0,0,0,3,0,3,2,0
1,0,0,1,1,1,3,11.63,2,46.53,0.01,9,0.5,2.58,4,5,3,3,3,0
1,0,0,1,1,1,0,5.33,1.5,12,0,4,0.67,0.67,1,3,1,3,0,0
1,0,0,1,1,1,0,5.33,1.5,12,0,4,0.67,0.67,1,3,1,3,0,0
1,0,0,1,1,1,0,5.33,1.5,12,0,4,0.67,0.67,1,3,1,3,0,0
1,0,0,1,1,1,2,0,0,0,0,3,0,0,0,3,0,3,2,0
1,0,0,1,1,1,2,5.33,1.5,12,0,4,0.67,0.67,1,3,1,3,2,0
1,0,0,1,1,1,2,0,0,0,0,3,0,0,0,3,0,3,2,0
1,0,0,1,1,1,2,0,0,0,0,3,0,0,0,3,0,3,2,0
1,0,0,1,1,1,2,0,0,0,0,3,0,0,0,3,0,3,2,0
1,0,0,1,1,1,2,0,0,0,0,3,0,0,0,3,0,3,2,0
1,0,0,1,1,1,2,0,0,0,0,3,0,0,0,3,0,3,2,0
1,0,0,1,1,1,2,0,0,0,0,3,0,0,0,3,0,3,2,0
1,0,0,1,1,1,2,0,0,0,0,3,0,0,0,3,0,3,2,0
1,0,0,1,1,1,2,0,0,0,0,3,0,0,0,3,0,3,2,0
1,0,0,1,1,1,2,0,0,0,0,3,0,0,0,3,0,3,2,0
1,0,0,1,1,1,2,0,0,0,0,3,0,0,0,3,0,3,2,0
1,0,0,1,1,1,2,0,0,0,0,3,0,0,0,3,0,3,2,0
1,0,0,1,1,1,0,7.74,1.5,17.41,0,5,0.67,0.97,2,3,2,3,0,0
1,0,0,1,1,1,0,7.74,1.5,17.41,0,5,0.67,0.97,2,3,2,3,0,0
1,0,0,1,1,1,0,0,0,0,0,3,0,0,0,3,0,3,0,0
1,0,0,1,1,1,0,5.33,1.5,12,0,4,0.67,0.67,1,3,1,3,0,0
1,0,0,1,1,1,2,0,0,0,0,3,0,0,0,3,0,3,2,0
1,0,0,1,1,1,2,0,0,0,0,3,0,0,0,3,0,3,2,0
1,0,0,1,1,1,2,0,0,0,0,3,0,0,0,3,0,3,2,0
1,0,0,1,1,1,2,0,0,0,0,3,0,0,0,3,0,3,2,0
1,0,0,1,1,1,2,0,0,0,0,3,0,0,0,3,0,3,2,0
1,0,0,1,1,1,2,0,0,0,0,3,0,0,0,3,0,3,2,0
1,0,0,1,1,1,2,0,0,0,0,3,0,0,0,3,0,3,2,0
1,0,0,1,1,1,2,0,0,0,0,3,0,0,0,3,0,3,2,0
1,0,0,1,1,1,2,0,0,0,0,3,0,0,0,3,0,3,2,0
1,0,0,1,1,1,2,0,0,0,0,3,0,0,0,3,0,3,2,0
1,0,0,1,1,1,2,0,0,0,0,3,0,0,0,3,0,3,2,0
1,0,0,1,1,1,1,0,0,0,0,1,0,0,0,1,0,1,1,0
119,17,108,62,37,30,447,115.56,124.26,1784483.62,4.79,2072,0.01,99137.98,797,1275,93,29,464,1
21,4,14,11,1,1,58,19.48,39.6,30550.67,0.26,173,0.03,1697.26,66,107,10,12,62,1
1,0,0,1,1,1,9,7.4,1.5,16.64,0,7,0.67,0.92,6,1,2,1,9,0
19,3,9,10,8,6,37,40.14,17.65,12506.31,0.24,136,0.06,694.8,58,78,23,14,40,0
11,1,6,6,6,1,26,35.77,12.22,5343.78,0.15,90,0.08,296.88,40,50,18,11,27,0
1,0,1,1,1,1,13,47.31,9.14,3954.88,0.14,97,0.11,219.72,32,65,14,8,13,1
21,1,222,11,7,6,794,607.16,62.62,2380904.39,12.67,4780,0.02,132272.48,1816,2964,232,16,795,0
70,3,77,57,53,1,360,57.65,113.07,737097.31,2.17,903,0.01,40949.85,365,538,92,57,363,0
5,0,5,3,1,1,7,13.32,13.71,2505.06,0.06,43,0.07,139.17,16,27,7,12,7,0
5,0,5,3,1,1,7,13.32,13.71,2505.06,0.06,43,0.07,139.17,16,27,7,12,7,0
9,2,1,8,1,1,27,34.09,9.88,3329.22,0.11,68,0.1,184.96,24,44,17,14,29,0
3,0,1,2,1,1,2,12.09,6.3,479.73,0.03,20,0.16,26.65,7,13,5,9,2,0
1,0,0,1,1,1,2,5.33,1.5,12,0,4,0.67,0.67,1,3,1,3,2,0
1,0,0,1,1,1,2,5.33,1.5,12,0,4,0.67,0.67,1,3,1,3,2,0
1,0,0,1,1,1,2,5.33,1.5,12,0,4,0.67,0.67,1,3,1,3,2,0
1,0,0,1,1,1,2,5.33,1.5,12,0,4,0.67,0.67,1,3,1,3,2,0
1,0,0,1,1,1,2,5.33,1.5,12,0,4,0.67,0.67,1,3,1,3,2,0
1,0,0,1,1,1,2,5.33,1.5,12,0,4,0.67,0.67,1,3,1,3,2,0
1,0,0,1,1,1,2,5.33,1.5,12,0,4,0.67,0.67,1,3,1,3,2,0
1,0,0,1,1,1,2,5.33,1.5,12,0,4,0.67,0.67,1,3,1,3,2,0
1,0,0,1,1,1,2,5.33,1.5,12,0,4,0.67,0.67,1,3,1,3,2,0
1,0,0,1,1,1,2,0,0,0,0,4,0,0,0,4,0,4,2,0
1,0,0,1,1,1,1,0,0,0,0,1,0,0,0,1,0,1,1,0
1,0,0,1,1,1,2,0,0,0,0,5,0,0,0,5,0,5,2,0
11,1,4,6,1,1,21,13.86,22.5,7014.99,0.1,68,0.04,389.72,27,41,9,15,22,0
1,0,0,1,1,1,2,20.97,3,188.72,0.02,17,0.33,10.48,7,10,7,6,2,0
1,0,0,1,1,1,2,20.97,3,188.72,0.02,17,0.33,10.48,7,10,7,6,2,0
1,0,0,1,1,1,2,27.35,3,246.13,0.03,21,0.33,13.67,9,12,9,6,2,0
1,0,0,1,1,1,3,30.67,3,276,0.03,23,0.33,15.33,10,13,10,6,3,0
1,0,0,1,1,1,3,30.67,3,276,0.03,23,0.33,15.33,10,13,10,6,3,0
1,0,0,1,1,1,3,30.67,3,276,0.03,23,0.33,15.33,10,13,10,6,3,0
1,0,0,1,1,1,2,27.35,3,246.13,0.03,21,0.33,13.67,9,12,9,6,2,0
1,0,0,1,1,1,3,27.35,3,246.13,0.03,21,0.33,13.67,9,12,9,6,3,0
1,0,0,1,1,1,2,20.97,3,188.72,0.02,17,0.33,10.48,7,10,7,6,2,0
1,0,0,1,1,1,2,20.97,3,188.72,0.02,17,0.33,10.48,7,10,7,6,2,0
1,0,0,1,1,1,2,20.97,3,188.72,0.02,17,0.33,10.48,7,10,7,6,2,0
1,0,0,1,1,1,2,17.92,3,161.32,0.02,15,0.33,8.96,6,9,6,6,2,0
1,0,0,1,1,1,2,17.92,3,161.32,0.02,15,0.33,8.96,6,9,6,6,2,0
1,0,0,1,1,1,2,14.99,3,134.92,0.01,13,0.33,7.5,5,8,5,6,2,0
1,0,0,1,1,1,2,14.99,3,134.92,0.01,13,0.33,7.5,5,8,5,6,2,0
1,0,0,1,1,1,2,14.99,3,134.92,0.01,13,0.33,7.5,5,8,5,6,2,0
1,0,0,1,1,1,2,14.99,3,134.92,0.01,13,0.33,7.5,5,8,5,6,2,0
1,0,0,1,1,1,2,14.99,3,134.92,0.01,13,0.33,7.5,5,8,5,6,2,0
1,0,0,1,1,1,2,17.92,3,161.32,0.02,15,0.33,8.96,6,9,6,6,2,0
1,0,0,1,1,1,2,17.92,3,161.32,0.02,15,0.33,8.96,6,9,6,6,2,0
1,0,0,1,1,1,2,20.97,3,188.72,0.02,17,0.33,10.48,7,10,7,6,2,0
1,0,0,1,1,1,2,20.97,3,188.72,0.02,17,0.33,10.48,7,10,7,6,2,0
1,0,0,1,1,1,1,0,0,0,0,0,0,0,0,0,0,0,1,0
1,0,0,1,1,1,1,0,0,0,0,1,0,0,0,1,0,1,1,0
1,0,0,1,1,1,2,5.33,1.5,12,0,4,0.67,0.67,1,3,1,3,2,0
1,0,0,1,1,1,2,5.33,1.5,12,0,4,0.67,0.67,1,3,1,3,2,0
1,9,0,1,1,1,2,0,0,0,0,9,0,0,9,0,1,0,11,0
1,0,0,1,1,1,1,0,0,0,0,0,0,0,0,0,0,0,1,0
1,0,0,1,1,1,1,0,0,0,0,0,0,0,0,0,0,0,1,0
1,0,0,1,1,1,1,0,0,0,0,1,0,0,0,1,0,1,1,0
1,0,0,1,1,1,4,18.49,2.4,106.51,0.01,14,0.42,5.92,6,8,5,4,4,0
1,0,0,1,1,1,2,5.33,1.5,12,0,4,0.67,0.67,1,3,1,3,2,0
1,0,0,1,1,1,5,8.45,0.75,4.75,0,4,1.33,0.26,3,1,2,1,5,0
1,0,0,1,1,1,1,0,0,0,0,0,0,0,0,0,0,0,1,0
1,0,0,1,1,1,1,0,0,0,0,1,0,0,0,1,0,1,1,0
1,0,0,1,1,1,3,10.8,2.5,67.5,0.01,9,0.4,3.75,3,6,3,5,3,0
1,0,0,1,1,1,2,5.33,1.5,12,0,4,0.67,0.67,1,3,1,3,2,0
1,0,0,1,1,1,2,6.2,2.5,38.77,0.01,6,0.4,2.15,1,5,1,5,2,0
1,0,0,1,1,1,4,9.51,0.5,2.38,0,3,2,0.13,2,1,2,1,4,0
1,0,0,1,1,1,1,0,0,0,0,1,0,0,0,1,0,1,1,0
1,0,0,1,1,1,2,5.33,1.5,12,0,4,0.67,0.67,1,3,1,3,2,0
1,0,0,1,1,1,2,5.33,1.5,12,0,4,0.67,0.67,1,3,1,3,2,0
1,0,0,1,1,1,2,0,0,0,0,4,0,0,0,4,0,4,2,0
1,0,0,1,1,1,1,0,0,0,0,1,0,0,0,1,0,1,1,0
1,0,0,1,1,1,2,0,0,0,0,5,0,0,0,5,0,5,2,0
1,0,0,1,1,1,1,0,0,0,0,1,0,0,0,1,0,1,1,0
1,0,0,1,1,1,2,5.33,1.5,12,0,4,0.67,0.67,1,3,1,3,2,0
1,0,0,1,1,1,2,5.33,1.5,12,0,4,0.67,0.67,1,3,1,3,2,0
1,0,0,1,1,1,1,0,0,0,0,1,0,0,0,1,0,1,1,0
1,0,0,1,1,1,1,0,0,0,0,1,0,0,0,1,0,1,1,0
1,0,0,1,1,1,1,0,0,0,0,1,0,0,0,1,0,1,1,0
1,0,0,1,1,1,1,0,0,0,0,1,0,0,0,1,0,1,1,0
1,0,0,1,1,1,1,0,0,0,0,1,0,0,0,1,0,1,1,0
1,0,0,1,1,1,1,0,0,0,0,1,0,0,0,1,0,1,1,0
1,0,0,1,1,1,1,0,0,0,0,1,0,0,0,1,0,1,1,0
1,0,0,1,1,1,0,0,0,0,0,1,0,0,0,1,0,1,0,0
1,0,0,1,1,1,2,0,0,0,0,3,0,0,0,3,0,3,2,0
1,0,0,1,1,1,2,0,0,0,0,3,0,0,0,3,0,3,2,0
1,0,0,1,1,1,2,0,0,0,0,3,0,0,0,3,0,3,2,0
1,0,0,1,1,1,2,0,0,0,0,3,0,0,0,3,0,3,2,0
1,0,0,1,1,1,2,0,0,0,0,3,0,0,0,3,0,3,2,0
1,0,0,1,1,1,2,0,0,0,0,3,0,0,0,3,0,3,2,0
1,0,0,1,1,1,2,0,0,0,0,3,0,0,0,3,0,3,2,0
1,0,0,1,1,1,2,0,0,0,0,3,0,0,0,3,0,3,2,0
1,0,0,1,1,1,2,0,0,0,0,3,0,0,0,3,0,3,2,0
1,0,0,1,1,1,2,0,0,0,0,3,0,0,0,3,0,3,2,0
1,0,0,1,1,1,2,0,0,0,0,3,0,0,0,3,0,3,2,0
1,0,0,1,1,1,3,11.63,2,46.53,0.01,9,0.5,2.58,4,5,3,3,3,0
1,0,0,1,1,1,0,5.33,1.5,12,0,4,0.67,0.67,1,3,1,3,0,0
1,0,0,1,1,1,0,5.33,1.5,12,0,4,0.67,0.67,1,3,1,3,0,0
1,0,0,1,1,1,0,5.33,1.5,12,0,4,0.67,0.67,1,3,1,3,0,0
1,0,0,1,1,1,2,0,0,0,0,3,0,0,0,3,0,3,2,0
1,0,0,1,1,1,2,5.33,1.5,12,0,4,0.67,0.67,1,3,1,3,2,0
1,0,0,1,1,1,2,0,0,0,0,3,0,0,0,3,0,3,2,0
1,0,0,1,1,1,2,0,0,0,0,3,0,0,0,3,0,3,2,0
1,0,0,1,1,1,2,0,0,0,0,3,0,0,0,3,0,3,2,0
1,0,0,1,1,1,2,0,0,0,0,3,0,0,0,3,0,3,2,0
1,0,0,1,1,1,2,0,0,0,0,3,0,0,0,3,0,3,2,0
1,0,0,1,1,1,2,0,0,0,0,3,0,0,0,3,0,3,2,0
1,0,0,1,1,1,2,0,0,0,0,3,0,0,0,3,0,3,2,0
1,0,0,1,1,1,2,0,0,0,0,3,0,0,0,3,0,3,2,0
1,0,0,1,1,1,2,0,0,0,0,3,0,0,0,3,0,3,2,0
1,0,0,1,1,1,2,0,0,0,0,3,0,0,0,3,0,3,2,0
1,0,0,1,1,1,2,0,0,0,0,3,0,0,0,3,0,3,2,0
1,0,0,1,1,1,0,7.74,1.5,17.41,0,5,0.67,0.97,2,3,2,3,0,0
1,0,0,1,1,1,0,7.74,1.5,17.41,0,5,0.67,0.97,2,3,2,3,0,0
1,0,0,1,1,1,0,0,0,0,0,3,0,0,0,3,0,3,0,0
1,0,0,1,1,1,0,5.33,1.5,12,0,4,0.67,0.67,1,3,1,3,0,0
1,0,0,1,1,1,2,0,0,0,0,3,0,0,0,3,0,3,2,0
1,0,0,1,1,1,2,0,0,0,0,3,0,0,0,3,0,3,2,0
1,0,0,1,1,1,2,0,0,0,0,3,0,0,0,3,0,3,2,0
1,0,0,1,1,1,2,0,0,0,0,3,0,0,0,3,0,3,2,0
1,0,0,1,1,1,2,0,0,0,0,3,0,0,0,3,0,3,2,0
1,0,0,1,1,1,2,0,0,0,0,3,0,0,0,3,0,3,2,0
1,0,0,1,1,1,2,0,0,0,0,3,0,0,0,3,0,3,2,0
1,0,0,1,1,1,2,0,0,0,0,3,0,0,0,3,0,3,2,0
1,0,0,1,1,1,2,0,0,0,0,3,0,0,0,3,0,3,2,0
1,0,0,1,1,1,2,0,0,0,0,3,0,0,0,3,0,3,2,0
1,0,0,1,1,1,2,0,0,0,0,3,0,0,0,3,0,3,2,0
1,0,0,1,1,1,0,0,0,0,0,1,0,0,0,1,0,1,0,0
17,1,17,9,5,7,62,28.81,47.03,63730.17,0.45,271,0.02,3540.56,83,188,15,17,63,0
79,0,195,42,24,9,375,68.19,125.38,1071842,2.85,1341,0.01,59546.78,443,898,53,30,375,0
1,0,3,1,1,1,8,38.31,6.67,1702.75,0.09,55,0.15,94.6,20,35,15,10,8,0
1,0,0,1,1,1,9,2.29,3.5,28,0,8,0.29,1.56,7,1,1,1,9,0
3,0,0,2,1,1,12,25.38,3.75,356.94,0.03,25,0.27,19.83,10,15,8,6,12,0
7,0,1,4,4,1,21,35.85,9.84,3474.18,0.12,76,0.1,193.01,35,41,16,9,21,0
7,0,1,4,4,1,18,36.35,9.33,3166.49,0.11,75,0.11,175.92,35,40,15,8,18,0
1,0,3,1,1,1,10,33.99,10.18,3523.97,0.12,83,0.1,195.78,32,51,11,7,10,0
27,29,132,14,8,8,373,329.92,55.63,1020998.24,6.12,2567,0.02,56722.12,942,1625,127,15,402,0
28,0,4,25,25,1,134,48.93,61.81,186927.79,1.01,467,0.02,10384.88,182,285,53,36,134,0
3,0,3,2,2,1,22,32.54,18.67,11336.79,0.2,102,0.05,629.82,35,67,30,32,22,0
5,0,5,3,1,1,7,13.32,13.71,2505.06,0.06,43,0.07,139.17,16,27,7,12,7,0
5,0,5,3,1,1,7,13.32,13.71,2505.06,0.06,43,0.07,139.17,16,27,7,12,7,0
9,2,1,8,1,1,27,34.09,9.88,3329.22,0.11,68,0.1,184.96,24,44,17,14,29,0
3,0,1,2,1,1,2,12.09,6.3,479.73,0.03,20,0.16,26.65,7,13,5,9,2,0
1,0,0,1,1,1,2,5.33,1.5,12,0,4,0.67,0.67,1,3,1,3,2,0
1,0,0,1,1,1,2,5.33,1.5,12,0,4,0.67,0.67,1,3,1,3,2,0
1,0,0,1,1,1,2,5.33,1.5,12,0,4,0.67,0.67,1,3,1,3,2,0
1,0,0,1,1,1,2,5.33,1.5,12,0,4,0.67,0.67,1,3,1,3,2,0
1,0,0,1,1,1,2,5.33,1.5,12,0,4,0.67,0.67,1,3,1,3,2,0
1,0,0,1,1,1,2,5.33,1.5,12,0,4,0.67,0.67,1,3,1,3,2,0
1,0,0,1,1,1,2,5.33,1.5,12,0,4,0.67,0.67,1,3,1,3,2,0
1,0,0,1,1,1,2,5.33,1.5,12,0,4,0.67,0.67,1,3,1,3,2,0
1,0,0,1,1,1,2,5.33,1.5,12,0,4,0.67,0.67,1,3,1,3,2,0
1,0,0,1,1,1,2,0,0,0,0,4,0,0,0,4,0,4,2,0
1,0,0,1,1,1,1,0,0,0,0,1,0,0,0,1,0,1,1,0
1,0,0,1,1,1,2,0,0,0,0,5,0,0,0,5,0,5,2,0
11,1,4,6,1,1,21,13.86,22.5,7014.99,0.1,68,0.04,389.72,27,41,9,15,22,0
1,0,0,1,1,1,2,20.97,3,188.72,0.02,17,0.33,10.48,7,10,7,6,2,0
1,0,0,1,1,1,2,20.97,3,188.72,0.02,17,0.33,10.48,7,10,7,6,2,0
1,0,0,1,1,1,2,27.35,3,246.13,0.03,21,0.33,13.67,9,12,9,6,2,0
1,0,0,1,1,1,3,30.67,3,276,0.03,23,0.33,15.33,10,13,10,6,3,0
1,0,0,1,1,1,3,30.67,3,276,0.03,23,0.33,15.33,10,13,10,6,3,0
1,0,0,1,1,1,3,30.67,3,276,0.03,23,0.33,15.33,10,13,10,6,3,0
1,0,0,1,1,1,2,27.35,3,246.13,0.03,21,0.33,13.67,9,12,9,6,2,0
1,0,0,1,1,1,3,27.35,3,246.13,0.03,21,0.33,13.67,9,12,9,6,3,0
1,0,0,1,1,1,2,20.97,3,188.72,0.02,17,0.33,10.48,7,10,7,6,2,0
1,0,0,1,1,1,2,20.97,3,188.72,0.02,17,0.33,10.48,7,10,7,6,2,0
1,0,0,1,1,1,2,20.97,3,188.72,0.02,17,0.33,10.48,7,10,7,6,2,0
1,0,0,1,1,1,2,17.92,3,161.32,0.02,15,0.33,8.96,6,9,6,6,2,0
1,0,0,1,1,1,2,17.92,3,161.32,0.02,15,0.33,8.96,6,9,6,6,2,0
1,0,0,1,1,1,2,14.99,3,134.92,0.01,13,0.33,7.5,5,8,5,6,2,0
1,0,0,1,1,1,2,14.99,3,134.92,0.01,13,0.33,7.5,5,8,5,6,2,0
1,0,0,1,1,1,2,14.99,3,134.92,0.01,13,0.33,7.5,5,8,5,6,2,0
1,0,0,1,1,1,2,14.99,3,134.92,0.01,13,0.33,7.5,5,8,5,6,2,0
1,0,0,1,1,1,2,14.99,3,134.92,0.01,13,0.33,7.5,5,8,5,6,2,0
1,0,0,1,1,1,2,17.92,3,161.32,0.02,15,0.33,8.96,6,9,6,6,2,0
1,0,0,1,1,1,2,17.92,3,161.32,0.02,15,0.33,8.96,6,9,6,6,2,0
1,0,0,1,1,1,2,20.97,3,188.72,0.02,17,0.33,10.48,7,10,7,6,2,0
1,0,0,1,1,1,2,20.97,3,188.72,0.02,17,0.33,10.48,7,10,7,6,2,0
1,0,0,1,1,1,1,0,0,0,0,0,0,0,0,0,0,0,1,0
1,0,0,1,1,1,1,0,0,0,0,1,0,0,0,1,0,1,1,0
1,0,0,1,1,1,2,5.33,1.5,12,0,4,0.67,0.67,1,3,1,3,2,0
1,0,0,1,1,1,2,5.33,1.5,12,0,4,0.67,0.67,1,3,1,3,2,0
1,9,0,1,1,1,2,0,0,0,0,9,0,0,9,0,1,0,11,0
1,0,0,1,1,1,1,0,0,0,0,0,0,0,0,0,0,0,1,0
1,0,0,1,1,1,1,0,0,0,0,0,0,0,0,0,0,0,1,0
1,0,0,1,1,1,1,0,0,0,0,1,0,0,0,1,0,1,1,0
1,0,0,1,1,1,4,18.49,2.4,106.51,0.01,14,0.42,5.92,6,8,5,4,4,0
1,0,0,1,1,1,2,5.33,1.5,12,0,4,0.67,0.67,1,3,1,3,2,0
1,0,0,1,1,1,5,8.45,0.75,4.75,0,4,1.33,0.26,3,1,2,1,5,0
1,0,0,1,1,1,1,0,0,0,0,0,0,0,0,0,0,0,1,0
1,0,0,1,1,1,1,0,0,0,0,1,0,0,0,1,0,1,1,0
1,0,0,1,1,1,3,10.8,2.5,67.5,0.01,9,0.4,3.75,3,6,3,5,3,0
1,0,0,1,1,1,2,5.33,1.5,12,0,4,0.67,0.67,1,3,1,3,2,0
1,0,0,1,1,1,2,6.2,2.5,38.77,0.01,6,0.4,2.15,1,5,1,5,2,0
1,0,0,1,1,1,4,9.51,0.5,2.38,0,3,2,0.13,2,1,2,1,4,0
1,0,0,1,1,1,1,0,0,0,0,1,0,0,0,1,0,1,1,0
1,0,0,1,1,1,2,5.33,1.5,12,0,4,0.67,0.67,1,3,1,3,2,0
1,0,0,1,1,1,2,5.33,1.5,12,0,4,0.67,0.67,1,3,1,3,2,0
1,0,0,1,1,1,2,0,0,0,0,4,0,0,0,4,0,4,2,0
1,0,0,1,1,1,1,0,0,0,0,1,0,0,0,1,0,1,1,0
1,0,0,1,1,1,2,0,0,0,0,5,0,0,0,5,0,5,2,0
1,0,0,1,1,1,1,0,0,0,0,1,0,0,0,1,0,1,1,0
1,0,0,1,1,1,2,5.33,1.5,12,0,4,0.67,0.67,1,3,1,3,2,0
1,0,0,1,1,1,2,5.33,1.5,12,0,4,0.67,0.67,1,3,1,3,2,0
1,0,0,1,1,1,1,0,0,0,0,1,0,0,0,1,0,1,1,0
7,1,0,4,1,1,17,19.66,7,963.25,0.05,33,0.14,53.51,14,19,9,9,18,0
25,3,9,13,2,9,32,11.52,67.69,52782.82,0.26,164,0.01,2932.38,57,107,8,19,35,1
5,0,5,3,1,1,7,13.32,13.71,2505.06,0.06,43,0.07,139.17,16,27,7,12,7,0
5,0,5,3,1,1,7,13.32,13.71,2505.06,0.06,43,0.07,139.17,16,27,7,12,7,0
9,2,1,8,1,1,27,34.09,9.88,3329.22,0.11,68,0.1,184.96,24,44,17,14,29,0
33,3,3,17,1,17,27,14.96,84.62,107135.17,0.42,251,0.01,5951.95,110,141,13,20,30,0
33,3,3,17,1,17,27,14.96,84.62,107135.17,0.42,251,0.01,5951.95,110,141,13,20,30,0
3,1,0,2,1,1,8,7.3,5,182.48,0.01,13,0.2,10.14,4,9,2,5,9,0
23,1,0,12,1,7,32,6.85,45,13877.81,0.1,81,0.02,770.99,36,45,4,10,33,0
23,1,0,12,1,7,32,6.85,45,13877.81,0.1,81,0.02,770.99,36,45,4,10,33,0
3,1,0,2,1,1,8,7.3,5,182.48,0.01,13,0.2,10.14,4,9,2,5,9,0
27,13,12,14,4,1,46,28.55,38.92,43259.4,0.37,199,0.03,2403.3,92,107,26,22,59,0
19,11,9,10,3,1,32,23.26,35,28498.4,0.27,151,0.03,1583.24,70,81,21,21,43,0
11,3,4,6,4,1,43,32.91,18.55,11326.3,0.2,120,0.05,629.24,47,73,19,15,46,0
11,3,4,6,4,1,43,32.91,18.55,11326.3,0.2,120,0.05,629.24,47,73,19,15,46,0
5,0,6,3,1,1,13,24.18,4.29,444.05,0.03,28,0.23,24.67,10,18,7,6,13,0
15,1,24,8,1,1,43,61.35,11.82,8568.18,0.24,145,0.08,476.01,52,93,22,10,44,0
5,1,0,3,1,1,10,7.89,11.25,999.12,0.03,24,0.09,55.51,10,14,4,9,11,0
5,1,0,3,1,1,10,7.89,11.25,999.12,0.03,24,0.09,55.51,10,14,4,9,11,0
5,1,0,3,1,1,10,7.89,11.25,999.12,0.03,24,0.09,55.51,10,14,4,9,11,0
3,0,1,2,1,1,2,12.09,6.3,479.73,0.03,20,0.16,26.65,7,13,5,9,2,0
11,1,4,6,1,1,21,13.86,22.5,7014.99,0.1,68,0.04,389.72,27,41,9,15,22,0
1,0,0,1,1,1,1,0,0,0,0,1,0,0,0,1,0,1,1,0
1,0,0,1,1,1,1,0,0,0,0,1,0,0,0,1,0,1,1,0
1,0,0,1,1,1,1,0,0,0,0,1,0,0,0,1,0,1,1,0
1,0,0,1,1,1,1,0,0,0,0,1,0,0,0,1,0,1,1,0
1,0,0,1,1,1,1,0,0,0,0,1,0,0,0,1,0,1,1,0
1,0,0,1,1,1,1,0,0,0,0,1,0,0,0,1,0,1,1,0
1,0,0,1,1,1,1,0,0,0,0,1,0,0,0,1,0,1,1,0
1,0,0,1,1,1,0,0,0,0,0,1,0,0,0,1,0,1,0,0
1,0,0,1,1,1,2,0,0,0,0,3,0,0,0,3,0,3,2,0
1,0,0,1,1,1,2,0,0,0,0,3,0,0,0,3,0,3,2,0
1,0,0,1,1,1,2,0,0,0,0,3,0,0,0,3,0,3,2,0
1,0,0,1,1,1,2,0,0,0,0,3,0,0,0,3,0,3,2,0
1,0,0,1,1,1,2,0,0,0,0,3,0,0,0,3,0,3,2,0
1,0,0,1,1,1,2,0,0,0,0,3,0,0,0,3,0,3,2,0
1,0,0,1,1,1,2,0,0,0,0,3,0,0,0,3,0,3,2,0
1,0,0,1,1,1,2,0,0,0,0,3,0,0,0,3,0,3,2,0
1,0,0,1,1,1,2,0,0,0,0,3,0,0,0,3,0,3,2,0
1,0,0,1,1,1,2,0,0,0,0,3,0,0,0,3,0,3,2,0
1,0,0,1,1,1,2,0,0,0,0,3,0,0,0,3,0,3,2,0
1,0,0,1,1,1,3,11.63,2,46.53,0.01,9,0.5,2.58,4,5,3,3,3,0
1,0,0,1,1,1,0,5.33,1.5,12,0,4,0.67,0.67,1,3,1,3,0,0
1,0,0,1,1,1,0,5.33,1.5,12,0,4,0.67,0.67,1,3,1,3,0,0
1,0,0,1,1,1,0,5.33,1.5,12,0,4,0.67,0.67,1,3,1,3,0,0
1,0,0,1,1,1,2,0,0,0,0,3,0,0,0,3,0,3,2,0
1,0,0,1,1,1,2,5.33,1.5,12,0,4,0.67,0.67,1,3,1,3,2,0
1,0,0,1,1,1,2,0,0,0,0,3,0,0,0,3,0,3,2,0
1,0,0,1,1,1,2,0,0,0,0,3,0,0,0,3,0,3,2,0
1,0,0,1,1,1,2,0,0,0,0,3,0,0,0,3,0,3,2,0
1,0,0,1,1,1,2,0,0,0,0,3,0,0,0,3,0,3,2,0
1,0,0,1,1,1,2,0,0,0,0,3,0,0,0,3,0,3,2,0
1,0,0,1,1,1,2,0,0,0,0,3,0,0,0,3,0,3,2,0
1,0,0,1,1,1,2,0,0,0,0,3,0,0,0,3,0,3,2,0
1,0,0,1,1,1,2,0,0,0,0,3,0,0,0,3,0,3,2,0
1,0,0,1,1,1,2,0,0,0,0,3,0,0,0,3,0,3,2,0
1,0,0,1,1,1,2,0,0,0,0,3,0,0,0,3,0,3,2,0
1,0,0,1,1,1,2,0,0,0,0,3,0,0,0,3,0,3,2,0
1,0,0,1,1,1,0,7.74,1.5,17.41,0,5,0.67,0.97,2,3,2,3,0,0
1,0,0,1,1,1,0,7.74,1.5,17.41,0,5,0.67,0.97,2,3,2,3,0,0
1,0,0,1,1,1,0,0,0,0,0,3,0,0,0,3,0,3,0,0
1,0,0,1,1,1,0,5.33,1.5,12,0,4,0.67,0.67,1,3,1,3,0,0
1,0,0,1,1,1,2,0,0,0,0,3,0,0,0,3,0,3,2,0
1,0,0,1,1,1,2,0,0,0,0,3,0,0,0,3,0,3,2,0
1,0,0,1,1,1,2,0,0,0,0,3,0,0,0,3,0,3,2,0
1,0,0,1,1,1,2,0,0,0,0,3,0,0,0,3,0,3,2,0
1,0,0,1,1,1,2,0,0,0,0,3,0,0,0,3,0,3,2,0
1,0,0,1,1,1,2,0,0,0,0,3,0,0,0,3,0,3,2,0
1,0,0,1,1,1,2,0,0,0,0,3,0,0,0,3,0,3,2,0
1,0,0,1,1,1,2,0,0,0,0,3,0,0,0,3,0,3,2,0
1,0,0,1,1,1,2,0,0,0,0,3,0,0,0,3,0,3,2,0
1,0,0,1,1,1,2,0,0,0,0,3,0,0,0,3,0,3,2,0
1,0,0,1,1,1,2,0,0,0,0,3,0,0,0,3,0,3,2,0
1,0,0,1,1,1,1,0,0,0,0,1,0,0,0,1,0,1,1,0
273,21,123,137,17,73,709,150.7,147.72,3288484.49,7.42,3358,0.01,182693.6,1167,2191,79,20,730,1
1,0,0,1,1,1,4,2.67,1.5,6,0,4,0.67,0.33,3,1,1,1,4,0
11,1,4,6,6,1,28,44.65,11.43,5831.8,0.17,103,0.09,323.99,48,55,21,10,29,1
1,0,2,1,1,1,5,18.37,8,1175.87,0.05,41,0.13,65.33,16,25,6,6,5,0
13,2,170,7,5,4,1268,400.84,70.66,2001507.77,9.44,3945,0.01,111194.88,1435,2510,132,13,1270,1
6,4,1,5,5,1,25,37.3,10.94,4464.77,0.14,84,0.09,248.04,31,53,17,12,29,0
5,0,5,3,1,1,7,13.32,13.71,2505.06,0.06,43,0.07,139.17,16,27,7,12,7,0
5,0,5,3,1,1,7,13.32,13.71,2505.06,0.06,43,0.07,139.17,16,27,7,12,7,0
9,2,1,8,1,1,27,34.09,9.88,3329.22,0.11,68,0.1,184.96,24,44,17,14,29,0
3,0,1,2,1,1,2,12.09,6.3,479.73,0.03,20,0.16,26.65,7,13,5,9,2,0
1,0,0,1,1,1,2,5.33,1.5,12,0,4,0.67,0.67,1,3,1,3,2,0
1,0,0,1,1,1,2,5.33,1.5,12,0,4,0.67,0.67,1,3,1,3,2,0
1,0,0,1,1,1,2,5.33,1.5,12,0,4,0.67,0.67,1,3,1,3,2,0
1,0,0,1,1,1,2,5.33,1.5,12,0,4,0.67,0.67,1,3,1,3,2,0
1,0,0,1,1,1,2,5.33,1.5,12,0,4,0.67,0.67,1,3,1,3,2,0
1,0,0,1,1,1,2,5.33,1.5,12,0,4,0.67,0.67,1,3,1,3,2,0
1,0,0,1,1,1,2,5.33,1.5,12,0,4,0.67,0.67,1,3,1,3,2,0
1,0,0,1,1,1,2,5.33,1.5,12,0,4,0.67,0.67,1,3,1,3,2,0
1,0,0,1,1,1,2,5.33,1.5,12,0,4,0.67,0.67,1,3,1,3,2,0
1,0,0,1,1,1,2,0,0,0,0,4,0,0,0,4,0,4,2,0
1,0,0,1,1,1,1,0,0,0,0,1,0,0,0,1,0,1,1,0
1,0,0,1,1,1,2,0,0,0,0,5,0,0,0,5,0,5,2,0
11,1,4,6,1,1,21,13.86,22.5,7014.99,0.1,68,0.04,389.72,27,41,9,15,22,0
1,0,0,1,1,1,2,20.97,3,188.72,0.02,17,0.33,10.48,7,10,7,6,2,0
1,0,0,1,1,1,2,20.97,3,188.72,0.02,17,0.33,10.48,7,10,7,6,2,0
1,0,0,1,1,1,2,27.35,3,246.13,0.03,21,0.33,13.67,9,12,9,6,2,0
1,0,0,1,1,1,3,30.67,3,276,0.03,23,0.33,15.33,10,13,10,6,3,0
1,0,0,1,1,1,3,30.67,3,276,0.03,23,0.33,15.33,10,13,10,6,3,0
1,0,0,1,1,1,3,30.67,3,276,0.03,23,0.33,15.33,10,13,10,6,3,0
1,0,0,1,1,1,2,27.35,3,246.13,0.03,21,0.33,13.67,9,12,9,6,2,0
1,0,0,1,1,1,3,27.35,3,246.13,0.03,21,0.33,13.67,9,12,9,6,3,0
1,0,0,1,1,1,2,20.97,3,188.72,0.02,17,0.33,10.48,7,10,7,6,2,0
1,0,0,1,1,1,2,20.97,3,188.72,0.02,17,0.33,10.48,7,10,7,6,2,0
1,0,0,1,1,1,2,20.97,3,188.72,0.02,17,0.33,10.48,7,10,7,6,2,0
1,0,0,1,1,1,2,17.92,3,161.32,0.02,15,0.33,8.96,6,9,6,6,2,0
1,0,0,1,1,1,2,17.92,3,161.32,0.02,15,0.33,8.96,6,9,6,6,2,0
1,0,0,1,1,1,2,14.99,3,134.92,0.01,13,0.33,7.5,5,8,5,6,2,0
1,0,0,1,1,1,2,14.99,3,134.92,0.01,13,0.33,7.5,5,8,5,6,2,0
1,0,0,1,1,1,2,14.99,3,134.92,0.01,13,0.33,7.5,5,8,5,6,2,0
1,0,0,1,1,1,2,14.99,3,134.92,0.01,13,0.33,7.5,5,8,5,6,2,0
1,0,0,1,1,1,2,14.99,3,134.92,0.01,13,0.33,7.5,5,8,5,6,2,0
1,0,0,1,1,1,2,17.92,3,161.32,0.02,15,0.33,8.96,6,9,6,6,2,0
1,0,0,1,1,1,2,17.92,3,161.32,0.02,15,0.33,8.96,6,9,6,6,2,0
1,0,0,1,1,1,2,20.97,3,188.72,0.02,17,0.33,10.48,7,10,7,6,2,0
1,0,0,1,1,1,2,20.97,3,188.72,0.02,17,0.33,10.48,7,10,7,6,2,0
1,0,0,1,1,1,1,0,0,0,0,0,0,0,0,0,0,0,1,0
1,0,0,1,1,1,1,0,0,0,0,1,0,0,0,1,0,1,1,0
1,0,0,1,1,1,2,5.33,1.5,12,0,4,0.67,0.67,1,3,1,3,2,0
1,0,0,1,1,1,2,5.33,1.5,12,0,4,0.67,0.67,1,3,1,3,2,0
1,9,0,1,1,1,2,0,0,0,0,9,0,0,9,0,1,0,11,0
1,0,0,1,1,1,1,0,0,0,0,0,0,0,0,0,0,0,1,0
1,0,0,1,1,1,1,0,0,0,0,0,0,0,0,0,0,0,1,0
1,0,0,1,1,1,1,0,0,0,0,1,0,0,0,1,0,1,1,0
1,0,0,1,1,1,4,18.49,2.4,106.51,0.01,14,0.42,5.92,6,8,5,4,4,0
1,0,0,1,1,1,2,5.33,1.5,12,0,4,0.67,0.67,1,3,1,3,2,0
1,0,0,1,1,1,5,8.45,0.75,4.75,0,4,1.33,0.26,3,1,2,1,5,0
1,0,0,1,1,1,1,0,0,0,0,0,0,0,0,0,0,0,1,0
1,0,0,1,1,1,1,0,0,0,0,1,0,0,0,1,0,1,1,0
1,0,0,1,1,1,3,10.8,2.5,67.5,0.01,9,0.4,3.75,3,6,3,5,3,0
1,0,0,1,1,1,2,5.33,1.5,12,0,4,0.67,0.67,1,3,1,3,2,0
1,0,0,1,1,1,2,6.2,2.5,38.77,0.01,6,0.4,2.15,1,5,1,5,2,0
1,0,0,1,1,1,4,9.51,0.5,2.38,0,3,2,0.13,2,1,2,1,4,0
1,0,0,1,1,1,1,0,0,0,0,1,0,0,0,1,0,1,1,0
1,0,0,1,1,1,2,5.33,1.5,12,0,4,0.67,0.67,1,3,1,3,2,0
1,0,0,1,1,1,2,5.33,1.5,12,0,4,0.67,0.67,1,3,1,3,2,0
1,0,0,1,1,1,2,0,0,0,0,4,0,0,0,4,0,4,2,0
1,0,0,1,1,1,1,0,0,0,0,1,0,0,0,1,0,1,1,0
1,0,0,1,1,1,2,0,0,0,0,5,0,0,0,5,0,5,2,0
1,0,0,1,1,1,1,0,0,0,0,1,0,0,0,1,0,1,1,0
1,0,0,1,1,1,2,5.33,1.5,12,0,4,0.67,0.67,1,3,1,3,2,0
1,0,0,1,1,1,2,5.33,1.5,12,0,4,0.67,0.67,1,3,1,3,2,0
1,0,0,1,1,1,1,0,0,0,0,1,0,0,0,1,0,1,1,0
1,0,0,1,1,1,1,0,0,0,0,1,0,0,0,1,0,1,1,0
1,0,0,1,1,1,1,0,0,0,0,1,0,0,0,1,0,1,1,0
5,0,0,3,1,1,2,13.29,4.5,269.08,0.02,18,0.22,14.95,6,12,4,6,2,0
1,0,1,1,1,1,2,16.92,3.5,207.22,0.02,16,0.29,11.51,6,10,6,7,2,0
1,0,0,1,1,1,0,0,0,0,0,1,0,0,0,1,0,1,0,0
1,0,0,1,1,1,2,0,0,0,0,3,0,0,0,3,0,3,2,0
1,0,0,1,1,1,2,0,0,0,0,3,0,0,0,3,0,3,2,0
1,0,0,1,1,1,2,0,0,0,0,3,0,0,0,3,0,3,2,0
1,0,0,1,1,1,2,0,0,0,0,3,0,0,0,3,0,3,2,0
1,0,0,1,1,1,2,0,0,0,0,3,0,0,0,3,0,3,2,0
1,0,0,1,1,1,2,0,0,0,0,3,0,0,0,3,0,3,2,0
1,0,0,1,1,1,2,0,0,0,0,3,0,0,0,3,0,3,2,0
1,0,0,1,1,1,2,0,0,0,0,3,0,0,0,3,0,3,2,0
1,0,0,1,1,1,2,0,0,0,0,3,0,0,0,3,0,3,2,0
1,0,0,1,1,1,2,0,0,0,0,3,0,0,0,3,0,3,2,0
1,0,0,1,1,1,2,0,0,0,0,3,0,0,0,3,0,3,2,0
1,0,0,1,1,1,3,11.63,2,46.53,0.01,9,0.5,2.58,4,5,3,3,3,0
1,0,0,1,1,1,0,5.33,1.5,12,0,4,0.67,0.67,1,3,1,3,0,0
1,0,0,1,1,1,0,5.33,1.5,12,0,4,0.67,0.67,1,3,1,3,0,0
1,0,0,1,1,1,0,5.33,1.5,12,0,4,0.67,0.67,1,3,1,3,0,0
1,0,0,1,1,1,2,0,0,0,0,3,0,0,0,3,0,3,2,0
1,0,0,1,1,1,2,5.33,1.5,12,0,4,0.67,0.67,1,3,1,3,2,0
1,0,0,1,1,1,2,0,0,0,0,3,0,0,0,3,0,3,2,0
1,0,0,1,1,1,2,0,0,0,0,3,0,0,0,3,0,3,2,0
1,0,0,1,1,1,2,0,0,0,0,3,0,0,0,3,0,3,2,0
1,0,0,1,1,1,2,0,0,0,0,3,0,0,0,3,0,3,2,0
1,0,0,1,1,1,2,0,0,0,0,3,0,0,0,3,0,3,2,0
1,0,0,1,1,1,2,0,0,0,0,3,0,0,0,3,0,3,2,0
1,0,0,1,1,1,2,0,0,0,0,3,0,0,0,3,0,3,2,0
1,0,0,1,1,1,2,0,0,0,0,3,0,0,0,3,0,3,2,0
1,0,0,1,1,1,2,0,0,0,0,3,0,0,0,3,0,3,2,0
1,0,0,1,1,1,2,0,0,0,0,3,0,0,0,3,0,3,2,0
1,0,0,1,1,1,2,0,0,0,0,3,0,0,0,3,0,3,2,0
1,0,0,1,1,1,0,7.74,1.5,17.41,0,5,0.67,0.97,2,3,2,3,0,0
1,0,0,1,1,1,0,7.74,1.5,17.41,0,5,0.67,0.97,2,3,2,3,0,0
1,0,0,1,1,1,0,0,0,0,0,3,0,0,0,3,0,3,0,0
1,0,0,1,1,1,0,5.33,1.5,12,0,4,0.67,0.67,1,3,1,3,0,0
1,0,0,1,1,1,2,0,0,0,0,3,0,0,0,3,0,3,2,0
1,0,0,1,1,1,2,0,0,0,0,3,0,0,0,3,0,3,2,0
1,0,0,1,1,1,2,0,0,0,0,3,0,0,0,3,0,3,2,0
1,0,0,1,1,1,2,0,0,0,0,3,0,0,0,3,0,3,2,0
1,0,0,1,1,1,2,0,0,0,0,3,0,0,0,3,0,3,2,0
1,0,0,1,1,1,2,0,0,0,0,3,0,0,0,3,0,3,2,0
1,0,0,1,1,1,2,0,0,0,0,3,0,0,0,3,0,3,2,0
1,0,0,1,1,1,2,0,0,0,0,3,0,0,0,3,0,3,2,0
1,0,0,1,1,1,2,0,0,0,0,3,0,0,0,3,0,3,2,0
1,0,0,1,1,1,2,0,0,0,0,3,0,0,0,3,0,3,2,0
1,0,0,1,1,1,2,0,0,0,0,3,0,0,0,3,0,3,2,0
5,0,0,3,1,3,9,9.87,7.88,611.96,0.03,21,0.13,34,7,14,4,9,9,0
5,0,0,3,1,3,9,10.85,9,879.05,0.03,25,0.11,48.84,9,16,5,10,9,0
1,0,0,1,1,1,0,5.33,1.5,12,0,4,0.67,0.67,1,3,1,3,0,0
1,0,0,1,1,1,0,0,0,0,0,0,0,0,0,0,0,0,0,0
1,0,0,1,1,1,0,0,0,0,0,0,0,0,0,0,0,0,0,0
1,0,0,1,1,1,2,5.33,1.5,12,0,4,0.67,0.67,1,3,1,3,2,0
1,0,0,1,1,1,2,5.33,1.5,12,0,4,0.67,0.67,1,3,1,3,2,0
1,0,0,1,1,1,2,0,0,0,0,4,0,0,0,4,0,4,2,0
1,0,0,1,1,1,1,0,0,0,0,1,0,0,0,1,0,1,1,0
1,0,0,1,1,1,0,0,0,0,0,1,0,0,0,1,0,1,0,0
1,0,0,1,1,1,2,0,0,0,0,5,0,0,0,5,0,5,2,0
1,0,0,1,1,1,2,0,0,0,0.01,6,0,0,0,6,0,6,2,0
1,0,0,1,1,1,0,0,0,0,0,0,0,0,0,0,0,0,0,0
1,0,0,1,1,1,1,0,0,0,0,1,0,0,0,1,0,1,1,0
1,0,0,1,1,1,2,5.33,1.5,12,0,4,0.67,0.67,1,3,1,3,2,0
1,0,0,1,1,1,2,5.33,1.5,12,0,4,0.67,0.67,1,3,1,3,2,0
1,0,0,1,1,1,2,0,0,0,0,4,0,0,0,4,0,4,2,0
1,0,0,1,1,1,1,0,0,0,0,1,0,0,0,1,0,1,1,0
1,0,0,1,1,1,2,0,0,0,0,5,0,0,0,5,0,5,2,0
1,0,0,1,1,1,1,0,0,0,0,1,0,0,0,1,0,1,1,0
1,0,0,1,1,1,2,5.33,1.5,12,0,4,0.67,0.67,1,3,1,3,2,0
1,0,0,1,1,1,2,5.33,1.5,12,0,4,0.67,0.67,1,3,1,3,2,0
1,0,0,1,1,1,1,0,0,0,0,1,0,0,0,1,0,1,1,0
1,0,0,1,1,1,2,10.44,3.5,127.89,0.01,11,0.29,7.11,3,8,3,7,2,0
1,0,0,1,1,1,2,7.49,3,67.38,0.01,8,0.33,3.74,1,7,1,6,2,0
1,0,0,1,1,1,2,9,3,81,0.01,9,0.33,4.5,2,7,2,6,2,0
1,0,0,1,1,1,2,9,3,81,0.01,9,0.33,4.5,2,7,2,6,2,0
1,0,0,1,1,1,2,9,3,81,0.01,9,0.33,4.5,2,7,2,6,2,0
1,0,0,1,1,1,2,10.44,3.5,127.89,0.01,11,0.29,7.11,3,8,3,7,2,0
1,0,0,1,1,1,2,9,3,81,0.01,9,0.33,4.5,2,7,2,6,2,0
1,0,0,1,1,1,2,9,3,81,0.01,9,0.33,4.5,2,7,2,6,2,0
1,0,0,1,1,1,2,7.49,3,67.38,0.01,8,0.33,3.74,1,7,1,6,2,0
1,0,0,1,1,1,2,7.49,3,67.38,0.01,8,0.33,3.74,1,7,1,6,2,0
1,0,0,1,1,1,2,10,3,90,0.01,10,0.33,5,2,8,2,6,2,0
1,0,0,1,1,1,3,10.44,3.5,127.89,0.01,11,0.29,7.11,3,8,3,7,3,0
1,0,0,1,1,1,3,11.39,3.5,139.52,0.01,12,0.29,7.75,3,9,3,7,3,0
1,0,0,1,1,1,2,9,3,81,0.01,9,0.33,4.5,2,7,2,6,2,0
1,0,0,1,1,1,2,10.44,3.5,127.89,0.01,11,0.29,7.11,3,8,3,7,2,0
1,0,0,1,1,1,2,9,3,81,0.01,9,0.33,4.5,2,7,2,6,2,0
1,0,0,1,1,1,2,9,3,81,0.01,9,0.33,4.5,2,7,2,6,2,0
1,0,0,1,1,1,2,10.44,3.5,127.89,0.01,11,0.29,7.11,3,8,3,7,2,0
1,0,0,1,1,1,2,9,3,81,0.01,9,0.33,4.5,2,7,2,6,2,0
1,0,0,1,1,1,2,9,3,81,0.01,9,0.33,4.5,2,7,2,6,2,0
1,0,0,1,1,1,2,9,3,81,0.01,9,0.33,4.5,2,7,2,6,2,0
1,0,0,1,1,1,2,7.49,3,67.38,0.01,8,0.33,3.74,1,7,1,6,2,0
1,0,0,1,1,1,2,9,3,81,0.01,9,0.33,4.5,2,7,2,6,2,0
1,0,0,1,1,1,2,9,3,81,0.01,9,0.33,4.5,2,7,2,6,2,0
1,0,0,1,1,1,2,10.44,3.5,127.89,0.01,11,0.29,7.11,3,8,3,7,2,0
1,0,0,1,1,1,2,9.05,2,36.19,0.01,7,0.5,2,2,5,2,4,2,0
1,0,0,1,1,1,2,9.05,2,36.19,0.01,7,0.5,2,2,5,2,4,2,0
1,0,0,1,1,1,2,9.05,2,36.19,0.01,7,0.5,2,2,5,2,4,2,0
1,0,0,1,1,1,2,9.05,2,36.19,0.01,7,0.5,2,2,5,2,4,2,0
1,0,0,1,1,1,2,9.05,2,36.19,0.01,7,0.5,2,2,5,2,4,2,0
1,0,0,1,1,1,2,9.05,2,36.19,0.01,7,0.5,2,2,5,2,4,2,0
1,0,0,1,1,1,2,9.05,2,36.19,0.01,7,0.5,2,2,5,2,4,2,0
1,0,0,1,1,1,2,9.05,2,36.19,0.01,7,0.5,2,2,5,2,4,2,0
1,0,0,1,1,1,2,9.05,2,36.19,0.01,7,0.5,2,2,5,2,4,2,0
1,0,0,1,1,1,2,9.05,2,36.19,0.01,7,0.5,2,2,5,2,4,2,0
1,0,0,1,1,1,2,9.05,2,36.19,0.01,7,0.5,2,2,5,2,4,2,0
1,0,0,1,1,1,2,9.05,2,36.19,0.01,7,0.5,2,2,5,2,4,2,0
1,0,0,1,1,1,2,9.05,2,36.19,0.01,7,0.5,2,2,5,2,4,2,0
1,0,0,1,1,1,2,10.44,3.5,127.89,0.01,11,0.29,7.11,3,8,3,7,2,0
1,0,0,1,1,1,2,10.44,3.5,127.89,0.01,11,0.29,7.11,3,8,3,7,2,0
1,0,0,1,1,1,2,9.05,2,36.19,0.01,7,0.5,2,2,5,2,4,2,0
1,0,0,1,1,1,0,0,0,0,0,1,0,0,0,1,0,1,0,0
1,0,0,1,1,1,2,5.33,1.5,12,0,4,0.67,0.67,1,3,1,3,2,0
3,0,0,2,1,1,6,11.86,4.38,227.03,0.02,15,0.23,12.61,5,10,4,7,6,0
3,2,0,2,1,1,6,14.43,5.14,381.76,0.02,19,0.19,21.21,9,10,7,8,8,0
5,1,0,3,1,1,10,12.67,10,1267.11,0.04,31,0.1,70.4,14,17,7,10,11,0
3,1,0,2,1,1,6,11.71,4.9,281.06,0.02,16,0.2,15.61,7,9,5,7,7,0
3,1,0,2,1,1,6,11.71,4.9,281.06,0.02,16,0.2,15.61,7,9,5,7,7,0
1,0,0,1,1,1,2,5.33,1.5,12,0,4,0.67,0.67,1,3,1,3,2,0
1,0,0,1,1,1,2,5.33,1.5,12,0,4,0.67,0.67,1,3,1,3,2,0
3,1,0,2,1,1,6,11.23,5.6,352.28,0.02,17,0.18,19.57,7,10,5,8,7,0
7,1,1,4,1,3,13,18.91,10.45,2065.48,0.07,45,0.1,114.75,19,26,10,11,14,0
5,1,0,3,1,1,10,13.33,9,1080,0.04,30,0.11,60,14,16,7,9,11,0
3,1,0,2,1,1,6,11.71,4.9,281.06,0.02,16,0.2,15.61,7,9,5,7,7,0
7,1,1,4,1,3,13,18.91,10.45,2065.48,0.07,45,0.1,114.75,19,26,10,11,14,0
3,1,0,2,1,1,6,11.71,4.9,281.06,0.02,16,0.2,15.61,7,9,5,7,7,0
3,0,0,2,1,1,6,11.86,4.38,227.03,0.02,15,0.23,12.61,5,10,4,7,6,0
3,2,0,2,1,1,7,16.73,5.5,506,0.03,23,0.18,28.11,11,12,8,8,9,0
1,0,0,1,1,1,2,5.33,1.5,12,0,4,0.67,0.67,1,3,1,3,2,0
9,6,0,5,1,1,14,23.12,11.15,2875.94,0.09,57,0.09,159.77,29,28,13,10,20,0
3,1,0,2,1,1,7,14.43,5.14,381.76,0.02,19,0.19,21.21,9,10,7,8,8,0
7,1,1,4,1,3,13,19.62,10,1962.15,0.07,44,0.1,109.01,20,24,11,11,14,0
1,0,0,1,1,1,2,5.33,1.5,12,0,4,0.67,0.67,1,3,1,3,2,0
1,0,0,1,1,1,2,5.33,1.5,12,0,4,0.67,0.67,1,3,1,3,2,0
1,0,0,1,1,1,2,5.33,1.5,12,0,4,0.67,0.67,1,3,1,3,2,0
1,0,0,1,1,1,2,5.33,1.5,12,0,4,0.67,0.67,1,3,1,3,2,0
1,0,0,1,1,1,2,5.33,1.5,12,0,4,0.67,0.67,1,3,1,3,2,0
1,0,0,1,1,1,2,5.33,1.5,12,0,4,0.67,0.67,1,3,1,3,2,0
1,0,0,1,1,1,2,5.33,1.5,12,0,4,0.67,0.67,1,3,1,3,2,0
3,1,0,2,1,1,5,10.95,6,394.38,0.02,19,0.17,21.91,10,9,5,6,6,0
3,1,0,2,1,1,5,10.95,6,394.38,0.02,19,0.17,21.91,10,9,5,6,6,0
3,1,0,2,1,1,5,10.95,6,394.38,0.02,19,0.17,21.91,10,9,5,6,6,0
3,1,0,2,1,1,5,10.95,6,394.38,0.02,19,0.17,21.91,10,9,5,6,6,0
3,1,1,2,1,1,5,10.95,6,394.38,0.02,19,0.17,21.91,10,9,5,6,6,0
1,0,0,1,1,1,3,13,3,117,0.01,13,0.33,6.5,6,7,4,4,3,0
1,0,0,1,1,1,2,11.07,3,99.66,0.01,10,0.33,5.54,4,6,4,6,2,0
1,0,0,1,1,1,2,7.74,1.5,17.41,0,5,0.67,0.97,2,3,2,3,2,0
3,0,1,2,1,1,8,16.92,4.5,342.66,0.03,20,0.22,19.04,9,11,7,7,8,0
3,1,0,2,1,1,7,16.92,4.5,342.66,0.03,20,0.22,19.04,9,11,7,7,8,0
1,0,0,1,1,1,2,11.41,2.5,71.32,0.01,9,0.4,3.96,4,5,4,5,2,0
3,1,0,2,1,1,5,10.95,6,394.38,0.02,19,0.17,21.91,10,9,5,6,6,0
1,0,0,1,1,1,4,16.51,4.8,380.39,0.03,25,0.21,21.13,12,13,5,4,4,0
1,0,0,1,1,1,2,7.74,1.5,17.41,0,5,0.67,0.97,2,3,2,3,2,0
3,1,0,2,1,1,5,10.95,6,394.38,0.02,19,0.17,21.91,10,9,5,6,6,0
3,1,0,2,1,1,5,10.95,6,394.38,0.02,19,0.17,21.91,10,9,5,6,6,0
1,0,0,1,1,1,2,9.83,2,39.3,0.01,7,0.5,2.18,3,4,3,4,2,0
3,0,0,2,2,1,11,22.39,6.61,978.44,0.05,37,0.15,54.36,17,20,9,7,11,0
1,0,0,1,1,1,0,0,0,0,0,1,0,0,0,1,0,1,0,0
1,0,0,1,1,1,2,0,0,0,0,3,0,0,0,3,0,3,2,0
1,0,0,1,1,1,2,0,0,0,0,3,0,0,0,3,0,3,2,0
1,0,0,1,1,1,2,0,0,0,0,3,0,0,0,3,0,3,2,0
1,0,0,1,1,1,2,0,0,0,0,3,0,0,0,3,0,3,2,0
1,0,0,1,1,1,2,0,0,0,0,3,0,0,0,3,0,3,2,0
1,0,0,1,1,1,2,0,0,0,0,3,0,0,0,3,0,3,2,0
1,0,0,1,1,1,2,0,0,0,0,3,0,0,0,3,0,3,2,0
1,0,0,1,1,1,2,0,0,0,0,3,0,0,0,3,0,3,2,0
1,0,0,1,1,1,2,0,0,0,0,3,0,0,0,3,0,3,2,0
1,0,0,1,1,1,2,0,0,0,0,3,0,0,0,3,0,3,2,0
1,0,0,1,1,1,2,0,0,0,0,3,0,0,0,3,0,3,2,0
1,0,0,1,1,1,3,11.63,2,46.53,0.01,9,0.5,2.58,4,5,3,3,3,0
1,0,0,1,1,1,0,5.33,1.5,12,0,4,0.67,0.67,1,3,1,3,0,0
1,0,0,1,1,1,0,5.33,1.5,12,0,4,0.67,0.67,1,3,1,3,0,0
1,0,0,1,1,1,0,5.33,1.5,12,0,4,0.67,0.67,1,3,1,3,0,0
1,0,0,1,1,1,2,0,0,0,0,3,0,0,0,3,0,3,2,0
1,0,0,1,1,1,2,5.33,1.5,12,0,4,0.67,0.67,1,3,1,3,2,0
1,0,0,1,1,1,2,0,0,0,0,3,0,0,0,3,0,3,2,0
1,0,0,1,1,1,2,0,0,0,0,3,0,0,0,3,0,3,2,0
1,0,0,1,1,1,2,0,0,0,0,3,0,0,0,3,0,3,2,0
1,0,0,1,1,1,2,0,0,0,0,3,0,0,0,3,0,3,2,0
1,0,0,1,1,1,2,0,0,0,0,3,0,0,0,3,0,3,2,0
1,0,0,1,1,1,2,0,0,0,0,3,0,0,0,3,0,3,2,0
1,0,0,1,1,1,2,0,0,0,0,3,0,0,0,3,0,3,2,0
1,0,0,1,1,1,2,0,0,0,0,3,0,0,0,3,0,3,2,0
1,0,0,1,1,1,2,0,0,0,0,3,0,0,0,3,0,3,2,0
1,0,0,1,1,1,2,0,0,0,0,3,0,0,0,3,0,3,2,0
1,0,0,1,1,1,2,0,0,0,0,3,0,0,0,3,0,3,2,0
1,0,0,1,1,1,0,7.74,1.5,17.41,0,5,0.67,0.97,2,3,2,3,0,0
1,0,0,1,1,1,0,7.74,1.5,17.41,0,5,0.67,0.97,2,3,2,3,0,0
1,0,0,1,1,1,0,0,0,0,0,3,0,0,0,3,0,3,0,0
1,0,0,1,1,1,0,5.33,1.5,12,0,4,0.67,0.67,1,3,1,3,0,0
1,0,0,1,1,1,2,0,0,0,0,3,0,0,0,3,0,3,2,0
1,0,0,1,1,1,2,0,0,0,0,3,0,0,0,3,0,3,2,0
1,0,0,1,1,1,2,0,0,0,0,3,0,0,0,3,0,3,2,0
1,0,0,1,1,1,2,0,0,0,0,3,0,0,0,3,0,3,2,0
1,0,0,1,1,1,2,0,0,0,0,3,0,0,0,3,0,3,2,0
1,0,0,1,1,1,2,0,0,0,0,3,0,0,0,3,0,3,2,0
1,0,0,1,1,1,2,0,0,0,0,3,0,0,0,3,0,3,2,0
1,0,0,1,1,1,2,0,0,0,0,3,0,0,0,3,0,3,2,0
1,0,0,1,1,1,2,0,0,0,0,3,0,0,0,3,0,3,2,0
1,0,0,1,1,1,2,0,0,0,0,3,0,0,0,3,0,3,2,0
1,0,0,1,1,1,2,0,0,0,0,3,0,0,0,3,0,3,2,0
1,0,0,1,1,1,3,17.27,2.5,107.96,0.01,13,0.4,6,5,8,5,5,3,0
1,0,0,1,1,1,3,13.95,2.5,87.17,0.01,11,0.4,4.84,4,7,4,5,3,0
1,0,0,1,1,1,2,5.8,2,23.22,0,5,0.5,1.29,1,4,1,4,2,0
1,0,0,1,1,1,2,9.6,2.5,60,0.01,8,0.4,3.33,3,5,3,5,2,0
5,0,1,3,3,1,15,24.32,9.6,2241.75,0.08,56,0.1,124.54,24,32,10,8,15,0
3,0,1,2,2,1,13,23.24,8.18,1555.89,0.06,44,0.12,86.44,20,24,11,9,13,0
5,0,0,3,1,3,9,9.87,7.88,611.96,0.03,21,0.13,34,7,14,4,9,9,0
5,0,0,3,1,3,9,10.85,9,879.05,0.03,25,0.11,48.84,9,16,5,10,9,0
1,0,0,1,1,1,0,5.33,1.5,12,0,4,0.67,0.67,1,3,1,3,0,0
1,0,0,1,1,1,3,10.8,2.5,67.5,0.01,9,0.4,3.75,3,6,3,5,3,0
1,0,0,1,1,1,2,12.18,3,109.62,0.01,11,0.33,6.09,4,7,4,6,2,0
1,0,0,1,1,1,3,13.29,3,119.59,0.01,12,0.33,6.64,4,8,4,6,3,0
1,0,0,1,1,1,3,9.05,2,36.19,0.01,7,0.5,2,2,5,2,4,3,0
1,0,0,1,1,1,3,9.05,2,36.19,0.01,7,0.5,2,2,5,2,4,3,0
1,0,0,1,1,1,3,13.95,2.5,87.17,0.01,11,0.4,4.84,4,7,4,5,3,0
5,0,1,3,2,3,9,20.32,10.91,2418.05,0.07,49,0.09,134.34,20,29,11,12,9,0
5,0,1,3,3,1,11,24.14,7.6,1394.42,0.06,44,0.13,77.47,19,25,10,8,11,0
1,0,0,1,1,1,1,0,0,0,0,1,0,0,0,1,0,1,1,0
1,0,0,1,1,1,1,0,0,0,0,1,0,0,0,1,0,1,1,0
1,0,0,1,1,1,1,0,0,0,0,1,0,0,0,1,0,1,1,0
1,0,0,1,1,1,1,0,0,0,0,1,0,0,0,1,0,1,1,0
1,0,0,1,1,1,1,0,0,0,0,1,0,0,0,1,0,1,1,0
1,0,0,1,1,1,1,0,0,0,0,1,0,0,0,1,0,1,1,0
1,0,0,1,1,1,1,0,0,0,0,1,0,0,0,1,0,1,1,0
1,0,0,1,1,1,0,0,0,0,0,1,0,0,0,1,0,1,0,0
5,0,0,3,1,1,2,13.29,4.5,269.08,0.02,18,0.22,14.95,6,12,4,6,2,0
1,0,1,1,1,1,2,16.92,3.5,207.22,0.02,16,0.29,11.51,6,10,6,7,2,0
1,0,0,1,1,1,0,0,0,0,0,1,0,0,0,1,0,1,0,0
1,0,0,1,1,1,2,0,0,0,0,3,0,0,0,3,0,3,2,0
1,0,0,1,1,1,2,0,0,0,0,3,0,0,0,3,0,3,2,0
1,0,0,1,1,1,2,0,0,0,0,3,0,0,0,3,0,3,2,0
1,0,0,1,1,1,2,0,0,0,0,3,0,0,0,3,0,3,2,0
1,0,0,1,1,1,2,0,0,0,0,3,0,0,0,3,0,3,2,0
1,0,0,1,1,1,2,0,0,0,0,3,0,0,0,3,0,3,2,0
1,0,0,1,1,1,2,0,0,0,0,3,0,0,0,3,0,3,2,0
1,0,0,1,1,1,2,0,0,0,0,3,0,0,0,3,0,3,2,0
1,0,0,1,1,1,2,0,0,0,0,3,0,0,0,3,0,3,2,0
1,0,0,1,1,1,2,0,0,0,0,3,0,0,0,3,0,3,2,0
1,0,0,1,1,1,2,0,0,0,0,3,0,0,0,3,0,3,2,0
1,0,0,1,1,1,3,11.63,2,46.53,0.01,9,0.5,2.58,4,5,3,3,3,0
1,0,0,1,1,1,0,5.33,1.5,12,0,4,0.67,0.67,1,3,1,3,0,0
1,0,0,1,1,1,0,5.33,1.5,12,0,4,0.67,0.67,1,3,1,3,0,0
1,0,0,1,1,1,0,5.33,1.5,12,0,4,0.67,0.67,1,3,1,3,0,0
1,0,0,1,1,1,2,0,0,0,0,3,0,0,0,3,0,3,2,0
1,0,0,1,1,1,2,5.33,1.5,12,0,4,0.67,0.67,1,3,1,3,2,0
1,0,0,1,1,1,2,0,0,0,0,3,0,0,0,3,0,3,2,0
1,0,0,1,1,1,2,0,0,0,0,3,0,0,0,3,0,3,2,0
1,0,0,1,1,1,2,0,0,0,0,3,0,0,0,3,0,3,2,0
1,0,0,1,1,1,2,0,0,0,0,3,0,0,0,3,0,3,2,0
1,0,0,1,1,1,2,0,0,0,0,3,0,0,0,3,0,3,2,0
1,0,0,1,1,1,2,0,0,0,0,3,0,0,0,3,0,3,2,0
1,0,0,1,1,1,2,0,0,0,0,3,0,0,0,3,0,3,2,0
1,0,0,1,1,1,2,0,0,0,0,3,0,0,0,3,0,3,2,0
1,0,0,1,1,1,2,0,0,0,0,3,0,0,0,3,0,3,2,0
1,0,0,1,1,1,2,0,0,0,0,3,0,0,0,3,0,3,2,0
1,0,0,1,1,1,2,0,0,0,0,3,0,0,0,3,0,3,2,0
1,0,0,1,1,1,0,7.74,1.5,17.41,0,5,0.67,0.97,2,3,2,3,0,0
1,0,0,1,1,1,0,7.74,1.5,17.41,0,5,0.67,0.97,2,3,2,3,0,0
1,0,0,1,1,1,0,0,0,0,0,3,0,0,0,3,0,3,0,0
1,0,0,1,1,1,0,5.33,1.5,12,0,4,0.67,0.67,1,3,1,3,0,0
1,0,0,1,1,1,2,0,0,0,0,3,0,0,0,3,0,3,2,0
1,0,0,1,1,1,2,0,0,0,0,3,0,0,0,3,0,3,2,0
1,0,0,1,1,1,2,0,0,0,0,3,0,0,0,3,0,3,2,0
1,0,0,1,1,1,2,0,0,0,0,3,0,0,0,3,0,3,2,0
1,0,0,1,1,1,2,0,0,0,0,3,0,0,0,3,0,3,2,0
1,0,0,1,1,1,2,0,0,0,0,3,0,0,0,3,0,3,2,0
1,0,0,1,1,1,2,0,0,0,0,3,0,0,0,3,0,3,2,0
1,0,0,1,1,1,2,0,0,0,0,3,0,0,0,3,0,3,2,0
1,0,0,1,1,1,2,0,0,0,0,3,0,0,0,3,0,3,2,0
1,0,0,1,1,1,2,0,0,0,0,3,0,0,0,3,0,3,2,0
1,0,0,1,1,1,2,0,0,0,0,3,0,0,0,3,0,3,2,0
5,0,5,3,1,1,7,13.32,13.71,2505.06,0.06,43,0.07,139.17,16,27,7,12,7,0
5,0,5,3,1,1,7,13.32,13.71,2505.06,0.06,43,0.07,139.17,16,27,7,12,7,0
1,0,0,1,1,1,1,0,0,0,0,1,0,0,0,1,0,1,1,0
181,24,300,94,14,51,309,89.87,112.55,1138416.63,3.37,1445,0.01,63245.37,648,797,95,33,333,0
5,1,0,4,1,1,15,24.32,6,875.68,0.05,35,0.17,48.65,12,23,9,9,16,0
1,0,0,1,1,1,4,2.67,1.5,6,0,4,0.67,0.33,3,1,1,1,4,0
11,1,4,6,4,1,31,27.55,17.19,8142.3,0.16,89,0.06,452.35,38,51,21,19,32,1
25,5,22,13,12,1,63,99.95,19.19,36788.57,0.64,315,0.05,2043.81,148,167,54,14,68,0
1,0,7,1,1,1,25,93.27,12.38,14306.29,0.39,229,0.08,794.79,92,137,26,7,25,0
13,2,28,7,5,4,301,173.1,46.09,367738.91,2.66,1226,0.02,20429.94,507,719,77,14,303,0
49,11,15,25,15,6,64,58.73,34.63,70438.3,0.68,339,0.03,3913.24,177,162,46,18,75,0
60,2,56,40,37,1,186,88.2,63,350063.96,1.85,784,0.02,19448,350,434,100,36,188,0
37,3,18,19,1,17,32,25.01,38.18,36464.5,0.32,176,0.03,2025.81,80,96,22,21,35,0
76,9,35,45,20,24,144,57.75,70.67,288408.33,1.36,594,0.01,16022.68,262,332,76,41,153,0
1,0,0,1,1,1,2,5.33,1.5,12,0,4,0.67,0.67,1,3,1,3,2,0
9,2,1,8,1,1,27,34.09,9.88,3329.22,0.11,68,0.1,184.96,24,44,17,14,29,0
3,0,1,2,1,1,2,12.09,6.3,479.73,0.03,20,0.16,26.65,7,13,5,9,2,0
1,0,0,1,1,1,2,5.33,1.5,12,0,4,0.67,0.67,1,3,1,3,2,0
1,0,0,1,1,1,2,5.33,1.5,12,0,4,0.67,0.67,1,3,1,3,2,0
1,0,0,1,1,1,2,5.33,1.5,12,0,4,0.67,0.67,1,3,1,3,2,0
1,0,0,1,1,1,2,5.33,1.5,12,0,4,0.67,0.67,1,3,1,3,2,0
1,0,0,1,1,1,2,5.33,1.5,12,0,4,0.67,0.67,1,3,1,3,2,0
1,0,0,1,1,1,2,5.33,1.5,12,0,4,0.67,0.67,1,3,1,3,2,0
1,0,0,1,1,1,2,5.33,1.5,12,0,4,0.67,0.67,1,3,1,3,2,0
1,0,0,1,1,1,2,5.33,1.5,12,0,4,0.67,0.67,1,3,1,3,2,0
1,0,0,1,1,1,2,5.33,1.5,12,0,4,0.67,0.67,1,3,1,3,2,0
1,0,0,1,1,1,2,0,0,0,0,5,0,0,0,5,0,5,2,0
1,0,0,1,1,1,0,0,0,0,0,5,0,0,0,5,0,5,0,0
1,0,0,1,1,1,0,0,0,0,0,5,0,0,0,5,0,5,0,0
1,0,0,1,1,1,0,0,0,0,0,1,0,0,0,1,0,1,0,0
1,0,0,1,1,1,1,0,0,0,0,1,0,0,0,1,0,1,1,0
1,0,0,1,1,1,2,0,0,0,0.01,6,0,0,0,6,0,6,2,0
1,0,0,1,1,1,2,0,0,0,0,5,0,0,0,5,0,5,2,0
1,0,0,1,1,1,2,0,0,0,0.01,6,0,0,0,6,0,6,2,0
11,1,4,6,1,1,21,13.86,22.5,7014.99,0.1,68,0.04,389.72,27,41,9,15,22,0
1,0,0,1,1,1,0,0,0,0,0,1,0,0,0,1,0,1,0,0
1,0,3,1,1,1,2,5.33,1.5,12,0,4,0.67,0.67,1,3,1,3,2,0
1,0,0,1,1,1,2,5.33,1.5,12,0,4,0.67,0.67,1,3,1,3,2,0
3,1,0,2,1,1,6,11.71,4.9,281.06,0.02,16,0.2,15.61,7,9,5,7,7,0
1,0,1,1,1,1,2,5.33,1.5,12,0,4,0.67,0.67,1,3,1,3,2,0
1,0,0,1,1,1,2,5.33,1.5,12,0,4,0.67,0.67,1,3,1,3,2,0
1,0,0,1,1,1,2,6.97,2,27.86,0,6,0.5,1.55,1,5,1,4,2,0
1,0,1,1,1,1,2,10.8,2.5,67.5,0.01,9,0.4,3.75,3,6,3,5,2,0
1,0,0,1,1,1,2,9.05,2,36.19,0.01,7,0.5,2,2,5,2,4,2,0
1,0,0,1,1,1,2,7.49,3,67.38,0.01,8,0.33,3.74,1,7,1,6,2,0
1,0,0,1,1,1,2,9,3,81,0.01,9,0.33,4.5,2,7,2,6,2,0
1,0,0,1,1,1,2,9,3,81,0.01,9,0.33,4.5,2,7,2,6,2,0
1,0,0,1,1,1,2,7.49,3,67.38,0.01,8,0.33,3.74,1,7,1,6,2,0
1,0,0,1,1,1,2,10.8,2.5,67.5,0.01,9,0.4,3.75,3,6,3,5,2,0
1,0,0,1,1,1,2,9,3,81,0.01,9,0.33,4.5,2,7,2,6,2,0
1,0,0,1,1,1,2,9.05,2,36.19,0.01,7,0.5,2,2,5,2,4,2,0
1,0,0,1,1,1,2,9.05,2,36.19,0.01,7,0.5,2,2,5,2,4,2,0
1,0,0,1,1,1,2,20.97,3,188.72,0.02,17,0.33,10.48,7,10,7,6,2,0
1,0,0,1,1,1,2,20.97,3,188.72,0.02,17,0.33,10.48,7,10,7,6,2,0
1,0,0,1,1,1,2,27.35,3,246.13,0.03,21,0.33,13.67,9,12,9,6,2,0
1,0,0,1,1,1,3,30.67,3,276,0.03,23,0.33,15.33,10,13,10,6,3,0
1,0,0,1,1,1,3,30.67,3,276,0.03,23,0.33,15.33,10,13,10,6,3,0
1,0,0,1,1,1,3,30.67,3,276,0.03,23,0.33,15.33,10,13,10,6,3,0
1,0,0,1,1,1,2,27.35,3,246.13,0.03,21,0.33,13.67,9,12,9,6,2,0
1,0,0,1,1,1,3,27.35,3,246.13,0.03,21,0.33,13.67,9,12,9,6,3,0
1,0,0,1,1,1,2,20.97,3,188.72,0.02,17,0.33,10.48,7,10,7,6,2,0
1,0,0,1,1,1,2,20.97,3,188.72,0.02,17,0.33,10.48,7,10,7,6,2,0
1,0,0,1,1,1,2,20.97,3,188.72,0.02,17,0.33,10.48,7,10,7,6,2,0
1,0,0,1,1,1,2,17.92,3,161.32,0.02,15,0.33,8.96,6,9,6,6,2,0
1,0,0,1,1,1,2,17.92,3,161.32,0.02,15,0.33,8.96,6,9,6,6,2,0
1,0,0,1,1,1,2,14.99,3,134.92,0.01,13,0.33,7.5,5,8,5,6,2,0
1,0,0,1,1,1,2,14.99,3,134.92,0.01,13,0.33,7.5,5,8,5,6,2,0
1,0,0,1,1,1,2,14.99,3,134.92,0.01,13,0.33,7.5,5,8,5,6,2,0
1,0,0,1,1,1,2,14.99,3,134.92,0.01,13,0.33,7.5,5,8,5,6,2,0
1,0,0,1,1,1,2,14.99,3,134.92,0.01,13,0.33,7.5,5,8,5,6,2,0
1,0,0,1,1,1,2,17.92,3,161.32,0.02,15,0.33,8.96,6,9,6,6,2,0
1,0,0,1,1,1,2,17.92,3,161.32,0.02,15,0.33,8.96,6,9,6,6,2,0
1,0,0,1,1,1,2,20.97,3,188.72,0.02,17,0.33,10.48,7,10,7,6,2,0
1,0,0,1,1,1,2,20.97,3,188.72,0.02,17,0.33,10.48,7,10,7,6,2,0
1,0,0,1,1,1,1,0,0,0,0,0,0,0,0,0,0,0,1,0
1,0,0,1,1,1,1,0,0,0,0,1,0,0,0,1,0,1,1,0
1,0,0,1,1,1,2,5.33,1.5,12,0,4,0.67,0.67,1,3,1,3,2,0
1,0,0,1,1,1,2,5.33,1.5,12,0,4,0.67,0.67,1,3,1,3,2,0
1,9,0,1,1,1,2,0,0,0,0,9,0,0,9,0,1,0,11,0
1,0,0,1,1,1,1,0,0,0,0,0,0,0,0,0,0,0,1,0
1,0,0,1,1,1,1,0,0,0,0,0,0,0,0,0,0,0,1,0
1,0,0,1,1,1,1,0,0,0,0,1,0,0,0,1,0,1,1,0
1,0,0,1,1,1,4,18.49,2.4,106.51,0.01,14,0.42,5.92,6,8,5,4,4,0
1,0,0,1,1,1,2,5.33,1.5,12,0,4,0.67,0.67,1,3,1,3,2,0
1,0,0,1,1,1,5,8.45,0.75,4.75,0,4,1.33,0.26,3,1,2,1,5,0
1,0,0,1,1,1,1,0,0,0,0,0,0,0,0,0,0,0,1,0
1,0,0,1,1,1,1,0,0,0,0,1,0,0,0,1,0,1,1,0
1,0,0,1,1,1,3,10.8,2.5,67.5,0.01,9,0.4,3.75,3,6,3,5,3,0
1,0,0,1,1,1,2,5.33,1.5,12,0,4,0.67,0.67,1,3,1,3,2,0
1,0,0,1,1,1,2,6.2,2.5,38.77,0.01,6,0.4,2.15,1,5,1,5,2,0
1,0,0,1,1,1,4,9.51,0.5,2.38,0,3,2,0.13,2,1,2,1,4,0
1,0,0,1,1,1,1,0,0,0,0,1,0,0,0,1,0,1,1,0
1,0,0,1,1,1,2,5.33,1.5,12,0,4,0.67,0.67,1,3,1,3,2,0
1,0,0,1,1,1,2,5.33,1.5,12,0,4,0.67,0.67,1,3,1,3,2,0
1,0,0,1,1,1,2,0,0,0,0,4,0,0,0,4,0,4,2,0
1,0,0,1,1,1,1,0,0,0,0,1,0,0,0,1,0,1,1,0
1,0,0,1,1,1,2,0,0,0,0,5,0,0,0,5,0,5,2,0
1,0,0,1,1,1,1,0,0,0,0,1,0,0,0,1,0,1,1,0
1,0,0,1,1,1,2,5.33,1.5,12,0,4,0.67,0.67,1,3,1,3,2,0
1,0,0,1,1,1,2,5.33,1.5,12,0,4,0.67,0.67,1,3,1,3,2,0
1,0,0,1,1,1,1,0,0,0,0,1,0,0,0,1,0,1,1,0
1,0,0,1,1,1,6,16.68,7.5,938.23,0.04,30,0.13,52.12,12,18,8,10,6,0
1,0,0,1,1,1,2,5.33,1.5,12,0,4,0.67,0.67,1,3,1,3,2,0
1,0,0,1,1,1,2,10.44,3.5,127.89,0.01,11,0.29,7.11,3,8,3,7,2,0
1,0,0,1,1,1,0,0,0,0,0,1,0,0,0,1,0,1,0,0
1,0,0,1,1,1,2,5.33,1.5,12,0,4,0.67,0.67,1,3,1,3,2,0
1,0,0,1,1,1,2,8,3,72,0.01,8,0.33,4,2,6,2,6,2,0
1,0,0,1,1,1,2,0,0,0,0,5,0,0,0,5,0,5,2,0
1,0,0,1,1,1,0,0,0,0,0,1,0,0,0,1,0,1,0,0
1,0,0,1,1,1,2,0,0,0,0.01,6,0,0,0,6,0,6,2,0
1,0,0,1,1,1,2,7.75,2,31.02,0.01,6,0.5,1.72,2,4,2,4,2,0
1,0,0,1,1,1,2,7.74,1.5,17.41,0,5,0.67,0.97,2,3,2,3,2,0
1,1,1,1,1,1,1,0,0,0,0,1,0,0,1,0,1,0,2,0
3,1,0,2,1,1,7,12.44,4.9,298.63,0.02,17,0.2,16.59,7,10,5,7,8,0
1,0,0,1,1,1,0,0,0,0,0,1,0,0,0,1,0,1,0,0
3,1,0,2,2,1,6,10.88,6.3,431.75,0.02,18,0.16,23.99,7,11,5,9,7,0
1,0,0,1,1,1,2,0,0,0,0,5,0,0,0,5,0,5,2,0
1,0,0,1,1,1,0,0,0,0,0,1,0,0,0,1,0,1,0,0
1,0,0,1,1,1,2,0,0,0,0.01,6,0,0,0,6,0,6,2,0
1,0,3,1,1,1,4,0,0,0,0,3,0,0,3,0,2,0,4,0
1,0,0,1,1,1,0,0,0,0,0,1,0,0,0,1,0,1,0,0
3,2,1,2,1,1,5,10.33,4.5,209.28,0.02,14,0.22,11.63,6,8,4,6,7,0
3,1,0,2,1,1,6,13.45,3.6,174.36,0.02,14,0.28,9.69,6,8,5,6,7,0
1,0,0,1,1,1,2,0,0,0,0,5,0,0,0,5,0,5,2,0
1,0,0,1,1,1,0,0,0,0,0,1,0,0,0,1,0,1,0,0
1,0,0,1,1,1,2,0,0,0,0.01,6,0,0,0,6,0,6,2,0
1,0,0,1,1,1,0,0,0,0,0,1,0,0,0,1,0,1,0,0
1,0,0,1,1,1,2,6.55,3,58.95,0.01,7,0.33,3.28,1,6,1,6,2,0
1,0,0,1,1,1,2,5.33,1.5,12,0,4,0.67,0.67,1,3,1,3,2,0
1,0,0,1,1,1,2,8,3,72,0.01,8,0.33,4,2,6,2,6,2,0
1,0,0,1,1,1,2,9,3,81,0.01,9,0.33,4.5,2,7,2,6,2,0
1,0,0,1,1,1,2,8,3,72,0.01,8,0.33,4,2,6,2,6,2,0
1,0,0,1,1,1,2,9.49,3.5,116.27,0.01,10,0.29,6.46,3,7,3,7,2,0
1,0,0,1,1,1,2,11.86,3.5,145.3,0.01,12,0.29,8.07,4,8,4,7,2,0
1,0,0,1,1,1,2,0,0,0,0,5,0,0,0,5,0,5,2,0
1,0,0,1,1,1,0,0,0,0,0,1,0,0,0,1,0,1,0,0
1,0,0,1,1,1,2,0,0,0,0.01,6,0,0,0,6,0,6,2,0
1,0,0,1,1,1,2,7.75,2,31.02,0.01,6,0.5,1.72,2,4,2,4,2,0
1,0,0,1,1,1,3,10.8,3.33,120,0.01,12,0.3,6.67,4,8,3,5,3,0
1,0,0,1,1,1,2,7.75,2,31.02,0.01,6,0.5,1.72,2,4,2,4,2,0
1,0,0,1,1,1,3,12.68,2.5,79.25,0.01,10,0.4,4.4,4,6,4,5,3,0
1,3,1,1,1,1,1,0,0,0,0,1,0,0,1,0,1,0,4,0
1,0,0,1,1,1,2,6.55,3,58.95,0.01,7,0.33,3.28,1,6,1,6,2,0
1,0,0,1,1,1,0,0,0,0,0,1,0,0,0,1,0,1,0,0
1,0,0,1,1,1,2,8,3,72,0.01,8,0.33,4,2,6,2,6,2,0
1,0,0,1,1,1,2,9,3,81,0.01,9,0.33,4.5,2,7,2,6,2,0
1,0,0,1,1,1,2,5.33,1.5,12,0,4,0.67,0.67,1,3,1,3,2,0
1,0,0,1,1,1,2,5.33,1.5,12,0,4,0.67,0.67,1,3,1,3,2,0
1,0,0,1,1,1,2,6.55,3,58.95,0.01,7,0.33,3.28,1,6,1,6,2,0
1,0,0,1,1,1,2,5.33,1.5,12,0,4,0.67,0.67,1,3,1,3,2,0
1,0,0,1,1,1,2,5.33,1.5,12,0,4,0.67,0.67,1,3,1,3,2,0
1,0,0,1,1,1,2,6.55,3,58.95,0.01,7,0.33,3.28,1,6,1,6,2,0
1,0,0,1,1,1,2,0,0,0,0,5,0,0,0,5,0,5,2,0
1,0,0,1,1,1,0,0,0,0,0,1,0,0,0,1,0,1,0,0
1,0,0,1,1,1,2,0,0,0,0.01,6,0,0,0,6,0,6,2,0
1,0,0,1,1,1,0,0,0,0,0,1,0,0,0,1,0,1,0,0
1,0,1,1,1,1,2,9.51,3,85.59,0.01,9,0.33,4.75,3,6,3,6,2,0
1,0,0,1,1,1,2,0,0,0,0,5,0,0,0,5,0,5,2,0
1,0,0,1,1,1,0,0,0,0,0,1,0,0,0,1,0,1,0,0
1,0,0,1,1,1,2,0,0,0,0.01,6,0,0,0,6,0,6,2,0
1,0,0,1,1,1,2,10.44,3.5,127.89,0.01,11,0.29,7.11,3,8,3,7,2,0
1,0,0,1,1,1,2,7.49,3,67.38,0.01,8,0.33,3.74,1,7,1,6,2,0
1,0,0,1,1,1,2,9,3,81,0.01,9,0.33,4.5,2,7,2,6,2,0
1,0,0,1,1,1,2,9,3,81,0.01,9,0.33,4.5,2,7,2,6,2,0
1,0,0,1,1,1,2,9,3,81,0.01,9,0.33,4.5,2,7,2,6,2,0
1,0,0,1,1,1,2,10.44,3.5,127.89,0.01,11,0.29,7.11,3,8,3,7,2,0
1,0,0,1,1,1,2,9,3,81,0.01,9,0.33,4.5,2,7,2,6,2,0
1,0,0,1,1,1,2,9,3,81,0.01,9,0.33,4.5,2,7,2,6,2,0
1,0,0,1,1,1,2,7.49,3,67.38,0.01,8,0.33,3.74,1,7,1,6,2,0
1,0,0,1,1,1,2,7.49,3,67.38,0.01,8,0.33,3.74,1,7,1,6,2,0
1,0,0,1,1,1,2,10,3,90,0.01,10,0.33,5,2,8,2,6,2,0
1,0,0,1,1,1,3,10.44,3.5,127.89,0.01,11,0.29,7.11,3,8,3,7,3,0
1,0,0,1,1,1,3,11.39,3.5,139.52,0.01,12,0.29,7.75,3,9,3,7,3,0
1,0,0,1,1,1,2,9,3,81,0.01,9,0.33,4.5,2,7,2,6,2,0
1,0,0,1,1,1,2,10.44,3.5,127.89,0.01,11,0.29,7.11,3,8,3,7,2,0
1,0,0,1,1,1,2,9,3,81,0.01,9,0.33,4.5,2,7,2,6,2,0
1,0,0,1,1,1,2,9,3,81,0.01,9,0.33,4.5,2,7,2,6,2,0
1,0,0,1,1,1,2,10.44,3.5,127.89,0.01,11,0.29,7.11,3,8,3,7,2,0
1,0,0,1,1,1,2,9,3,81,0.01,9,0.33,4.5,2,7,2,6,2,0
1,0,0,1,1,1,2,9,3,81,0.01,9,0.33,4.5,2,7,2,6,2,0
1,0,0,1,1,1,2,9,3,81,0.01,9,0.33,4.5,2,7,2,6,2,0
1,0,0,1,1,1,2,7.49,3,67.38,0.01,8,0.33,3.74,1,7,1,6,2,0
1,0,0,1,1,1,2,9,3,81,0.01,9,0.33,4.5,2,7,2,6,2,0
1,0,0,1,1,1,2,9,3,81,0.01,9,0.33,4.5,2,7,2,6,2,0
1,0,0,1,1,1,2,10.44,3.5,127.89,0.01,11,0.29,7.11,3,8,3,7,2,0
1,0,0,1,1,1,2,9.05,2,36.19,0.01,7,0.5,2,2,5,2,4,2,0
1,0,0,1,1,1,2,9.05,2,36.19,0.01,7,0.5,2,2,5,2,4,2,0
1,0,0,1,1,1,2,9.05,2,36.19,0.01,7,0.5,2,2,5,2,4,2,0
1,0,0,1,1,1,2,9.05,2,36.19,0.01,7,0.5,2,2,5,2,4,2,0
1,0,0,1,1,1,2,9.05,2,36.19,0.01,7,0.5,2,2,5,2,4,2,0
1,0,0,1,1,1,2,9.05,2,36.19,0.01,7,0.5,2,2,5,2,4,2,0
1,0,0,1,1,1,2,9.05,2,36.19,0.01,7,0.5,2,2,5,2,4,2,0
1,0,0,1,1,1,2,9.05,2,36.19,0.01,7,0.5,2,2,5,2,4,2,0
1,0,0,1,1,1,2,9.05,2,36.19,0.01,7,0.5,2,2,5,2,4,2,0
1,0,0,1,1,1,2,9.05,2,36.19,0.01,7,0.5,2,2,5,2,4,2,0
1,0,0,1,1,1,2,9.05,2,36.19,0.01,7,0.5,2,2,5,2,4,2,0
1,0,0,1,1,1,2,9.05,2,36.19,0.01,7,0.5,2,2,5,2,4,2,0
1,0,0,1,1,1,2,9.05,2,36.19,0.01,7,0.5,2,2,5,2,4,2,0
1,0,0,1,1,1,2,10.44,3.5,127.89,0.01,11,0.29,7.11,3,8,3,7,2,0
1,0,0,1,1,1,2,10.44,3.5,127.89,0.01,11,0.29,7.11,3,8,3,7,2,0
1,0,0,1,1,1,2,9.05,2,36.19,0.01,7,0.5,2,2,5,2,4,2,0
1,0,0,1,1,1,0,0,0,0,0,1,0,0,0,1,0,1,0,0
1,0,0,1,1,1,2,5.33,1.5,12,0,4,0.67,0.67,1,3,1,3,2,0
3,0,0,2,1,1,6,11.86,4.38,227.03,0.02,15,0.23,12.61,5,10,4,7,6,0
3,2,0,2,1,1,6,14.43,5.14,381.76,0.02,19,0.19,21.21,9,10,7,8,8,0
5,1,0,3,1,1,10,12.67,10,1267.11,0.04,31,0.1,70.4,14,17,7,10,11,0
3,1,0,2,1,1,6,11.71,4.9,281.06,0.02,16,0.2,15.61,7,9,5,7,7,0
3,1,0,2,1,1,6,11.71,4.9,281.06,0.02,16,0.2,15.61,7,9,5,7,7,0
1,0,0,1,1,1,2,5.33,1.5,12,0,4,0.67,0.67,1,3,1,3,2,0
1,0,0,1,1,1,2,5.33,1.5,12,0,4,0.67,0.67,1,3,1,3,2,0
3,1,0,2,1,1,6,11.23,5.6,352.28,0.02,17,0.18,19.57,7,10,5,8,7,0
7,1,1,4,1,3,13,18.91,10.45,2065.48,0.07,45,0.1,114.75,19,26,10,11,14,0
5,1,0,3,1,1,10,13.33,9,1080,0.04,30,0.11,60,14,16,7,9,11,0
3,1,0,2,1,1,6,11.71,4.9,281.06,0.02,16,0.2,15.61,7,9,5,7,7,0
7,1,1,4,1,3,13,18.91,10.45,2065.48,0.07,45,0.1,114.75,19,26,10,11,14,0
3,1,0,2,1,1,6,11.71,4.9,281.06,0.02,16,0.2,15.61,7,9,5,7,7,0
3,0,0,2,1,1,6,11.86,4.38,227.03,0.02,15,0.23,12.61,5,10,4,7,6,0
3,2,0,2,1,1,7,16.73,5.5,506,0.03,23,0.18,28.11,11,12,8,8,9,0
1,0,0,1,1,1,2,5.33,1.5,12,0,4,0.67,0.67,1,3,1,3,2,0
9,6,0,5,1,1,14,23.12,11.15,2875.94,0.09,57,0.09,159.77,29,28,13,10,20,0
3,1,0,2,1,1,7,14.43,5.14,381.76,0.02,19,0.19,21.21,9,10,7,8,8,0
7,1,1,4,1,3,13,19.62,10,1962.15,0.07,44,0.1,109.01,20,24,11,11,14,0
1,0,0,1,1,1,2,5.33,1.5,12,0,4,0.67,0.67,1,3,1,3,2,0
1,0,0,1,1,1,2,5.33,1.5,12,0,4,0.67,0.67,1,3,1,3,2,0
1,0,0,1,1,1,2,5.33,1.5,12,0,4,0.67,0.67,1,3,1,3,2,0
1,0,0,1,1,1,2,5.33,1.5,12,0,4,0.67,0.67,1,3,1,3,2,0
1,0,0,1,1,1,2,5.33,1.5,12,0,4,0.67,0.67,1,3,1,3,2,0
1,0,0,1,1,1,2,5.33,1.5,12,0,4,0.67,0.67,1,3,1,3,2,0
1,0,0,1,1,1,2,5.33,1.5,12,0,4,0.67,0.67,1,3,1,3,2,0
3,1,0,2,1,1,5,10.95,6,394.38,0.02,19,0.17,21.91,10,9,5,6,6,0
3,1,0,2,1,1,5,10.95,6,394.38,0.02,19,0.17,21.91,10,9,5,6,6,0
3,1,0,2,1,1,5,10.95,6,394.38,0.02,19,0.17,21.91,10,9,5,6,6,0
3,1,0,2,1,1,5,10.95,6,394.38,0.02,19,0.17,21.91,10,9,5,6,6,0
3,1,1,2,1,1,5,10.95,6,394.38,0.02,19,0.17,21.91,10,9,5,6,6,0
1,0,0,1,1,1,3,13,3,117,0.01,13,0.33,6.5,6,7,4,4,3,0
1,0,0,1,1,1,2,11.07,3,99.66,0.01,10,0.33,5.54,4,6,4,6,2,0
1,0,0,1,1,1,2,7.74,1.5,17.41,0,5,0.67,0.97,2,3,2,3,2,0
3,0,1,2,1,1,8,16.92,4.5,342.66,0.03,20,0.22,19.04,9,11,7,7,8,0
3,1,0,2,1,1,7,16.92,4.5,342.66,0.03,20,0.22,19.04,9,11,7,7,8,0
1,0,0,1,1,1,2,11.41,2.5,71.32,0.01,9,0.4,3.96,4,5,4,5,2,0
3,1,0,2,1,1,5,10.95,6,394.38,0.02,19,0.17,21.91,10,9,5,6,6,0
1,0,0,1,1,1,4,16.51,4.8,380.39,0.03,25,0.21,21.13,12,13,5,4,4,0
1,0,0,1,1,1,2,7.74,1.5,17.41,0,5,0.67,0.97,2,3,2,3,2,0
3,1,0,2,1,1,5,10.95,6,394.38,0.02,19,0.17,21.91,10,9,5,6,6,0
3,1,0,2,1,1,5,10.95,6,394.38,0.02,19,0.17,21.91,10,9,5,6,6,0
1,0,0,1,1,1,2,9.83,2,39.3,0.01,7,0.5,2.18,3,4,3,4,2,0
1,0,0,1,1,1,1,0,0,0,0,1,0,0,0,1,0,1,1,0
1,0,0,1,1,1,1,0,0,0,0,1,0,0,0,1,0,1,1,0
1,0,0,1,1,1,1,0,0,0,0,1,0,0,0,1,0,1,1,0
1,0,0,1,1,1,1,0,0,0,0,1,0,0,0,1,0,1,1,0
1,0,0,1,1,1,0,0,0,0,0,1,0,0,0,1,0,1,0,0
5,0,0,3,1,1,2,13.29,4.5,269.08,0.02,18,0.22,14.95,6,12,4,6,2,0
1,0,1,1,1,1,2,16.92,3.5,207.22,0.02,16,0.29,11.51,6,10,6,7,2,0
1,0,0,1,1,1,0,0,0,0,0,1,0,0,0,1,0,1,0,0
1,0,0,1,1,1,2,0,0,0,0,3,0,0,0,3,0,3,2,0
1,0,0,1,1,1,2,0,0,0,0,3,0,0,0,3,0,3,2,0
1,0,0,1,1,1,2,0,0,0,0,3,0,0,0,3,0,3,2,0
1,0,0,1,1,1,2,0,0,0,0,3,0,0,0,3,0,3,2,0
1,0,0,1,1,1,2,0,0,0,0,3,0,0,0,3,0,3,2,0
1,0,0,1,1,1,2,0,0,0,0,3,0,0,0,3,0,3,2,0
1,0,0,1,1,1,2,0,0,0,0,3,0,0,0,3,0,3,2,0
1,0,0,1,1,1,2,0,0,0,0,3,0,0,0,3,0,3,2,0
1,0,0,1,1,1,2,0,0,0,0,3,0,0,0,3,0,3,2,0
1,0,0,1,1,1,2,0,0,0,0,3,0,0,0,3,0,3,2,0
1,0,0,1,1,1,2,0,0,0,0,3,0,0,0,3,0,3,2,0
1,0,0,1,1,1,3,11.63,2,46.53,0.01,9,0.5,2.58,4,5,3,3,3,0
1,0,0,1,1,1,0,5.33,1.5,12,0,4,0.67,0.67,1,3,1,3,0,0
1,0,0,1,1,1,0,5.33,1.5,12,0,4,0.67,0.67,1,3,1,3,0,0
1,0,0,1,1,1,0,5.33,1.5,12,0,4,0.67,0.67,1,3,1,3,0,0
1,0,0,1,1,1,2,0,0,0,0,3,0,0,0,3,0,3,2,0
1,0,0,1,1,1,2,5.33,1.5,12,0,4,0.67,0.67,1,3,1,3,2,0
1,0,0,1,1,1,2,0,0,0,0,3,0,0,0,3,0,3,2,0
1,0,0,1,1,1,2,0,0,0,0,3,0,0,0,3,0,3,2,0
1,0,0,1,1,1,2,0,0,0,0,3,0,0,0,3,0,3,2,0
1,0,0,1,1,1,2,0,0,0,0,3,0,0,0,3,0,3,2,0
1,0,0,1,1,1,2,0,0,0,0,3,0,0,0,3,0,3,2,0
1,0,0,1,1,1,2,0,0,0,0,3,0,0,0,3,0,3,2,0
1,0,0,1,1,1,2,0,0,0,0,3,0,0,0,3,0,3,2,0
1,0,0,1,1,1,2,0,0,0,0,3,0,0,0,3,0,3,2,0
1,0,0,1,1,1,2,0,0,0,0,3,0,0,0,3,0,3,2,0
1,0,0,1,1,1,2,0,0,0,0,3,0,0,0,3,0,3,2,0
1,0,0,1,1,1,2,0,0,0,0,3,0,0,0,3,0,3,2,0
1,0,0,1,1,1,0,7.74,1.5,17.41,0,5,0.67,0.97,2,3,2,3,0,0
1,0,0,1,1,1,0,7.74,1.5,17.41,0,5,0.67,0.97,2,3,2,3,0,0
1,0,0,1,1,1,0,0,0,0,0,3,0,0,0,3,0,3,0,0
1,0,0,1,1,1,0,5.33,1.5,12,0,4,0.67,0.67,1,3,1,3,0,0
1,0,0,1,1,1,2,0,0,0,0,3,0,0,0,3,0,3,2,0
1,0,0,1,1,1,2,0,0,0,0,3,0,0,0,3,0,3,2,0
1,0,0,1,1,1,2,0,0,0,0,3,0,0,0,3,0,3,2,0
1,0,0,1,1,1,2,0,0,0,0,3,0,0,0,3,0,3,2,0
1,0,0,1,1,1,2,0,0,0,0,3,0,0,0,3,0,3,2,0
1,0,0,1,1,1,2,0,0,0,0,3,0,0,0,3,0,3,2,0
1,0,0,1,1,1,2,0,0,0,0,3,0,0,0,3,0,3,2,0
1,0,0,1,1,1,2,0,0,0,0,3,0,0,0,3,0,3,2,0
1,0,0,1,1,1,2,0,0,0,0,3,0,0,0,3,0,3,2,0
1,0,0,1,1,1,2,0,0,0,0,3,0,0,0,3,0,3,2,0
1,0,0,1,1,1,2,0,0,0,0,3,0,0,0,3,0,3,2,0
5,0,5,3,1,1,7,13.32,13.71,2505.06,0.06,43,0.07,139.17,16,27,7,12,7,0
5,0,5,3,1,1,7,13.32,13.71,2505.06,0.06,43,0.07,139.17,16,27,7,12,7,0
1,0,0,1,1,1,1,0,0,0,0,1,0,0,0,1,0,1,1,0
231,32,162,116,15,44,246,210.9,41.87,369765.74,2.94,1180,0.02,20542.54,568,612,156,23,278,0
1,0,0,1,1,1,6,2.4,2.5,15,0,6,0.4,0.83,5,1,1,1,6,0
7,2,4,4,3,1,22,36.87,11.87,5194.05,0.15,84,0.08,288.56,39,45,23,14,24,0
7,1,6,4,4,1,15,26.02,12.47,4043.32,0.11,69,0.08,224.63,34,35,15,11,16,0
1,0,1,1,1,1,43,174.43,9.48,15673.51,0.55,286,0.11,870.75,130,156,48,7,43,0
21,2,32,11,7,6,227,245.85,34.22,287901.48,2.8,1229,0.03,15994.53,537,692,102,13,229,0
65,16,24,39,34,1,157,64.26,69.13,307090.97,1.48,681,0.01,17060.61,316,365,64,28,173,0
69,3,14,37,7,31,77,47.17,49.72,116597.83,0.78,364,0.02,6477.66,155,209,53,34,80,0
9,0,6,5,4,3,19,27.45,10.36,2944.2,0.09,62,0.1,163.57,29,33,14,10,19,0
9,2,1,8,1,1,27,34.09,9.88,3329.22,0.11,68,0.1,184.96,24,44,17,14,29,0
3,0,1,2,1,1,2,12.09,6.3,479.73,0.03,20,0.16,26.65,7,13,5,9,2,0
1,0,0,1,1,1,2,5.33,1.5,12,0,4,0.67,0.67,1,3,1,3,2,0
1,0,0,1,1,1,2,5.33,1.5,12,0,4,0.67,0.67,1,3,1,3,2,0
1,0,0,1,1,1,2,5.33,1.5,12,0,4,0.67,0.67,1,3,1,3,2,0
1,0,0,1,1,1,2,5.33,1.5,12,0,4,0.67,0.67,1,3,1,3,2,0
1,0,0,1,1,1,2,5.33,1.5,12,0,4,0.67,0.67,1,3,1,3,2,0
1,0,0,1,1,1,2,5.33,1.5,12,0,4,0.67,0.67,1,3,1,3,2,0
1,0,0,1,1,1,2,5.33,1.5,12,0,4,0.67,0.67,1,3,1,3,2,0
1,0,0,1,1,1,2,0,0,0,0,5,0,0,0,5,0,5,2,0
1,0,0,1,1,1,0,0,0,0,0,5,0,0,0,5,0,5,0,0
1,0,0,1,1,1,0,0,0,0,0,5,0,0,0,5,0,5,0,0
1,0,0,1,1,1,0,0,0,0,0,1,0,0,0,1,0,1,0,0
1,0,0,1,1,1,2,0,0,0,0.01,6,0,0,0,6,0,6,2,0
11,1,4,6,1,1,21,13.86,22.5,7014.99,0.1,68,0.04,389.72,27,41,9,15,22,0
1,0,0,1,1,1,2,20.97,3,188.72,0.02,17,0.33,10.48,7,10,7,6,2,0
1,0,0,1,1,1,2,20.97,3,188.72,0.02,17,0.33,10.48,7,10,7,6,2,0
1,0,0,1,1,1,2,27.35,3,246.13,0.03,21,0.33,13.67,9,12,9,6,2,0
1,0,0,1,1,1,3,30.67,3,276,0.03,23,0.33,15.33,10,13,10,6,3,0
1,0,0,1,1,1,3,30.67,3,276,0.03,23,0.33,15.33,10,13,10,6,3,0
1,0,0,1,1,1,3,30.67,3,276,0.03,23,0.33,15.33,10,13,10,6,3,0
1,0,0,1,1,1,2,27.35,3,246.13,0.03,21,0.33,13.67,9,12,9,6,2,0
1,0,0,1,1,1,3,27.35,3,246.13,0.03,21,0.33,13.67,9,12,9,6,3,0
1,0,0,1,1,1,2,20.97,3,188.72,0.02,17,0.33,10.48,7,10,7,6,2,0
1,0,0,1,1,1,2,20.97,3,188.72,0.02,17,0.33,10.48,7,10,7,6,2,0
1,0,0,1,1,1,2,20.97,3,188.72,0.02,17,0.33,10.48,7,10,7,6,2,0
1,0,0,1,1,1,2,17.92,3,161.32,0.02,15,0.33,8.96,6,9,6,6,2,0
1,0,0,1,1,1,2,17.92,3,161.32,0.02,15,0.33,8.96,6,9,6,6,2,0
1,0,0,1,1,1,2,14.99,3,134.92,0.01,13,0.33,7.5,5,8,5,6,2,0
1,0,0,1,1,1,2,14.99,3,134.92,0.01,13,0.33,7.5,5,8,5,6,2,0
1,0,0,1,1,1,2,14.99,3,134.92,0.01,13,0.33,7.5,5,8,5,6,2,0
1,0,0,1,1,1,2,14.99,3,134.92,0.01,13,0.33,7.5,5,8,5,6,2,0
1,0,0,1,1,1,2,14.99,3,134.92,0.01,13,0.33,7.5,5,8,5,6,2,0
1,0,0,1,1,1,2,17.92,3,161.32,0.02,15,0.33,8.96,6,9,6,6,2,0
1,0,0,1,1,1,2,17.92,3,161.32,0.02,15,0.33,8.96,6,9,6,6,2,0
1,0,0,1,1,1,2,20.97,3,188.72,0.02,17,0.33,10.48,7,10,7,6,2,0
1,0,0,1,1,1,2,20.97,3,188.72,0.02,17,0.33,10.48,7,10,7,6,2,0
1,0,0,1,1,1,1,0,0,0,0,0,0,0,0,0,0,0,1,0
1,0,0,1,1,1,1,0,0,0,0,1,0,0,0,1,0,1,1,0
1,0,0,1,1,1,2,5.33,1.5,12,0,4,0.67,0.67,1,3,1,3,2,0
1,0,0,1,1,1,2,5.33,1.5,12,0,4,0.67,0.67,1,3,1,3,2,0
1,9,0,1,1,1,2,0,0,0,0,9,0,0,9,0,1,0,11,0
1,0,0,1,1,1,1,0,0,0,0,0,0,0,0,0,0,0,1,0
1,0,0,1,1,1,1,0,0,0,0,0,0,0,0,0,0,0,1,0
1,0,0,1,1,1,1,0,0,0,0,1,0,0,0,1,0,1,1,0
1,0,0,1,1,1,4,18.49,2.4,106.51,0.01,14,0.42,5.92,6,8,5,4,4,0
1,0,0,1,1,1,2,5.33,1.5,12,0,4,0.67,0.67,1,3,1,3,2,0
1,0,0,1,1,1,5,8.45,0.75,4.75,0,4,1.33,0.26,3,1,2,1,5,0
1,0,0,1,1,1,1,0,0,0,0,0,0,0,0,0,0,0,1,0
1,0,0,1,1,1,1,0,0,0,0,1,0,0,0,1,0,1,1,0
1,0,0,1,1,1,3,10.8,2.5,67.5,0.01,9,0.4,3.75,3,6,3,5,3,0
1,0,0,1,1,1,2,5.33,1.5,12,0,4,0.67,0.67,1,3,1,3,2,0
1,0,0,1,1,1,2,6.2,2.5,38.77,0.01,6,0.4,2.15,1,5,1,5,2,0
1,0,0,1,1,1,4,9.51,0.5,2.38,0,3,2,0.13,2,1,2,1,4,0
1,0,0,1,1,1,1,0,0,0,0,1,0,0,0,1,0,1,1,0
1,0,0,1,1,1,6,16.68,7.5,938.23,0.04,30,0.13,52.12,12,18,8,10,6,0
1,0,0,1,1,1,2,5.33,1.5,12,0,4,0.67,0.67,1,3,1,3,2,0
1,0,0,1,1,1,2,10.44,3.5,127.89,0.01,11,0.29,7.11,3,8,3,7,2,0
1,0,0,1,1,1,2,10.44,3.5,127.89,0.01,11,0.29,7.11,3,8,3,7,2,0
1,0,0,1,1,1,2,7.49,3,67.38,0.01,8,0.33,3.74,1,7,1,6,2,0
1,0,0,1,1,1,2,9,3,81,0.01,9,0.33,4.5,2,7,2,6,2,0
1,0,0,1,1,1,2,9,3,81,0.01,9,0.33,4.5,2,7,2,6,2,0
1,0,0,1,1,1,2,9,3,81,0.01,9,0.33,4.5,2,7,2,6,2,0
1,0,0,1,1,1,2,10.44,3.5,127.89,0.01,11,0.29,7.11,3,8,3,7,2,0
1,0,0,1,1,1,2,9,3,81,0.01,9,0.33,4.5,2,7,2,6,2,0
1,0,0,1,1,1,2,9,3,81,0.01,9,0.33,4.5,2,7,2,6,2,0
1,0,0,1,1,1,2,7.49,3,67.38,0.01,8,0.33,3.74,1,7,1,6,2,0
1,0,0,1,1,1,2,7.49,3,67.38,0.01,8,0.33,3.74,1,7,1,6,2,0
1,0,0,1,1,1,2,10,3,90,0.01,10,0.33,5,2,8,2,6,2,0
1,0,0,1,1,1,3,10.44,3.5,127.89,0.01,11,0.29,7.11,3,8,3,7,3,0
1,0,0,1,1,1,3,11.39,3.5,139.52,0.01,12,0.29,7.75,3,9,3,7,3,0
1,0,0,1,1,1,2,9,3,81,0.01,9,0.33,4.5,2,7,2,6,2,0
1,0,0,1,1,1,2,10.44,3.5,127.89,0.01,11,0.29,7.11,3,8,3,7,2,0
1,0,0,1,1,1,2,9,3,81,0.01,9,0.33,4.5,2,7,2,6,2,0
1,0,0,1,1,1,2,9,3,81,0.01,9,0.33,4.5,2,7,2,6,2,0
1,0,0,1,1,1,2,10.44,3.5,127.89,0.01,11,0.29,7.11,3,8,3,7,2,0
1,0,0,1,1,1,2,9,3,81,0.01,9,0.33,4.5,2,7,2,6,2,0
1,0,0,1,1,1,2,9,3,81,0.01,9,0.33,4.5,2,7,2,6,2,0
1,0,0,1,1,1,2,9,3,81,0.01,9,0.33,4.5,2,7,2,6,2,0
1,0,0,1,1,1,2,7.49,3,67.38,0.01,8,0.33,3.74,1,7,1,6,2,0
1,0,0,1,1,1,2,9,3,81,0.01,9,0.33,4.5,2,7,2,6,2,0
1,0,0,1,1,1,2,9,3,81,0.01,9,0.33,4.5,2,7,2,6,2,0
1,0,0,1,1,1,2,10.44,3.5,127.89,0.01,11,0.29,7.11,3,8,3,7,2,0
1,0,0,1,1,1,2,9.05,2,36.19,0.01,7,0.5,2,2,5,2,4,2,0
1,0,0,1,1,1,2,9.05,2,36.19,0.01,7,0.5,2,2,5,2,4,2,0
1,0,0,1,1,1,2,9.05,2,36.19,0.01,7,0.5,2,2,5,2,4,2,0
1,0,0,1,1,1,2,9.05,2,36.19,0.01,7,0.5,2,2,5,2,4,2,0
1,0,0,1,1,1,2,9.05,2,36.19,0.01,7,0.5,2,2,5,2,4,2,0
1,0,0,1,1,1,2,9.05,2,36.19,0.01,7,0.5,2,2,5,2,4,2,0
1,0,0,1,1,1,2,9.05,2,36.19,0.01,7,0.5,2,2,5,2,4,2,0
1,0,0,1,1,1,2,9.05,2,36.19,0.01,7,0.5,2,2,5,2,4,2,0
1,0,0,1,1,1,2,9.05,2,36.19,0.01,7,0.5,2,2,5,2,4,2,0
1,0,0,1,1,1,2,9.05,2,36.19,0.01,7,0.5,2,2,5,2,4,2,0
1,0,0,1,1,1,2,9.05,2,36.19,0.01,7,0.5,2,2,5,2,4,2,0
1,0,0,1,1,1,2,9.05,2,36.19,0.01,7,0.5,2,2,5,2,4,2,0
1,0,0,1,1,1,2,9.05,2,36.19,0.01,7,0.5,2,2,5,2,4,2,0
1,0,0,1,1,1,2,10.44,3.5,127.89,0.01,11,0.29,7.11,3,8,3,7,2,0
1,0,0,1,1,1,2,10.44,3.5,127.89,0.01,11,0.29,7.11,3,8,3,7,2,0
1,0,0,1,1,1,2,9.05,2,36.19,0.01,7,0.5,2,2,5,2,4,2,0
1,0,0,1,1,1,0,0,0,0,0,1,0,0,0,1,0,1,0,0
1,0,0,1,1,1,2,5.33,1.5,12,0,4,0.67,0.67,1,3,1,3,2,0
3,0,0,2,1,1,6,11.86,4.38,227.03,0.02,15,0.23,12.61,5,10,4,7,6,0
3,2,0,2,1,1,6,14.43,5.14,381.76,0.02,19,0.19,21.21,9,10,7,8,8,0
5,1,0,3,1,1,10,12.67,10,1267.11,0.04,31,0.1,70.4,14,17,7,10,11,0
3,1,0,2,1,1,6,11.71,4.9,281.06,0.02,16,0.2,15.61,7,9,5,7,7,0
3,1,0,2,1,1,6,11.71,4.9,281.06,0.02,16,0.2,15.61,7,9,5,7,7,0
1,0,0,1,1,1,2,5.33,1.5,12,0,4,0.67,0.67,1,3,1,3,2,0
1,0,0,1,1,1,2,5.33,1.5,12,0,4,0.67,0.67,1,3,1,3,2,0
3,1,0,2,1,1,6,11.23,5.6,352.28,0.02,17,0.18,19.57,7,10,5,8,7,0
7,1,1,4,1,3,13,18.91,10.45,2065.48,0.07,45,0.1,114.75,19,26,10,11,14,0
5,1,0,3,1,1,10,13.33,9,1080,0.04,30,0.11,60,14,16,7,9,11,0
3,1,0,2,1,1,6,11.71,4.9,281.06,0.02,16,0.2,15.61,7,9,5,7,7,0
7,1,1,4,1,3,13,18.91,10.45,2065.48,0.07,45,0.1,114.75,19,26,10,11,14,0
3,1,0,2,1,1,6,11.71,4.9,281.06,0.02,16,0.2,15.61,7,9,5,7,7,0
3,0,0,2,1,1,6,11.86,4.38,227.03,0.02,15,0.23,12.61,5,10,4,7,6,0
3,2,0,2,1,1,7,16.73,5.5,506,0.03,23,0.18,28.11,11,12,8,8,9,0
1,0,0,1,1,1,2,5.33,1.5,12,0,4,0.67,0.67,1,3,1,3,2,0
9,6,0,5,1,1,14,23.12,11.15,2875.94,0.09,57,0.09,159.77,29,28,13,10,20,0
3,1,0,2,1,1,7,14.43,5.14,381.76,0.02,19,0.19,21.21,9,10,7,8,8,0
7,1,1,4,1,3,13,19.62,10,1962.15,0.07,44,0.1,109.01,20,24,11,11,14,0
1,0,0,1,1,1,2,5.33,1.5,12,0,4,0.67,0.67,1,3,1,3,2,0
1,0,0,1,1,1,2,5.33,1.5,12,0,4,0.67,0.67,1,3,1,3,2,0
1,0,0,1,1,1,2,5.33,1.5,12,0,4,0.67,0.67,1,3,1,3,2,0
1,0,0,1,1,1,2,5.33,1.5,12,0,4,0.67,0.67,1,3,1,3,2,0
1,0,0,1,1,1,2,5.33,1.5,12,0,4,0.67,0.67,1,3,1,3,2,0
1,0,0,1,1,1,2,5.33,1.5,12,0,4,0.67,0.67,1,3,1,3,2,0
1,0,0,1,1,1,2,5.33,1.5,12,0,4,0.67,0.67,1,3,1,3,2,0
3,1,0,2,1,1,5,10.95,6,394.38,0.02,19,0.17,21.91,10,9,5,6,6,0
3,1,0,2,1,1,5,10.95,6,394.38,0.02,19,0.17,21.91,10,9,5,6,6,0
3,1,0,2,1,1,5,10.95,6,394.38,0.02,19,0.17,21.91,10,9,5,6,6,0
3,1,0,2,1,1,5,10.95,6,394.38,0.02,19,0.17,21.91,10,9,5,6,6,0
3,1,1,2,1,1,5,10.95,6,394.38,0.02,19,0.17,21.91,10,9,5,6,6,0
1,0,0,1,1,1,3,13,3,117,0.01,13,0.33,6.5,6,7,4,4,3,0
1,0,0,1,1,1,2,11.07,3,99.66,0.01,10,0.33,5.54,4,6,4,6,2,0
1,0,0,1,1,1,2,7.74,1.5,17.41,0,5,0.67,0.97,2,3,2,3,2,0
3,0,1,2,1,1,8,16.92,4.5,342.66,0.03,20,0.22,19.04,9,11,7,7,8,0
3,1,0,2,1,1,7,16.92,4.5,342.66,0.03,20,0.22,19.04,9,11,7,7,8,0
1,0,0,1,1,1,2,11.41,2.5,71.32,0.01,9,0.4,3.96,4,5,4,5,2,0
3,1,0,2,1,1,5,10.95,6,394.38,0.02,19,0.17,21.91,10,9,5,6,6,0
1,0,0,1,1,1,4,16.51,4.8,380.39,0.03,25,0.21,21.13,12,13,5,4,4,0
1,0,0,1,1,1,2,7.74,1.5,17.41,0,5,0.67,0.97,2,3,2,3,2,0
3,1,0,2,1,1,5,10.95,6,394.38,0.02,19,0.17,21.91,10,9,5,6,6,0
3,1,0,2,1,1,5,10.95,6,394.38,0.02,19,0.17,21.91,10,9,5,6,6,0
1,0,0,1,1,1,2,9.83,2,39.3,0.01,7,0.5,2.18,3,4,3,4,2,0
1,0,0,1,1,1,1,0,0,0,0,1,0,0,0,1,0,1,1,0
1,0,0,1,1,1,1,0,0,0,0,1,0,0,0,1,0,1,1,0
1,0,0,1,1,1,0,0,0,0,0,1,0,0,0,1,0,1,0,0
5,0,0,3,1,1,2,13.29,4.5,269.08,0.02,18,0.22,14.95,6,12,4,6,2,0
1,0,1,1,1,1,2,16.92,3.5,207.22,0.02,16,0.29,11.51,6,10,6,7,2,0
7,0,1,4,1,1,19,19.8,7.5,1113.65,0.05,39,0.13,61.87,15,24,7,7,19,0
9,0,1,5,1,1,19,7.06,24,4068.29,0.06,49,0.04,226.02,18,31,3,8,19,0
35,1,14,19,1,19,34,18.02,30.46,16720.16,0.18,113,0.03,928.9,43,70,12,17,35,0
35,0,26,18,5,17,44,34.71,42.41,62427.13,0.49,265,0.02,3468.17,125,140,28,19,44,1
7,1,9,5,2,1,25,28.17,13.47,5114.17,0.13,74,0.07,284.12,32,42,19,16,26,0
5,0,3,3,1,3,12,20.14,10.5,2220.96,0.07,45,0.1,123.39,21,24,13,13,12,0
27,0,9,14,1,14,23,34.52,23.12,18451.22,0.27,148,0.04,1025.06,68,80,25,17,23,0
5,0,6,3,1,3,10,17.2,6.67,764.63,0.04,27,0.15,42.48,12,15,9,10,10,1
1,0,0,1,1,1,2,5.33,1.5,12,0,4,0.67,0.67,1,3,1,3,2,0
1,0,0,1,1,1,2,5.33,1.5,12,0,4,0.67,0.67,1,3,1,3,2,0
1,0,0,1,1,1,2,0,0,0,0,4,0,0,0,4,0,4,2,0
1,0,0,1,1,1,0,0,0,0,0,5,0,0,0,5,0,5,0,0
1,0,0,1,1,1,0,0,0,0,0,5,0,0,0,5,0,5,0,0
1,0,0,1,1,1,1,0,0,0,0,1,0,0,0,1,0,1,1,0
1,0,0,1,1,1,2,0,0,0,0,5,0,0,0,5,0,5,2,0
1,0,0,1,1,1,2,20.97,3,188.72,0.02,17,0.33,10.48,7,10,7,6,2,0
1,0,0,1,1,1,2,20.97,3,188.72,0.02,17,0.33,10.48,7,10,7,6,2,0
1,0,0,1,1,1,2,27.35,3,246.13,0.03,21,0.33,13.67,9,12,9,6,2,0
1,0,0,1,1,1,3,30.67,3,276,0.03,23,0.33,15.33,10,13,10,6,3,0
1,0,0,1,1,1,3,30.67,3,276,0.03,23,0.33,15.33,10,13,10,6,3,0
1,0,0,1,1,1,3,30.67,3,276,0.03,23,0.33,15.33,10,13,10,6,3,0
1,0,0,1,1,1,2,27.35,3,246.13,0.03,21,0.33,13.67,9,12,9,6,2,0
1,0,0,1,1,1,3,27.35,3,246.13,0.03,21,0.33,13.67,9,12,9,6,3,0
1,0,0,1,1,1,2,20.97,3,188.72,0.02,17,0.33,10.48,7,10,7,6,2,0
1,0,0,1,1,1,2,20.97,3,188.72,0.02,17,0.33,10.48,7,10,7,6,2,0
1,0,0,1,1,1,2,20.97,3,188.72,0.02,17,0.33,10.48,7,10,7,6,2,0
1,0,0,1,1,1,2,17.92,3,161.32,0.02,15,0.33,8.96,6,9,6,6,2,0
1,0,0,1,1,1,2,17.92,3,161.32,0.02,15,0.33,8.96,6,9,6,6,2,0
1,0,0,1,1,1,2,14.99,3,134.92,0.01,13,0.33,7.5,5,8,5,6,2,0
1,0,0,1,1,1,2,14.99,3,134.92,0.01,13,0.33,7.5,5,8,5,6,2,0
1,0,0,1,1,1,2,14.99,3,134.92,0.01,13,0.33,7.5,5,8,5,6,2,0
1,0,0,1,1,1,2,14.99,3,134.92,0.01,13,0.33,7.5,5,8,5,6,2,0
1,0,0,1,1,1,2,14.99,3,134.92,0.01,13,0.33,7.5,5,8,5,6,2,0
1,0,0,1,1,1,2,17.92,3,161.32,0.02,15,0.33,8.96,6,9,6,6,2,0
1,0,0,1,1,1,2,17.92,3,161.32,0.02,15,0.33,8.96,6,9,6,6,2,0
1,0,0,1,1,1,2,20.97,3,188.72,0.02,17,0.33,10.48,7,10,7,6,2,0
1,0,0,1,1,1,2,20.97,3,188.72,0.02,17,0.33,10.48,7,10,7,6,2,0
1,0,0,1,1,1,1,0,0,0,0,1,0,0,0,1,0,1,1,0
1,0,0,1,1,1,2,5.33,1.5,12,0,4,0.67,0.67,1,3,1,3,2,0
1,0,0,1,1,1,2,5.33,1.5,12,0,4,0.67,0.67,1,3,1,3,2,0
1,0,0,1,1,1,2,0,0,0,0,4,0,0,0,4,0,4,2,0
1,0,0,1,1,1,1,0,0,0,0,1,0,0,0,1,0,1,1,0
1,0,0,1,1,1,2,0,0,0,0,5,0,0,0,5,0,5,2,0
1,0,0,1,1,1,1,0,0,0,0,1,0,0,0,1,0,1,1,0
1,0,0,1,1,1,2,5.33,1.5,12,0,4,0.67,0.67,1,3,1,3,2,0
1,0,0,1,1,1,2,5.33,1.5,12,0,4,0.67,0.67,1,3,1,3,2,0
1,0,0,1,1,1,1,0,0,0,0,1,0,0,0,1,0,1,1,0
1,0,0,1,1,1,6,16.68,7.5,938.23,0.04,30,0.13,52.12,12,18,8,10,6,0
1,0,0,1,1,1,2,5.33,1.5,12,0,4,0.67,0.67,1,3,1,3,2,0
1,0,0,1,1,1,2,10.44,3.5,127.89,0.01,11,0.29,7.11,3,8,3,7,2,0
1,0,0,1,1,1,1,0,0,0,0,1,0,0,0,1,0,1,1,0
1,0,0,1,1,1,1,0,0,0,0,1,0,0,0,1,0,1,1,0
1,0,0,1,1,1,1,0,0,0,0,1,0,0,0,1,0,1,1,0
1,0,0,1,1,1,1,0,0,0,0,1,0,0,0,1,0,1,1,0
1,0,0,1,1,1,1,0,0,0,0,1,0,0,0,1,0,1,1,0
1,0,0,1,1,1,1,0,0,0,0,1,0,0,0,1,0,1,1,0
1,0,0,1,1,1,0,0,0,0,0,1,0,0,0,1,0,1,0,0
1,0,0,1,1,1,0,0,0,0,0,1,0,0,0,1,0,1,0,0
1,0,0,1,1,1,2,0,0,0,0,3,0,0,0,3,0,3,2,0
1,0,0,1,1,1,2,0,0,0,0,3,0,0,0,3,0,3,2,0
1,0,0,1,1,1,2,0,0,0,0,3,0,0,0,3,0,3,2,0
1,0,0,1,1,1,2,0,0,0,0,3,0,0,0,3,0,3,2,0
1,0,0,1,1,1,2,0,0,0,0,3,0,0,0,3,0,3,2,0
1,0,0,1,1,1,2,0,0,0,0,3,0,0,0,3,0,3,2,0
1,0,0,1,1,1,2,0,0,0,0,3,0,0,0,3,0,3,2,0
1,0,0,1,1,1,2,0,0,0,0,3,0,0,0,3,0,3,2,0
1,0,0,1,1,1,2,0,0,0,0,3,0,0,0,3,0,3,2,0
1,0,0,1,1,1,2,0,0,0,0,3,0,0,0,3,0,3,2,0
1,0,0,1,1,1,2,0,0,0,0,3,0,0,0,3,0,3,2,0
1,0,0,1,1,1,3,11.63,2,46.53,0.01,9,0.5,2.58,4,5,3,3,3,0
1,0,0,1,1,1,0,5.33,1.5,12,0,4,0.67,0.67,1,3,1,3,0,0
1,0,0,1,1,1,0,5.33,1.5,12,0,4,0.67,0.67,1,3,1,3,0,0
1,0,0,1,1,1,0,5.33,1.5,12,0,4,0.67,0.67,1,3,1,3,0,0
1,0,0,1,1,1,2,0,0,0,0,3,0,0,0,3,0,3,2,0
1,0,0,1,1,1,2,5.33,1.5,12,0,4,0.67,0.67,1,3,1,3,2,0
1,0,0,1,1,1,2,0,0,0,0,3,0,0,0,3,0,3,2,0
1,0,0,1,1,1,2,0,0,0,0,3,0,0,0,3,0,3,2,0
1,0,0,1,1,1,2,0,0,0,0,3,0,0,0,3,0,3,2,0
1,0,0,1,1,1,2,0,0,0,0,3,0,0,0,3,0,3,2,0
1,0,0,1,1,1,2,0,0,0,0,3,0,0,0,3,0,3,2,0
1,0,0,1,1,1,2,0,0,0,0,3,0,0,0,3,0,3,2,0
1,0,0,1,1,1,2,0,0,0,0,3,0,0,0,3,0,3,2,0
1,0,0,1,1,1,2,0,0,0,0,3,0,0,0,3,0,3,2,0
1,0,0,1,1,1,2,0,0,0,0,3,0,0,0,3,0,3,2,0
1,0,0,1,1,1,2,0,0,0,0,3,0,0,0,3,0,3,2,0
1,0,0,1,1,1,2,0,0,0,0,3,0,0,0,3,0,3,2,0
1,0,0,1,1,1,0,7.74,1.5,17.41,0,5,0.67,0.97,2,3,2,3,0,0
1,0,0,1,1,1,0,7.74,1.5,17.41,0,5,0.67,0.97,2,3,2,3,0,0
1,0,0,1,1,1,0,0,0,0,0,3,0,0,0,3,0,3,0,0
1,0,0,1,1,1,0,5.33,1.5,12,0,4,0.67,0.67,1,3,1,3,0,0
1,0,0,1,1,1,2,0,0,0,0,3,0,0,0,3,0,3,2,0
1,0,0,1,1,1,2,0,0,0,0,3,0,0,0,3,0,3,2,0
1,0,0,1,1,1,2,0,0,0,0,3,0,0,0,3,0,3,2,0
1,0,0,1,1,1,2,0,0,0,0,3,0,0,0,3,0,3,2,0
1,0,0,1,1,1,2,0,0,0,0,3,0,0,0,3,0,3,2,0
1,0,0,1,1,1,2,0,0,0,0,3,0,0,0,3,0,3,2,0
1,0,0,1,1,1,2,0,0,0,0,3,0,0,0,3,0,3,2,0
1,0,0,1,1,1,2,0,0,0,0,3,0,0,0,3,0,3,2,0
1,0,0,1,1,1,2,0,0,0,0,3,0,0,0,3,0,3,2,0
1,0,0,1,1,1,2,0,0,0,0,3,0,0,0,3,0,3,2,0
1,0,0,1,1,1,2,0,0,0,0,3,0,0,0,3,0,3,2,0
5,0,5,3,1,1,7,13.32,13.71,2505.06,0.06,43,0.07,139.17,16,27,7,12,7,0
5,0,5,3,1,1,7,13.32,13.71,2505.06,0.06,43,0.07,139.17,16,27,7,12,7,0
1,0,0,1,1,1,0,0,0,0,0,1,0,0,0,1,0,1,0,0
295,2,69,150,54,56,807,104.51,282.61,8346698.06,9.84,4247,0,463705.47,1625,2622,92,32,809,1
1,0,1,1,1,1,11,14.11,12.5,2205.39,0.06,51,0.08,122.52,30,21,6,5,11,1
11,0,0,7,7,1,35,38.04,17.93,12235.66,0.23,130,0.06,679.76,55,75,23,15,35,1
29,1,8,15,5,9,66,41.35,34,47798.56,0.47,238,0.03,2655.48,102,136,36,24,67,1
49,1,4,25,21,1,159,71.56,61.82,273481.56,1.47,717,0.02,15193.42,281,436,50,22,160,1
1,1,2,1,1,1,13,32.5,11.43,4244.37,0.12,81,0.09,235.8,32,49,14,10,14,1
111,2,161,56,26,31,517,431.57,72.36,2259445.07,10.41,4013,0.01,125524.73,1624,2389,202,18,519,1
159,50,46,105,89,14,578,55.39,347.12,6674292.65,6.41,2535,0,370794.05,1083,1452,117,75,628,1
153,39,14,102,17,32,308,46.77,132.28,818318.31,2.06,847,0.01,45462.13,316,531,86,72,347,1
17,0,0,9,3,8,22,23.07,16.69,6428.97,0.13,81,0.06,357.17,31,50,13,14,22,1
9,2,1,8,1,1,27,34.09,9.88,3329.22,0.11,68,0.1,184.96,24,44,17,14,29,0
3,0,1,2,1,1,2,12.09,6.3,479.73,0.03,20,0.16,26.65,7,13,5,9,2,0
1,0,0,1,1,1,2,5.33,1.5,12,0,4,0.67,0.67,1,3,1,3,2,0
1,0,0,1,1,1,2,5.33,1.5,12,0,4,0.67,0.67,1,3,1,3,2,0
1,0,0,1,1,1,2,5.33,1.5,12,0,4,0.67,0.67,1,3,1,3,2,0
1,0,0,1,1,1,2,5.33,1.5,12,0,4,0.67,0.67,1,3,1,3,2,0
1,0,0,1,1,1,2,5.33,1.5,12,0,4,0.67,0.67,1,3,1,3,2,0
1,0,0,1,1,1,2,5.33,1.5,12,0,4,0.67,0.67,1,3,1,3,2,0
1,0,0,1,1,1,2,5.33,1.5,12,0,4,0.67,0.67,1,3,1,3,2,0
1,0,0,1,1,1,2,5.33,1.5,12,0,4,0.67,0.67,1,3,1,3,2,0
1,0,0,1,1,1,2,5.33,1.5,12,0,4,0.67,0.67,1,3,1,3,2,0
1,0,0,1,1,1,2,0,0,0,0,4,0,0,0,4,0,4,2,0
1,0,0,1,1,1,0,0,0,0,0,5,0,0,0,5,0,5,0,0
1,0,0,1,1,1,0,0,0,0,0,5,0,0,0,5,0,5,0,0
1,0,0,1,1,1,1,0,0,0,0,1,0,0,0,1,0,1,1,0
1,0,0,1,1,1,2,0,0,0,0,5,0,0,0,5,0,5,2,0
11,1,4,6,1,1,21,13.86,22.5,7014.99,0.1,68,0.04,389.72,27,41,9,15,22,0
1,0,0,1,1,1,2,20.97,3,188.72,0.02,17,0.33,10.48,7,10,7,6,2,0
1,0,0,1,1,1,2,20.97,3,188.72,0.02,17,0.33,10.48,7,10,7,6,2,0
1,0,0,1,1,1,2,27.35,3,246.13,0.03,21,0.33,13.67,9,12,9,6,2,0
1,0,0,1,1,1,3,30.67,3,276,0.03,23,0.33,15.33,10,13,10,6,3,0
1,0,0,1,1,1,3,30.67,3,276,0.03,23,0.33,15.33,10,13,10,6,3,0
1,0,0,1,1,1,3,30.67,3,276,0.03,23,0.33,15.33,10,13,10,6,3,0
1,0,0,1,1,1,2,27.35,3,246.13,0.03,21,0.33,13.67,9,12,9,6,2,0
1,0,0,1,1,1,3,27.35,3,246.13,0.03,21,0.33,13.67,9,12,9,6,3,0
1,0,0,1,1,1,2,20.97,3,188.72,0.02,17,0.33,10.48,7,10,7,6,2,0
1,0,0,1,1,1,2,20.97,3,188.72,0.02,17,0.33,10.48,7,10,7,6,2,0
1,0,0,1,1,1,2,20.97,3,188.72,0.02,17,0.33,10.48,7,10,7,6,2,0
1,0,0,1,1,1,2,17.92,3,161.32,0.02,15,0.33,8.96,6,9,6,6,2,0
1,0,0,1,1,1,2,17.92,3,161.32,0.02,15,0.33,8.96,6,9,6,6,2,0
1,0,0,1,1,1,2,14.99,3,134.92,0.01,13,0.33,7.5,5,8,5,6,2,0
1,0,0,1,1,1,2,14.99,3,134.92,0.01,13,0.33,7.5,5,8,5,6,2,0
1,0,0,1,1,1,2,14.99,3,134.92,0.01,13,0.33,7.5,5,8,5,6,2,0
1,0,0,1,1,1,2,14.99,3,134.92,0.01,13,0.33,7.5,5,8,5,6,2,0
1,0,0,1,1,1,2,14.99,3,134.92,0.01,13,0.33,7.5,5,8,5,6,2,0
1,0,0,1,1,1,2,17.92,3,161.32,0.02,15,0.33,8.96,6,9,6,6,2,0
1,0,0,1,1,1,2,17.92,3,161.32,0.02,15,0.33,8.96,6,9,6,6,2,0
1,0,0,1,1,1,2,20.97,3,188.72,0.02,17,0.33,10.48,7,10,7,6,2,0
1,0,0,1,1,1,2,20.97,3,188.72,0.02,17,0.33,10.48,7,10,7,6,2,0
1,0,0,1,1,1,1,0,0,0,0,0,0,0,0,0,0,0,1,0
1,0,0,1,1,1,1,0,0,0,0,1,0,0,0,1,0,1,1,0
1,0,0,1,1,1,2,5.33,1.5,12,0,4,0.67,0.67,1,3,1,3,2,0
1,0,0,1,1,1,2,5.33,1.5,12,0,4,0.67,0.67,1,3,1,3,2,0
1,9,0,1,1,1,2,0,0,0,0,9,0,0,9,0,1,0,11,0
1,0,0,1,1,1,1,0,0,0,0,0,0,0,0,0,0,0,1,0
1,0,0,1,1,1,1,0,0,0,0,0,0,0,0,0,0,0,1,0
1,0,0,1,1,1,1,0,0,0,0,1,0,0,0,1,0,1,1,0
1,0,0,1,1,1,4,18.49,2.4,106.51,0.01,14,0.42,5.92,6,8,5,4,4,0
1,0,0,1,1,1,2,5.33,1.5,12,0,4,0.67,0.67,1,3,1,3,2,0
1,0,0,1,1,1,5,8.45,0.75,4.75,0,4,1.33,0.26,3,1,2,1,5,0
1,0,0,1,1,1,1,0,0,0,0,0,0,0,0,0,0,0,1,0
1,0,0,1,1,1,1,0,0,0,0,1,0,0,0,1,0,1,1,0
1,0,0,1,1,1,3,10.8,2.5,67.5,0.01,9,0.4,3.75,3,6,3,5,3,0
1,0,0,1,1,1,2,5.33,1.5,12,0,4,0.67,0.67,1,3,1,3,2,0
1,0,0,1,1,1,2,6.2,2.5,38.77,0.01,6,0.4,2.15,1,5,1,5,2,0
1,0,0,1,1,1,4,9.51,0.5,2.38,0,3,2,0.13,2,1,2,1,4,0
1,0,0,1,1,1,1,0,0,0,0,1,0,0,0,1,0,1,1,0
1,0,0,1,1,1,2,5.33,1.5,12,0,4,0.67,0.67,1,3,1,3,2,0
1,0,0,1,1,1,2,5.33,1.5,12,0,4,0.67,0.67,1,3,1,3,2,0
1,0,0,1,1,1,2,0,0,0,0,4,0,0,0,4,0,4,2,0
1,0,0,1,1,1,1,0,0,0,0,1,0,0,0,1,0,1,1,0
1,0,0,1,1,1,2,0,0,0,0,5,0,0,0,5,0,5,2,0
1,0,0,1,1,1,1,0,0,0,0,1,0,0,0,1,0,1,1,0
1,0,0,1,1,1,2,5.33,1.5,12,0,4,0.67,0.67,1,3,1,3,2,0
1,0,0,1,1,1,2,5.33,1.5,12,0,4,0.67,0.67,1,3,1,3,2,0
1,0,0,1,1,1,1,0,0,0,0,1,0,0,0,1,0,1,1,0
1,0,0,1,1,1,6,16.68,7.5,938.23,0.04,30,0.13,52.12,12,18,8,10,6,0
1,0,0,1,1,1,2,5.33,1.5,12,0,4,0.67,0.67,1,3,1,3,2,0
1,0,0,1,1,1,2,10.44,3.5,127.89,0.01,11,0.29,7.11,3,8,3,7,2,0
1,0,0,1,1,1,1,0,0,0,0,1,0,0,0,1,0,1,1,0
1,0,0,1,1,1,1,0,0,0,0,1,0,0,0,1,0,1,1,0
1,0,0,1,1,1,1,0,0,0,0,1,0,0,0,1,0,1,1,0
1,0,0,1,1,1,1,0,0,0,0,1,0,0,0,1,0,1,1,0
1,0,0,1,1,1,1,0,0,0,0,1,0,0,0,1,0,1,1,0
1,0,0,1,1,1,1,0,0,0,0,1,0,0,0,1,0,1,1,0
1,0,0,1,1,1,0,0,0,0,0,1,0,0,0,1,0,1,0,0
1,0,0,1,1,1,0,0,0,0,0,1,0,0,0,1,0,1,0,0
1,0,0,1,1,1,2,0,0,0,0,3,0,0,0,3,0,3,2,0
1,0,0,1,1,1,2,0,0,0,0,3,0,0,0,3,0,3,2,0
1,0,0,1,1,1,2,0,0,0,0,3,0,0,0,3,0,3,2,0
1,0,0,1,1,1,2,0,0,0,0,3,0,0,0,3,0,3,2,0
1,0,0,1,1,1,2,0,0,0,0,3,0,0,0,3,0,3,2,0
1,0,0,1,1,1,2,0,0,0,0,3,0,0,0,3,0,3,2,0
1,0,0,1,1,1,2,0,0,0,0,3,0,0,0,3,0,3,2,0
1,0,0,1,1,1,2,0,0,0,0,3,0,0,0,3,0,3,2,0
1,0,0,1,1,1,2,0,0,0,0,3,0,0,0,3,0,3,2,0
1,0,0,1,1,1,2,0,0,0,0,3,0,0,0,3,0,3,2,0
1,0,0,1,1,1,2,0,0,0,0,3,0,0,0,3,0,3,2,0
1,0,0,1,1,1,3,11.63,2,46.53,0.01,9,0.5,2.58,4,5,3,3,3,0
1,0,0,1,1,1,0,5.33,1.5,12,0,4,0.67,0.67,1,3,1,3,0,0
1,0,0,1,1,1,0,5.33,1.5,12,0,4,0.67,0.67,1,3,1,3,0,0
1,0,0,1,1,1,0,5.33,1.5,12,0,4,0.67,0.67,1,3,1,3,0,0
1,0,0,1,1,1,2,0,0,0,0,3,0,0,0,3,0,3,2,0
1,0,0,1,1,1,2,5.33,1.5,12,0,4,0.67,0.67,1,3,1,3,2,0
1,0,0,1,1,1,2,0,0,0,0,3,0,0,0,3,0,3,2,0
1,0,0,1,1,1,2,0,0,0,0,3,0,0,0,3,0,3,2,0
1,0,0,1,1,1,2,0,0,0,0,3,0,0,0,3,0,3,2,0
1,0,0,1,1,1,2,0,0,0,0,3,0,0,0,3,0,3,2,0
1,0,0,1,1,1,2,0,0,0,0,3,0,0,0,3,0,3,2,0
1,0,0,1,1,1,2,0,0,0,0,3,0,0,0,3,0,3,2,0
1,0,0,1,1,1,2,0,0,0,0,3,0,0,0,3,0,3,2,0
1,0,0,1,1,1,2,0,0,0,0,3,0,0,0,3,0,3,2,0
1,0,0,1,1,1,2,0,0,0,0,3,0,0,0,3,0,3,2,0
1,0,0,1,1,1,2,0,0,0,0,3,0,0,0,3,0,3,2,0
1,0,0,1,1,1,2,0,0,0,0,3,0,0,0,3,0,3,2,0
1,0,0,1,1,1,0,7.74,1.5,17.41,0,5,0.67,0.97,2,3,2,3,0,0
1,0,0,1,1,1,0,7.74,1.5,17.41,0,5,0.67,0.97,2,3,2,3,0,0
1,0,0,1,1,1,0,0,0,0,0,3,0,0,0,3,0,3,0,0
1,0,0,1,1,1,0,5.33,1.5,12,0,4,0.67,0.67,1,3,1,3,0,0
1,0,0,1,1,1,2,0,0,0,0,3,0,0,0,3,0,3,2,0
1,0,0,1,1,1,2,0,0,0,0,3,0,0,0,3,0,3,2,0
1,0,0,1,1,1,2,0,0,0,0,3,0,0,0,3,0,3,2,0
1,0,0,1,1,1,2,0,0,0,0,3,0,0,0,3,0,3,2,0
1,0,0,1,1,1,2,0,0,0,0,3,0,0,0,3,0,3,2,0
1,0,0,1,1,1,2,0,0,0,0,3,0,0,0,3,0,3,2,0
1,0,0,1,1,1,2,0,0,0,0,3,0,0,0,3,0,3,2,0
1,0,0,1,1,1,2,0,0,0,0,3,0,0,0,3,0,3,2,0
1,0,0,1,1,1,2,0,0,0,0,3,0,0,0,3,0,3,2,0
1,0,0,1,1,1,2,0,0,0,0,3,0,0,0,3,0,3,2,0
1,0,0,1,1,1,2,0,0,0,0,3,0,0,0,3,0,3,2,0
5,0,5,3,1,1,7,13.32,13.71,2505.06,0.06,43,0.07,139.17,16,27,7,12,7,0
5,0,5,3,1,1,7,13.32,13.71,2505.06,0.06,43,0.07,139.17,16,27,7,12,7,0
1,0,0,1,1,1,0,0,0,0,0,1,0,0,0,1,0,1,0,0
35,7,61,18,9,15,190,65.25,80.64,424289.82,1.75,906,0.01,23571.66,370,536,39,17,197,1
1,0,0,1,1,1,25,37.87,17.5,11598.34,0.22,141,0.06,644.35,56,85,16,10,25,1
12,1,10,7,7,1,41,37.15,19.83,14600.75,0.25,146,0.05,811.15,61,85,20,13,42,1
124,4,21,68,35,62,281,66.35,98.31,641239.74,2.17,960,0.01,35624.43,349,611,71,40,285,1
54,2,20,30,23,9,130,64.2,45.08,130474.63,0.96,454,0.02,7248.59,187,267,56,27,132,1
1,0,1,1,1,1,17,35.89,18.75,12619.31,0.22,140,0.05,701.07,50,90,16,12,17,1
14,1,16,8,2,1,46,22.12,27.14,16294.42,0.2,118,0.04,905.25,38,80,14,20,47,1
3,0,10,2,2,1,50,21.49,37,29423.69,0.27,184,0.03,1634.65,74,110,10,10,50,1
1,0,8,1,1,1,30,19.83,24,11424,0.16,119,0.04,634.67,48,71,8,8,30,0
3,0,15,2,2,1,181,13.26,258.32,884783.14,1.14,747,0,49154.62,310,437,9,15,181,0
17,1,18,10,2,1,55,23.14,31.5,22962.22,0.24,141,0.03,1275.68,45,96,15,21,56,1
7,2,20,4,2,1,34,23.57,20.73,10126.2,0.16,108,0.05,562.57,38,70,11,12,36,1
31,1,79,16,9,9,255,249.2,41.5,429280.53,3.45,1466,0.02,23848.92,607,859,117,16,256,1
42,16,29,29,23,1,135,58.76,51.27,154440,1,470,0.02,8580,198,272,56,29,151,1
13,11,10,8,4,7,29,27.89,20,11157.6,0.19,101,0.05,619.87,40,61,23,23,40,0
9,2,1,8,1,1,27,34.09,9.88,3329.22,0.11,68,0.1,184.96,24,44,17,14,29,0
3,0,1,2,1,1,2,12.09,6.3,479.73,0.03,20,0.16,26.65,7,13,5,9,2,0
1,0,0,1,1,1,2,5.33,1.5,12,0,4,0.67,0.67,1,3,1,3,2,0
1,0,0,1,1,1,2,5.33,1.5,12,0,4,0.67,0.67,1,3,1,3,2,0
1,0,0,1,1,1,2,5.33,1.5,12,0,4,0.67,0.67,1,3,1,3,2,0
1,0,0,1,1,1,2,5.33,1.5,12,0,4,0.67,0.67,1,3,1,3,2,0
1,0,0,1,1,1,2,5.33,1.5,12,0,4,0.67,0.67,1,3,1,3,2,0
1,0,0,1,1,1,2,5.33,1.5,12,0,4,0.67,0.67,1,3,1,3,2,0
1,0,0,1,1,1,2,5.33,1.5,12,0,4,0.67,0.67,1,3,1,3,2,0
1,0,0,1,1,1,2,5.33,1.5,12,0,4,0.67,0.67,1,3,1,3,2,0
1,0,0,1,1,1,2,5.33,1.5,12,0,4,0.67,0.67,1,3,1,3,2,0
1,0,0,1,1,1,2,0,0,0,0,4,0,0,0,4,0,4,2,0
1,0,0,1,1,1,0,0,0,0,0,5,0,0,0,5,0,5,0,0
1,0,0,1,1,1,0,0,0,0,0,5,0,0,0,5,0,5,0,0
1,0,0,1,1,1,1,0,0,0,0,1,0,0,0,1,0,1,1,0
1,0,0,1,1,1,2,0,0,0,0,5,0,0,0,5,0,5,2,0
11,1,4,6,1,1,21,13.86,22.5,7014.99,0.1,68,0.04,389.72,27,41,9,15,22,0
1,0,0,1,1,1,2,20.97,3,188.72,0.02,17,0.33,10.48,7,10,7,6,2,0
1,0,0,1,1,1,2,20.97,3,188.72,0.02,17,0.33,10.48,7,10,7,6,2,0
1,0,0,1,1,1,2,27.35,3,246.13,0.03,21,0.33,13.67,9,12,9,6,2,0
1,0,0,1,1,1,3,30.67,3,276,0.03,23,0.33,15.33,10,13,10,6,3,0
1,0,0,1,1,1,3,30.67,3,276,0.03,23,0.33,15.33,10,13,10,6,3,0
1,0,0,1,1,1,3,30.67,3,276,0.03,23,0.33,15.33,10,13,10,6,3,0
1,0,0,1,1,1,2,27.35,3,246.13,0.03,21,0.33,13.67,9,12,9,6,2,0
1,0,0,1,1,1,3,27.35,3,246.13,0.03,21,0.33,13.67,9,12,9,6,3,0
1,0,0,1,1,1,2,20.97,3,188.72,0.02,17,0.33,10.48,7,10,7,6,2,0
1,0,0,1,1,1,2,20.97,3,188.72,0.02,17,0.33,10.48,7,10,7,6,2,0
1,0,0,1,1,1,2,20.97,3,188.72,0.02,17,0.33,10.48,7,10,7,6,2,0
1,0,0,1,1,1,2,17.92,3,161.32,0.02,15,0.33,8.96,6,9,6,6,2,0
1,0,0,1,1,1,2,17.92,3,161.32,0.02,15,0.33,8.96,6,9,6,6,2,0
1,0,0,1,1,1,2,14.99,3,134.92,0.01,13,0.33,7.5,5,8,5,6,2,0
1,0,0,1,1,1,2,14.99,3,134.92,0.01,13,0.33,7.5,5,8,5,6,2,0
1,0,0,1,1,1,2,14.99,3,134.92,0.01,13,0.33,7.5,5,8,5,6,2,0
1,0,0,1,1,1,2,14.99,3,134.92,0.01,13,0.33,7.5,5,8,5,6,2,0
1,0,0,1,1,1,2,14.99,3,134.92,0.01,13,0.33,7.5,5,8,5,6,2,0
1,0,0,1,1,1,2,17.92,3,161.32,0.02,15,0.33,8.96,6,9,6,6,2,0
1,0,0,1,1,1,2,17.92,3,161.32,0.02,15,0.33,8.96,6,9,6,6,2,0
1,0,0,1,1,1,2,20.97,3,188.72,0.02,17,0.33,10.48,7,10,7,6,2,0
1,0,0,1,1,1,2,20.97,3,188.72,0.02,17,0.33,10.48,7,10,7,6,2,0
1,0,0,1,1,1,1,0,0,0,0,0,0,0,0,0,0,0,1,0
1,0,0,1,1,1,1,0,0,0,0,1,0,0,0,1,0,1,1,0
1,0,0,1,1,1,2,5.33,1.5,12,0,4,0.67,0.67,1,3,1,3,2,0
1,0,0,1,1,1,2,5.33,1.5,12,0,4,0.67,0.67,1,3,1,3,2,0
1,9,0,1,1,1,2,0,0,0,0,9,0,0,9,0,1,0,11,0
1,0,0,1,1,1,1,0,0,0,0,0,0,0,0,0,0,0,1,0
1,0,0,1,1,1,1,0,0,0,0,0,0,0,0,0,0,0,1,0
1,0,0,1,1,1,1,0,0,0,0,1,0,0,0,1,0,1,1,0
1,0,0,1,1,1,4,18.49,2.4,106.51,0.01,14,0.42,5.92,6,8,5,4,4,0
1,0,0,1,1,1,2,5.33,1.5,12,0,4,0.67,0.67,1,3,1,3,2,0
1,0,0,1,1,1,5,8.45,0.75,4.75,0,4,1.33,0.26,3,1,2,1,5,0
1,0,0,1,1,1,1,0,0,0,0,0,0,0,0,0,0,0,1,0
1,0,0,1,1,1,1,0,0,0,0,1,0,0,0,1,0,1,1,0
1,0,0,1,1,1,3,10.8,2.5,67.5,0.01,9,0.4,3.75,3,6,3,5,3,0
1,0,0,1,1,1,2,5.33,1.5,12,0,4,0.67,0.67,1,3,1,3,2,0
1,0,0,1,1,1,2,6.2,2.5,38.77,0.01,6,0.4,2.15,1,5,1,5,2,0
1,0,0,1,1,1,4,9.51,0.5,2.38,0,3,2,0.13,2,1,2,1,4,0
1,0,0,1,1,1,1,0,0,0,0,1,0,0,0,1,0,1,1,0
1,0,0,1,1,1,2,5.33,1.5,12,0,4,0.67,0.67,1,3,1,3,2,0
1,0,0,1,1,1,2,5.33,1.5,12,0,4,0.67,0.67,1,3,1,3,2,0
1,0,0,1,1,1,2,0,0,0,0,4,0,0,0,4,0,4,2,0
1,0,0,1,1,1,1,0,0,0,0,1,0,0,0,1,0,1,1,0
1,0,0,1,1,1,2,0,0,0,0,5,0,0,0,5,0,5,2,0
1,0,0,1,1,1,1,0,0,0,0,1,0,0,0,1,0,1,1,0
1,0,0,1,1,1,2,5.33,1.5,12,0,4,0.67,0.67,1,3,1,3,2,0
1,0,0,1,1,1,2,5.33,1.5,12,0,4,0.67,0.67,1,3,1,3,2,0
1,0,0,1,1,1,1,0,0,0,0,1,0,0,0,1,0,1,1,0
1,0,0,1,1,1,6,16.68,7.5,938.23,0.04,30,0.13,52.12,12,18,8,10,6,0
1,0,0,1,1,1,2,5.33,1.5,12,0,4,0.67,0.67,1,3,1,3,2,0
1,0,0,1,1,1,2,10.44,3.5,127.89,0.01,11,0.29,7.11,3,8,3,7,2,0
1,0,0,1,1,1,1,0,0,0,0,1,0,0,0,1,0,1,1,0
1,0,0,1,1,1,1,0,0,0,0,1,0,0,0,1,0,1,1,0
1,0,0,1,1,1,1,0,0,0,0,1,0,0,0,1,0,1,1,0
1,0,0,1,1,1,1,0,0,0,0,1,0,0,0,1,0,1,1,0
1,0,0,1,1,1,0,0,0,0,0,1,0,0,0,1,0,1,0,0
5,0,0,3,1,1,2,13.29,4.5,269.08,0.02,18,0.22,14.95,6,12,4,6,2,0
1,0,1,1,1,1,2,16.92,3.5,207.22,0.02,16,0.29,11.51,6,10,6,7,2,0
1,0,0,1,1,1,0,0,0,0,0,1,0,0,0,1,0,1,0,0
1,0,0,1,1,1,2,0,0,0,0,3,0,0,0,3,0,3,2,0
1,0,0,1,1,1,2,0,0,0,0,3,0,0,0,3,0,3,2,0
1,0,0,1,1,1,2,0,0,0,0,3,0,0,0,3,0,3,2,0
1,0,0,1,1,1,2,0,0,0,0,3,0,0,0,3,0,3,2,0
1,0,0,1,1,1,2,0,0,0,0,3,0,0,0,3,0,3,2,0
1,0,0,1,1,1,2,0,0,0,0,3,0,0,0,3,0,3,2,0
1,0,0,1,1,1,2,0,0,0,0,3,0,0,0,3,0,3,2,0
1,0,0,1,1,1,2,0,0,0,0,3,0,0,0,3,0,3,2,0
1,0,0,1,1,1,2,0,0,0,0,3,0,0,0,3,0,3,2,0
1,0,0,1,1,1,2,0,0,0,0,3,0,0,0,3,0,3,2,0
1,0,0,1,1,1,2,0,0,0,0,3,0,0,0,3,0,3,2,0
1,0,0,1,1,1,3,11.63,2,46.53,0.01,9,0.5,2.58,4,5,3,3,3,0
1,0,0,1,1,1,0,5.33,1.5,12,0,4,0.67,0.67,1,3,1,3,0,0
1,0,0,1,1,1,0,5.33,1.5,12,0,4,0.67,0.67,1,3,1,3,0,0
1,0,0,1,1,1,0,5.33,1.5,12,0,4,0.67,0.67,1,3,1,3,0,0
1,0,0,1,1,1,2,0,0,0,0,3,0,0,0,3,0,3,2,0
1,0,0,1,1,1,2,5.33,1.5,12,0,4,0.67,0.67,1,3,1,3,2,0
1,0,0,1,1,1,2,0,0,0,0,3,0,0,0,3,0,3,2,0
1,0,0,1,1,1,2,0,0,0,0,3,0,0,0,3,0,3,2,0
1,0,0,1,1,1,2,0,0,0,0,3,0,0,0,3,0,3,2,0
1,0,0,1,1,1,2,0,0,0,0,3,0,0,0,3,0,3,2,0
1,0,0,1,1,1,2,0,0,0,0,3,0,0,0,3,0,3,2,0
1,0,0,1,1,1,2,0,0,0,0,3,0,0,0,3,0,3,2,0
1,0,0,1,1,1,2,0,0,0,0,3,0,0,0,3,0,3,2,0
1,0,0,1,1,1,2,0,0,0,0,3,0,0,0,3,0,3,2,0
1,0,0,1,1,1,2,0,0,0,0,3,0,0,0,3,0,3,2,0
1,0,0,1,1,1,2,0,0,0,0,3,0,0,0,3,0,3,2,0
1,0,0,1,1,1,2,0,0,0,0,3,0,0,0,3,0,3,2,0
1,0,0,1,1,1,0,7.74,1.5,17.41,0,5,0.67,0.97,2,3,2,3,0,0
1,0,0,1,1,1,0,7.74,1.5,17.41,0,5,0.67,0.97,2,3,2,3,0,0
1,0,0,1,1,1,0,0,0,0,0,3,0,0,0,3,0,3,0,0
1,0,0,1,1,1,0,5.33,1.5,12,0,4,0.67,0.67,1,3,1,3,0,0
1,0,0,1,1,1,2,0,0,0,0,3,0,0,0,3,0,3,2,0
1,0,0,1,1,1,2,0,0,0,0,3,0,0,0,3,0,3,2,0
1,0,0,1,1,1,2,0,0,0,0,3,0,0,0,3,0,3,2,0
1,0,0,1,1,1,2,0,0,0,0,3,0,0,0,3,0,3,2,0
1,0,0,1,1,1,2,0,0,0,0,3,0,0,0,3,0,3,2,0
1,0,0,1,1,1,2,0,0,0,0,3,0,0,0,3,0,3,2,0
1,0,0,1,1,1,2,0,0,0,0,3,0,0,0,3,0,3,2,0
1,0,0,1,1,1,2,0,0,0,0,3,0,0,0,3,0,3,2,0
1,0,0,1,1,1,2,0,0,0,0,3,0,0,0,3,0,3,2,0
1,0,0,1,1,1,2,0,0,0,0,3,0,0,0,3,0,3,2,0
1,0,0,1,1,1,2,0,0,0,0,3,0,0,0,3,0,3,2,0
5,0,5,3,1,1,7,13.32,13.71,2505.06,0.06,43,0.07,139.17,16,27,7,12,7,0
5,0,5,3,1,1,7,13.32,13.71,2505.06,0.06,43,0.07,139.17,16,27,7,12,7,0
1,0,0,1,1,1,1,0,0,0,0,1,0,0,0,1,0,1,1,0
15,0,14,8,1,8,23,33.39,12.32,5064.23,0.14,83,0.08,281.35,39,44,19,12,23,1
71,92,142,42,13,12,283,76.73,101.71,793650.29,2.6,1124,0.01,44091.68,455,669,85,38,375,1
3,1,12,2,1,1,37,73.84,15.89,18648.73,0.39,209,0.06,1036.04,98,111,37,12,38,1
19,0,1,10,7,10,17,25.81,11.92,3665.59,0.1,68,0.08,203.64,26,42,12,11,17,1
17,8,23,11,11,1,60,46.09,28.41,37194.42,0.44,232,0.04,2066.36,101,131,32,18,68,0
7,1,43,4,4,1,32,107.7,6.85,5050.51,0.25,127,0.15,280.58,63,64,46,10,33,1
3,1,11,2,1,1,32,69.59,15.09,15837.24,0.35,189,0.07,879.85,88,101,35,12,33,1
29,38,46,15,9,7,173,90.46,60.38,329803.84,1.82,869,0.02,18322.44,375,494,59,19,211,1
23,51,48,16,16,7,68,45.73,39.54,71485.44,0.6,296,0.03,3971.41,123,173,42,27,119,1
35,34,58,20,8,13,87,45.97,41.17,77917.49,0.63,302,0.02,4328.75,129,173,47,30,121,1
15,6,8,8,5,6,30,28.93,17.76,9127.31,0.17,101,0.06,507.07,45,56,19,15,36,1
1,0,0,1,1,1,2,5.33,1.5,12,0,4,0.67,0.67,1,3,1,3,2,0
9,2,1,8,1,1,27,34.09,9.88,3329.22,0.11,68,0.1,184.96,24,44,17,14,29,0
3,0,1,2,1,1,2,12.09,6.3,479.73,0.03,20,0.16,26.65,7,13,5,9,2,0
1,0,0,1,1,1,2,5.33,1.5,12,0,4,0.67,0.67,1,3,1,3,2,0
1,0,0,1,1,1,2,5.33,1.5,12,0,4,0.67,0.67,1,3,1,3,2,0
1,0,0,1,1,1,2,5.33,1.5,12,0,4,0.67,0.67,1,3,1,3,2,0
1,0,0,1,1,1,2,5.33,1.5,12,0,4,0.67,0.67,1,3,1,3,2,0
1,0,0,1,1,1,2,5.33,1.5,12,0,4,0.67,0.67,1,3,1,3,2,0
1,0,0,1,1,1,2,5.33,1.5,12,0,4,0.67,0.67,1,3,1,3,2,0
1,0,0,1,1,1,2,5.33,1.5,12,0,4,0.67,0.67,1,3,1,3,2,0
1,0,0,1,1,1,2,0,0,0,0,5,0,0,0,5,0,5,2,0
1,0,0,1,1,1,0,0,0,0,0,5,0,0,0,5,0,5,0,0
1,0,0,1,1,1,0,0,0,0,0,5,0,0,0,5,0,5,0,0
1,0,0,1,1,1,0,0,0,0,0,1,0,0,0,1,0,1,0,0
1,0,0,1,1,1,2,0,0,0,0.01,6,0,0,0,6,0,6,2,0
11,1,4,6,1,1,21,13.86,22.5,7014.99,0.1,68,0.04,389.72,27,41,9,15,22,0
1,0,0,1,1,1,1,0,0,0,0,0,0,0,0,0,0,0,1,0
1,0,0,1,1,1,1,0,0,0,0,1,0,0,0,1,0,1,1,0
1,0,0,1,1,1,2,5.33,1.5,12,0,4,0.67,0.67,1,3,1,3,2,0
1,0,0,1,1,1,2,5.33,1.5,12,0,4,0.67,0.67,1,3,1,3,2,0
1,9,0,1,1,1,2,0,0,0,0,9,0,0,9,0,1,0,11,0
1,0,0,1,1,1,1,0,0,0,0,0,0,0,0,0,0,0,1,0
1,0,0,1,1,1,1,0,0,0,0,0,0,0,0,0,0,0,1,0
1,0,0,1,1,1,1,0,0,0,0,1,0,0,0,1,0,1,1,0
1,0,0,1,1,1,4,18.49,2.4,106.51,0.01,14,0.42,5.92,6,8,5,4,4,0
1,0,0,1,1,1,2,5.33,1.5,12,0,4,0.67,0.67,1,3,1,3,2,0
1,0,0,1,1,1,5,8.45,0.75,4.75,0,4,1.33,0.26,3,1,2,1,5,0
1,0,0,1,1,1,1,0,0,0,0,0,0,0,0,0,0,0,1,0
1,0,0,1,1,1,1,0,0,0,0,1,0,0,0,1,0,1,1,0
1,0,0,1,1,1,3,10.8,2.5,67.5,0.01,9,0.4,3.75,3,6,3,5,3,0
1,0,0,1,1,1,2,5.33,1.5,12,0,4,0.67,0.67,1,3,1,3,2,0
1,0,0,1,1,1,2,6.2,2.5,38.77,0.01,6,0.4,2.15,1,5,1,5,2,0
1,0,0,1,1,1,4,9.51,0.5,2.38,0,3,2,0.13,2,1,2,1,4,0
1,0,0,1,1,1,1,0,0,0,0,1,0,0,0,1,0,1,1,0
1,0,0,1,1,1,6,16.68,7.5,938.23,0.04,30,0.13,52.12,12,18,8,10,6,0
1,0,0,1,1,1,2,5.33,1.5,12,0,4,0.67,0.67,1,3,1,3,2,0
1,0,0,1,1,1,2,10.44,3.5,127.89,0.01,11,0.29,7.11,3,8,3,7,2,0
1,0,0,1,1,1,2,10.44,3.5,127.89,0.01,11,0.29,7.11,3,8,3,7,2,0
1,0,0,1,1,1,2,7.49,3,67.38,0.01,8,0.33,3.74,1,7,1,6,2,0
1,0,0,1,1,1,2,9,3,81,0.01,9,0.33,4.5,2,7,2,6,2,0
1,0,0,1,1,1,2,9,3,81,0.01,9,0.33,4.5,2,7,2,6,2,0
1,0,0,1,1,1,2,9,3,81,0.01,9,0.33,4.5,2,7,2,6,2,0
1,0,0,1,1,1,2,10.44,3.5,127.89,0.01,11,0.29,7.11,3,8,3,7,2,0
1,0,0,1,1,1,2,9,3,81,0.01,9,0.33,4.5,2,7,2,6,2,0
1,0,0,1,1,1,2,9,3,81,0.01,9,0.33,4.5,2,7,2,6,2,0
1,0,0,1,1,1,2,7.49,3,67.38,0.01,8,0.33,3.74,1,7,1,6,2,0
1,0,0,1,1,1,2,7.49,3,67.38,0.01,8,0.33,3.74,1,7,1,6,2,0
1,0,0,1,1,1,2,10,3,90,0.01,10,0.33,5,2,8,2,6,2,0
1,0,0,1,1,1,3,10.44,3.5,127.89,0.01,11,0.29,7.11,3,8,3,7,3,0
1,0,0,1,1,1,3,11.39,3.5,139.52,0.01,12,0.29,7.75,3,9,3,7,3,0
1,0,0,1,1,1,2,9,3,81,0.01,9,0.33,4.5,2,7,2,6,2,0
1,0,0,1,1,1,2,10.44,3.5,127.89,0.01,11,0.29,7.11,3,8,3,7,2,0
1,0,0,1,1,1,2,9,3,81,0.01,9,0.33,4.5,2,7,2,6,2,0
1,0,0,1,1,1,2,9,3,81,0.01,9,0.33,4.5,2,7,2,6,2,0
1,0,0,1,1,1,2,10.44,3.5,127.89,0.01,11,0.29,7.11,3,8,3,7,2,0
1,0,0,1,1,1,2,9,3,81,0.01,9,0.33,4.5,2,7,2,6,2,0
1,0,0,1,1,1,2,9,3,81,0.01,9,0.33,4.5,2,7,2,6,2,0
1,0,0,1,1,1,2,9,3,81,0.01,9,0.33,4.5,2,7,2,6,2,0
1,0,0,1,1,1,2,7.49,3,67.38,0.01,8,0.33,3.74,1,7,1,6,2,0
1,0,0,1,1,1,2,9,3,81,0.01,9,0.33,4.5,2,7,2,6,2,0
1,0,0,1,1,1,2,9,3,81,0.01,9,0.33,4.5,2,7,2,6,2,0
1,0,0,1,1,1,2,10.44,3.5,127.89,0.01,11,0.29,7.11,3,8,3,7,2,0
1,0,0,1,1,1,2,9.05,2,36.19,0.01,7,0.5,2,2,5,2,4,2,0
1,0,0,1,1,1,2,9.05,2,36.19,0.01,7,0.5,2,2,5,2,4,2,0
1,0,0,1,1,1,2,9.05,2,36.19,0.01,7,0.5,2,2,5,2,4,2,0
1,0,0,1,1,1,2,9.05,2,36.19,0.01,7,0.5,2,2,5,2,4,2,0
1,0,0,1,1,1,2,9.05,2,36.19,0.01,7,0.5,2,2,5,2,4,2,0
1,0,0,1,1,1,2,9.05,2,36.19,0.01,7,0.5,2,2,5,2,4,2,0
1,0,0,1,1,1,2,9.05,2,36.19,0.01,7,0.5,2,2,5,2,4,2,0
1,0,0,1,1,1,2,9.05,2,36.19,0.01,7,0.5,2,2,5,2,4,2,0
1,0,0,1,1,1,2,9.05,2,36.19,0.01,7,0.5,2,2,5,2,4,2,0
1,0,0,1,1,1,2,9.05,2,36.19,0.01,7,0.5,2,2,5,2,4,2,0
1,0,0,1,1,1,2,9.05,2,36.19,0.01,7,0.5,2,2,5,2,4,2,0
1,0,0,1,1,1,2,9.05,2,36.19,0.01,7,0.5,2,2,5,2,4,2,0
1,0,0,1,1,1,2,9.05,2,36.19,0.01,7,0.5,2,2,5,2,4,2,0
1,0,0,1,1,1,2,10.44,3.5,127.89,0.01,11,0.29,7.11,3,8,3,7,2,0
1,0,0,1,1,1,2,10.44,3.5,127.89,0.01,11,0.29,7.11,3,8,3,7,2,0
1,0,0,1,1,1,2,9.05,2,36.19,0.01,7,0.5,2,2,5,2,4,2,0
1,0,0,1,1,1,0,0,0,0,0,1,0,0,0,1,0,1,0,0
1,0,0,1,1,1,2,5.33,1.5,12,0,4,0.67,0.67,1,3,1,3,2,0
3,0,0,2,1,1,6,11.86,4.38,227.03,0.02,15,0.23,12.61,5,10,4,7,6,0
3,2,0,2,1,1,6,14.43,5.14,381.76,0.02,19,0.19,21.21,9,10,7,8,8,0
5,1,0,3,1,1,10,12.67,10,1267.11,0.04,31,0.1,70.4,14,17,7,10,11,0
3,1,0,2,1,1,6,11.71,4.9,281.06,0.02,16,0.2,15.61,7,9,5,7,7,0
3,1,0,2,1,1,6,11.71,4.9,281.06,0.02,16,0.2,15.61,7,9,5,7,7,0
1,0,0,1,1,1,2,5.33,1.5,12,0,4,0.67,0.67,1,3,1,3,2,0
1,0,0,1,1,1,2,5.33,1.5,12,0,4,0.67,0.67,1,3,1,3,2,0
3,1,0,2,1,1,6,11.23,5.6,352.28,0.02,17,0.18,19.57,7,10,5,8,7,0
7,1,1,4,1,3,13,18.91,10.45,2065.48,0.07,45,0.1,114.75,19,26,10,11,14,0
5,1,0,3,1,1,10,13.33,9,1080,0.04,30,0.11,60,14,16,7,9,11,0
3,1,0,2,1,1,6,11.71,4.9,281.06,0.02,16,0.2,15.61,7,9,5,7,7,0
7,1,1,4,1,3,13,18.91,10.45,2065.48,0.07,45,0.1,114.75,19,26,10,11,14,0
3,1,0,2,1,1,6,11.71,4.9,281.06,0.02,16,0.2,15.61,7,9,5,7,7,0
3,0,0,2,1,1,6,11.86,4.38,227.03,0.02,15,0.23,12.61,5,10,4,7,6,0
3,2,0,2,1,1,7,16.73,5.5,506,0.03,23,0.18,28.11,11,12,8,8,9,0
1,0,0,1,1,1,2,5.33,1.5,12,0,4,0.67,0.67,1,3,1,3,2,0
9,6,0,5,1,1,14,23.12,11.15,2875.94,0.09,57,0.09,159.77,29,28,13,10,20,0
3,1,0,2,1,1,7,14.43,5.14,381.76,0.02,19,0.19,21.21,9,10,7,8,8,0
7,1,1,4,1,3,13,19.62,10,1962.15,0.07,44,0.1,109.01,20,24,11,11,14,0
1,0,0,1,1,1,2,5.33,1.5,12,0,4,0.67,0.67,1,3,1,3,2,0
1,0,0,1,1,1,2,5.33,1.5,12,0,4,0.67,0.67,1,3,1,3,2,0
1,0,0,1,1,1,2,5.33,1.5,12,0,4,0.67,0.67,1,3,1,3,2,0
1,0,0,1,1,1,2,5.33,1.5,12,0,4,0.67,0.67,1,3,1,3,2,0
1,0,0,1,1,1,2,5.33,1.5,12,0,4,0.67,0.67,1,3,1,3,2,0
1,0,0,1,1,1,2,5.33,1.5,12,0,4,0.67,0.67,1,3,1,3,2,0
3,1,0,2,1,1,5,10.95,6,394.38,0.02,19,0.17,21.91,10,9,5,6,6,0
3,1,0,2,1,1,5,10.95,6,394.38,0.02,19,0.17,21.91,10,9,5,6,6,0
3,1,0,2,1,1,5,10.95,6,394.38,0.02,19,0.17,21.91,10,9,5,6,6,0
3,1,0,2,1,1,5,10.95,6,394.38,0.02,19,0.17,21.91,10,9,5,6,6,0
3,1,1,2,1,1,5,10.95,6,394.38,0.02,19,0.17,21.91,10,9,5,6,6,0
1,0,0,1,1,1,3,13,3,117,0.01,13,0.33,6.5,6,7,4,4,3,0
1,0,0,1,1,1,2,11.07,3,99.66,0.01,10,0.33,5.54,4,6,4,6,2,0
1,0,0,1,1,1,2,7.74,1.5,17.41,0,5,0.67,0.97,2,3,2,3,2,0
3,0,1,2,1,1,8,16.92,4.5,342.66,0.03,20,0.22,19.04,9,11,7,7,8,0
3,1,0,2,1,1,7,16.92,4.5,342.66,0.03,20,0.22,19.04,9,11,7,7,8,0
1,0,0,1,1,1,2,11.41,2.5,71.32,0.01,9,0.4,3.96,4,5,4,5,2,0
3,1,0,2,1,1,5,10.95,6,394.38,0.02,19,0.17,21.91,10,9,5,6,6,0
1,0,0,1,1,1,4,16.51,4.8,380.39,0.03,25,0.21,21.13,12,13,5,4,4,0
1,0,0,1,1,1,2,7.74,1.5,17.41,0,5,0.67,0.97,2,3,2,3,2,0
3,1,0,2,1,1,5,10.95,6,394.38,0.02,19,0.17,21.91,10,9,5,6,6,0
3,1,0,2,1,1,5,10.95,6,394.38,0.02,19,0.17,21.91,10,9,5,6,6,0
1,0,0,1,1,1,2,9.83,2,39.3,0.01,7,0.5,2.18,3,4,3,4,2,0
1,0,0,1,1,1,1,0,0,0,0,1,0,0,0,1,0,1,1,0
1,0,0,1,1,1,1,0,0,0,0,1,0,0,0,1,0,1,1,0
1,0,0,1,1,1,1,0,0,0,0,1,0,0,0,1,0,1,1,0
1,0,0,1,1,1,1,0,0,0,0,1,0,0,0,1,0,1,1,0
1,0,0,1,1,1,1,0,0,0,0,1,0,0,0,1,0,1,1,0
1,0,0,1,1,1,1,0,0,0,0,1,0,0,0,1,0,1,1,0
1,0,0,1,1,1,0,0,0,0,0,1,0,0,0,1,0,1,0,0
1,0,0,1,1,1,0,0,0,0,0,1,0,0,0,1,0,1,0,0
1,0,0,1,1,1,2,0,0,0,0,3,0,0,0,3,0,3,2,0
1,0,0,1,1,1,2,0,0,0,0,3,0,0,0,3,0,3,2,0
1,0,0,1,1,1,2,0,0,0,0,3,0,0,0,3,0,3,2,0
1,0,0,1,1,1,2,0,0,0,0,3,0,0,0,3,0,3,2,0
1,0,0,1,1,1,2,0,0,0,0,3,0,0,0,3,0,3,2,0
1,0,0,1,1,1,2,0,0,0,0,3,0,0,0,3,0,3,2,0
1,0,0,1,1,1,2,0,0,0,0,3,0,0,0,3,0,3,2,0
1,0,0,1,1,1,2,0,0,0,0,3,0,0,0,3,0,3,2,0
1,0,0,1,1,1,2,0,0,0,0,3,0,0,0,3,0,3,2,0
1,0,0,1,1,1,2,0,0,0,0,3,0,0,0,3,0,3,2,0
1,0,0,1,1,1,2,0,0,0,0,3,0,0,0,3,0,3,2,0
1,0,0,1,1,1,3,11.63,2,46.53,0.01,9,0.5,2.58,4,5,3,3,3,0
1,0,0,1,1,1,0,5.33,1.5,12,0,4,0.67,0.67,1,3,1,3,0,0
1,0,0,1,1,1,0,5.33,1.5,12,0,4,0.67,0.67,1,3,1,3,0,0
1,0,0,1,1,1,0,5.33,1.5,12,0,4,0.67,0.67,1,3,1,3,0,0
1,0,0,1,1,1,2,0,0,0,0,3,0,0,0,3,0,3,2,0
1,0,0,1,1,1,2,5.33,1.5,12,0,4,0.67,0.67,1,3,1,3,2,0
1,0,0,1,1,1,2,0,0,0,0,3,0,0,0,3,0,3,2,0
1,0,0,1,1,1,2,0,0,0,0,3,0,0,0,3,0,3,2,0
1,0,0,1,1,1,2,0,0,0,0,3,0,0,0,3,0,3,2,0
1,0,0,1,1,1,2,0,0,0,0,3,0,0,0,3,0,3,2,0
1,0,0,1,1,1,2,0,0,0,0,3,0,0,0,3,0,3,2,0
1,0,0,1,1,1,2,0,0,0,0,3,0,0,0,3,0,3,2,0
1,0,0,1,1,1,2,0,0,0,0,3,0,0,0,3,0,3,2,0
1,0,0,1,1,1,2,0,0,0,0,3,0,0,0,3,0,3,2,0
1,0,0,1,1,1,2,0,0,0,0,3,0,0,0,3,0,3,2,0
1,0,0,1,1,1,2,0,0,0,0,3,0,0,0,3,0,3,2,0
1,0,0,1,1,1,2,0,0,0,0,3,0,0,0,3,0,3,2,0
1,0,0,1,1,1,0,7.74,1.5,17.41,0,5,0.67,0.97,2,3,2,3,0,0
1,0,0,1,1,1,0,7.74,1.5,17.41,0,5,0.67,0.97,2,3,2,3,0,0
1,0,0,1,1,1,0,0,0,0,0,3,0,0,0,3,0,3,0,0
1,0,0,1,1,1,0,5.33,1.5,12,0,4,0.67,0.67,1,3,1,3,0,0
1,0,0,1,1,1,2,0,0,0,0,3,0,0,0,3,0,3,2,0
1,0,0,1,1,1,2,0,0,0,0,3,0,0,0,3,0,3,2,0
1,0,0,1,1,1,2,0,0,0,0,3,0,0,0,3,0,3,2,0
1,0,0,1,1,1,2,0,0,0,0,3,0,0,0,3,0,3,2,0
1,0,0,1,1,1,2,0,0,0,0,3,0,0,0,3,0,3,2,0
1,0,0,1,1,1,2,0,0,0,0,3,0,0,0,3,0,3,2,0
1,0,0,1,1,1,2,0,0,0,0,3,0,0,0,3,0,3,2,0
1,0,0,1,1,1,2,0,0,0,0,3,0,0,0,3,0,3,2,0
1,0,0,1,1,1,2,0,0,0,0,3,0,0,0,3,0,3,2,0
1,0,0,1,1,1,2,0,0,0,0,3,0,0,0,3,0,3,2,0
1,0,0,1,1,1,2,0,0,0,0,3,0,0,0,3,0,3,2,0
5,0,5,3,1,1,7,13.32,13.71,2505.06,0.06,43,0.07,139.17,16,27,7,12,7,0
5,0,5,3,1,1,7,13.32,13.71,2505.06,0.06,43,0.07,139.17,16,27,7,12,7,0
1,0,0,1,1,1,0,0,0,0,0,1,0,0,0,1,0,1,0,0
45,4,156,23,13,8,259,120.85,54.03,352833.64,2.18,1042,0.02,19601.87,412,630,61,16,263,0
1,0,1,1,1,1,14,3.87,9,313.46,0.01,15,0.11,17.41,12,3,2,3,14,0
8,1,13,5,5,1,39,41.02,25.9,27529.73,0.35,204,0.04,1529.43,68,136,21,16,40,0
39,1,22,20,16,3,86,88.66,23.49,48914.57,0.69,354,0.04,2717.48,151,203,45,14,87,0
1,0,2,1,1,1,8,26.46,10.4,2862.24,0.09,66,0.1,159.01,26,40,10,8,8,0
45,9,139,23,21,5,424,303.91,32.18,314862.84,3.26,1402,0.03,17492.38,515,887,112,14,433,0
36,0,33,28,28,1,108,59.48,48.48,139830.28,0.96,436,0.02,7768.35,191,245,65,33,108,0
3,0,6,2,2,1,11,23.83,5.6,747.25,0.04,32,0.18,41.51,14,18,10,8,11,0
3,0,10,2,1,1,11,17.21,5,430.2,0.03,24,0.2,23.9,10,14,6,6,11,0
3,0,6,2,2,1,11,23.83,5.6,747.25,0.04,32,0.18,41.51,14,18,10,8,11,0
5,1,9,3,3,1,19,32.88,8.33,2283.23,0.09,59,0.12,126.85,25,34,15,10,20,0
3,0,6,2,1,1,11,24.37,3.75,342.66,0.03,24,0.27,19.04,10,14,8,6,11,0
5,0,7,3,3,1,15,29.82,6.67,1325.39,0.07,46,0.15,73.63,20,26,12,8,15,0
41,2,23,21,5,13,51,61.88,17.84,19691.48,0.37,201,0.06,1093.97,79,122,31,14,53,0
9,2,1,8,1,1,27,34.09,9.88,3329.22,0.11,68,0.1,184.96,24,44,17,14,29,0
3,0,1,2,1,1,2,12.09,6.3,479.73,0.03,20,0.16,26.65,7,13,5,9,2,0
1,0,0,1,1,1,2,5.33,1.5,12,0,4,0.67,0.67,1,3,1,3,2,0
1,0,0,1,1,1,2,5.33,1.5,12,0,4,0.67,0.67,1,3,1,3,2,0
1,0,0,1,1,1,2,5.33,1.5,12,0,4,0.67,0.67,1,3,1,3,2,0
1,0,0,1,1,1,2,5.33,1.5,12,0,4,0.67,0.67,1,3,1,3,2,0
1,0,0,1,1,1,2,5.33,1.5,12,0,4,0.67,0.67,1,3,1,3,2,0
1,0,0,1,1,1,2,5.33,1.5,12,0,4,0.67,0.67,1,3,1,3,2,0
1,0,0,1,1,1,2,5.33,1.5,12,0,4,0.67,0.67,1,3,1,3,2,0
1,0,0,1,1,1,2,5.33,1.5,12,0,4,0.67,0.67,1,3,1,3,2,0
1,0,0,1,1,1,2,5.33,1.5,12,0,4,0.67,0.67,1,3,1,3,2,0
1,0,0,1,1,1,2,0,0,0,0,4,0,0,0,4,0,4,2,0
1,0,0,1,1,1,0,0,0,0,0,5,0,0,0,5,0,5,0,0
1,0,0,1,1,1,0,0,0,0,0,5,0,0,0,5,0,5,0,0
1,0,0,1,1,1,1,0,0,0,0,1,0,0,0,1,0,1,1,0
1,0,0,1,1,1,2,0,0,0,0,5,0,0,0,5,0,5,2,0
11,1,4,6,1,1,21,13.86,22.5,7014.99,0.1,68,0.04,389.72,27,41,9,15,22,0
1,0,0,1,1,1,2,20.97,3,188.72,0.02,17,0.33,10.48,7,10,7,6,2,0
1,0,0,1,1,1,2,20.97,3,188.72,0.02,17,0.33,10.48,7,10,7,6,2,0
1,0,0,1,1,1,2,27.35,3,246.13,0.03,21,0.33,13.67,9,12,9,6,2,0
1,0,0,1,1,1,3,30.67,3,276,0.03,23,0.33,15.33,10,13,10,6,3,0
1,0,0,1,1,1,3,30.67,3,276,0.03,23,0.33,15.33,10,13,10,6,3,0
1,0,0,1,1,1,3,30.67,3,276,0.03,23,0.33,15.33,10,13,10,6,3,0
1,0,0,1,1,1,2,27.35,3,246.13,0.03,21,0.33,13.67,9,12,9,6,2,0
1,0,0,1,1,1,3,27.35,3,246.13,0.03,21,0.33,13.67,9,12,9,6,3,0
1,0,0,1,1,1,2,20.97,3,188.72,0.02,17,0.33,10.48,7,10,7,6,2,0
1,0,0,1,1,1,2,20.97,3,188.72,0.02,17,0.33,10.48,7,10,7,6,2,0
1,0,0,1,1,1,2,20.97,3,188.72,0.02,17,0.33,10.48,7,10,7,6,2,0
1,0,0,1,1,1,2,17.92,3,161.32,0.02,15,0.33,8.96,6,9,6,6,2,0
1,0,0,1,1,1,2,17.92,3,161.32,0.02,15,0.33,8.96,6,9,6,6,2,0
1,0,0,1,1,1,2,14.99,3,134.92,0.01,13,0.33,7.5,5,8,5,6,2,0
1,0,0,1,1,1,2,14.99,3,134.92,0.01,13,0.33,7.5,5,8,5,6,2,0
1,0,0,1,1,1,2,14.99,3,134.92,0.01,13,0.33,7.5,5,8,5,6,2,0
1,0,0,1,1,1,2,14.99,3,134.92,0.01,13,0.33,7.5,5,8,5,6,2,0
1,0,0,1,1,1,2,14.99,3,134.92,0.01,13,0.33,7.5,5,8,5,6,2,0
1,0,0,1,1,1,2,17.92,3,161.32,0.02,15,0.33,8.96,6,9,6,6,2,0
1,0,0,1,1,1,2,17.92,3,161.32,0.02,15,0.33,8.96,6,9,6,6,2,0
1,0,0,1,1,1,2,20.97,3,188.72,0.02,17,0.33,10.48,7,10,7,6,2,0
1,0,0,1,1,1,2,20.97,3,188.72,0.02,17,0.33,10.48,7,10,7,6,2,0
1,0,0,1,1,1,1,0,0,0,0,0,0,0,0,0,0,0,1,0
1,0,0,1,1,1,1,0,0,0,0,1,0,0,0,1,0,1,1,0
1,0,0,1,1,1,2,5.33,1.5,12,0,4,0.67,0.67,1,3,1,3,2,0
1,0,0,1,1,1,2,5.33,1.5,12,0,4,0.67,0.67,1,3,1,3,2,0
1,9,0,1,1,1,2,0,0,0,0,9,0,0,9,0,1,0,11,0
1,0,0,1,1,1,1,0,0,0,0,0,0,0,0,0,0,0,1,0
1,0,0,1,1,1,1,0,0,0,0,0,0,0,0,0,0,0,1,0
1,0,0,1,1,1,1,0,0,0,0,1,0,0,0,1,0,1,1,0
1,0,0,1,1,1,4,18.49,2.4,106.51,0.01,14,0.42,5.92,6,8,5,4,4,0
1,0,0,1,1,1,2,5.33,1.5,12,0,4,0.67,0.67,1,3,1,3,2,0
1,0,0,1,1,1,5,8.45,0.75,4.75,0,4,1.33,0.26,3,1,2,1,5,0
1,0,0,1,1,1,1,0,0,0,0,0,0,0,0,0,0,0,1,0
1,0,0,1,1,1,1,0,0,0,0,1,0,0,0,1,0,1,1,0
1,0,0,1,1,1,3,10.8,2.5,67.5,0.01,9,0.4,3.75,3,6,3,5,3,0
1,0,0,1,1,1,2,5.33,1.5,12,0,4,0.67,0.67,1,3,1,3,2,0
1,0,0,1,1,1,2,6.2,2.5,38.77,0.01,6,0.4,2.15,1,5,1,5,2,0
1,0,0,1,1,1,4,9.51,0.5,2.38,0,3,2,0.13,2,1,2,1,4,0
1,0,0,1,1,1,1,0,0,0,0,1,0,0,0,1,0,1,1,0
1,0,0,1,1,1,2,5.33,1.5,12,0,4,0.67,0.67,1,3,1,3,2,0
1,0,0,1,1,1,2,5.33,1.5,12,0,4,0.67,0.67,1,3,1,3,2,0
1,0,0,1,1,1,2,0,0,0,0,4,0,0,0,4,0,4,2,0
1,0,0,1,1,1,1,0,0,0,0,1,0,0,0,1,0,1,1,0
1,0,0,1,1,1,2,0,0,0,0,5,0,0,0,5,0,5,2,0
1,0,0,1,1,1,1,0,0,0,0,1,0,0,0,1,0,1,1,0
1,0,0,1,1,1,2,5.33,1.5,12,0,4,0.67,0.67,1,3,1,3,2,0
1,0,0,1,1,1,2,5.33,1.5,12,0,4,0.67,0.67,1,3,1,3,2,0
1,0,0,1,1,1,1,0,0,0,0,1,0,0,0,1,0,1,1,0
1,0,0,1,1,1,6,16.68,7.5,938.23,0.04,30,0.13,52.12,12,18,8,10,6,0
1,0,0,1,1,1,2,5.33,1.5,12,0,4,0.67,0.67,1,3,1,3,2,0
1,0,0,1,1,1,2,10.44,3.5,127.89,0.01,11,0.29,7.11,3,8,3,7,2,0
1,0,0,1,1,1,2,7.86,2.5,49.13,0.01,7,0.4,2.73,2,5,2,5,2,0
1,0,0,1,1,1,2,7.49,3,67.38,0.01,8,0.33,3.74,1,7,1,6,2,0
1,0,0,1,1,1,2,7.49,3,67.38,0.01,8,0.33,3.74,1,7,1,6,2,0
1,0,0,1,1,1,2,7.49,3,67.38,0.01,8,0.33,3.74,1,7,1,6,2,0
1,0,0,1,1,1,2,7.49,3,67.38,0.01,8,0.33,3.74,1,7,1,6,2,0
1,0,0,1,1,1,2,7.49,3,67.38,0.01,8,0.33,3.74,1,7,1,6,2,0
1,0,0,1,1,1,2,7.49,3,67.38,0.01,8,0.33,3.74,1,7,1,6,2,0
1,0,0,1,1,1,2,7.49,3,67.38,0.01,8,0.33,3.74,1,7,1,6,2,0
1,0,0,1,1,1,2,10.57,3,95.1,0.01,10,0.33,5.28,3,7,3,6,2,0
1,0,0,1,1,1,0,0,0,0,0,1,0,0,0,1,0,1,0,0
1,0,0,1,1,1,2,5.33,1.5,12,0,4,0.67,0.67,1,3,1,3,2,0
1,0,0,1,1,1,2,5.33,1.5,12,0,4,0.67,0.67,1,3,1,3,2,0
1,0,0,1,1,1,2,5.33,1.5,12,0,4,0.67,0.67,1,3,1,3,2,0
1,0,0,1,1,1,2,5.33,1.5,12,0,4,0.67,0.67,1,3,1,3,2,0
1,0,0,1,1,1,2,5.33,1.5,12,0,4,0.67,0.67,1,3,1,3,2,0
1,0,0,1,1,1,2,5.33,1.5,12,0,4,0.67,0.67,1,3,1,3,2,0
1,0,0,1,1,1,2,5.33,1.5,12,0,4,0.67,0.67,1,3,1,3,2,0
1,0,0,1,1,1,2,13.95,2.5,87.17,0.01,11,0.4,4.84,4,7,4,5,2,0
1,0,0,1,1,1,1,0,0,0,0,1,0,0,0,1,0,1,1,0
1,0,0,1,1,1,1,0,0,0,0,1,0,0,0,1,0,1,1,0
1,0,0,1,1,1,1,0,0,0,0,1,0,0,0,1,0,1,1,0
1,0,0,1,1,1,1,0,0,0,0,1,0,0,0,1,0,1,1,0
1,0,0,1,1,1,1,0,0,0,0,1,0,0,0,1,0,1,1,0
1,0,0,1,1,1,1,0,0,0,0,1,0,0,0,1,0,1,1,0
5,0,0,3,1,1,2,13.29,4.5,269.08,0.02,18,0.22,14.95,6,12,4,6,2,0
1,0,1,1,1,1,2,16.92,3.5,207.22,0.02,16,0.29,11.51,6,10,6,7,2,0
1,0,0,1,1,1,0,0,0,0,0,1,0,0,0,1,0,1,0,0
1,0,0,1,1,1,2,0,0,0,0,3,0,0,0,3,0,3,2,0
1,0,0,1,1,1,2,0,0,0,0,3,0,0,0,3,0,3,2,0
1,0,0,1,1,1,2,0,0,0,0,3,0,0,0,3,0,3,2,0
1,0,0,1,1,1,2,0,0,0,0,3,0,0,0,3,0,3,2,0
1,0,0,1,1,1,2,0,0,0,0,3,0,0,0,3,0,3,2,0
1,0,0,1,1,1,2,0,0,0,0,3,0,0,0,3,0,3,2,0
1,0,0,1,1,1,2,0,0,0,0,3,0,0,0,3,0,3,2,0
1,0,0,1,1,1,2,0,0,0,0,3,0,0,0,3,0,3,2,0
1,0,0,1,1,1,2,0,0,0,0,3,0,0,0,3,0,3,2,0
1,0,0,1,1,1,2,0,0,0,0,3,0,0,0,3,0,3,2,0
1,0,0,1,1,1,2,0,0,0,0,3,0,0,0,3,0,3,2,0
1,0,0,1,1,1,3,11.63,2,46.53,0.01,9,0.5,2.58,4,5,3,3,3,0
1,0,0,1,1,1,0,5.33,1.5,12,0,4,0.67,0.67,1,3,1,3,0,0
1,0,0,1,1,1,0,5.33,1.5,12,0,4,0.67,0.67,1,3,1,3,0,0
1,0,0,1,1,1,0,5.33,1.5,12,0,4,0.67,0.67,1,3,1,3,0,0
1,0,0,1,1,1,2,0,0,0,0,3,0,0,0,3,0,3,2,0
1,0,0,1,1,1,2,5.33,1.5,12,0,4,0.67,0.67,1,3,1,3,2,0
1,0,0,1,1,1,2,0,0,0,0,3,0,0,0,3,0,3,2,0
1,0,0,1,1,1,2,0,0,0,0,3,0,0,0,3,0,3,2,0
1,0,0,1,1,1,2,0,0,0,0,3,0,0,0,3,0,3,2,0
1,0,0,1,1,1,2,0,0,0,0,3,0,0,0,3,0,3,2,0
1,0,0,1,1,1,2,0,0,0,0,3,0,0,0,3,0,3,2,0
1,0,0,1,1,1,2,0,0,0,0,3,0,0,0,3,0,3,2,0
1,0,0,1,1,1,2,0,0,0,0,3,0,0,0,3,0,3,2,0
1,0,0,1,1,1,2,0,0,0,0,3,0,0,0,3,0,3,2,0
1,0,0,1,1,1,2,0,0,0,0,3,0,0,0,3,0,3,2,0
1,0,0,1,1,1,2,0,0,0,0,3,0,0,0,3,0,3,2,0
1,0,0,1,1,1,2,0,0,0,0,3,0,0,0,3,0,3,2,0
1,0,0,1,1,1,0,7.74,1.5,17.41,0,5,0.67,0.97,2,3,2,3,0,0
1,0,0,1,1,1,0,7.74,1.5,17.41,0,5,0.67,0.97,2,3,2,3,0,0
1,0,0,1,1,1,0,0,0,0,0,3,0,0,0,3,0,3,0,0
1,0,0,1,1,1,0,5.33,1.5,12,0,4,0.67,0.67,1,3,1,3,0,0
1,0,0,1,1,1,2,0,0,0,0,3,0,0,0,3,0,3,2,0
1,0,0,1,1,1,2,0,0,0,0,3,0,0,0,3,0,3,2,0
1,0,0,1,1,1,2,0,0,0,0,3,0,0,0,3,0,3,2,0
1,0,0,1,1,1,2,0,0,0,0,3,0,0,0,3,0,3,2,0
1,0,0,1,1,1,2,0,0,0,0,3,0,0,0,3,0,3,2,0
1,0,0,1,1,1,2,0,0,0,0,3,0,0,0,3,0,3,2,0
1,0,0,1,1,1,2,0,0,0,0,3,0,0,0,3,0,3,2,0
1,0,0,1,1,1,2,0,0,0,0,3,0,0,0,3,0,3,2,0
1,0,0,1,1,1,2,0,0,0,0,3,0,0,0,3,0,3,2,0
1,0,0,1,1,1,2,0,0,0,0,3,0,0,0,3,0,3,2,0
1,0,0,1,1,1,2,0,0,0,0,3,0,0,0,3,0,3,2,0
5,0,5,3,1,1,7,13.32,13.71,2505.06,0.06,43,0.07,139.17,16,27,7,12,7,0
5,0,5,3,1,1,7,13.32,13.71,2505.06,0.06,43,0.07,139.17,16,27,7,12,7,0
1,0,0,1,1,1,1,0,0,0,0,1,0,0,0,1,0,1,1,0
7,0,0,4,1,4,20,36.01,10.31,3829.39,0.12,79,0.1,212.74,33,46,16,10,20,1
13,0,0,7,1,7,19,30.29,12.57,4787.15,0.13,82,0.08,265.95,32,50,14,11,19,0
9,0,0,5,1,3,14,21.86,10.83,2565.73,0.08,51,0.09,142.54,20,31,12,13,14,0
5,0,0,3,1,1,12,15.48,9.43,1376.08,0.05,35,0.11,76.45,12,23,7,11,12,0
9,0,0,5,1,3,12,17.71,10.67,2014.61,0.06,43,0.09,111.92,16,27,9,12,12,0
15,0,0,8,1,6,16,22.34,12.83,3679.66,0.1,61,0.08,204.43,22,39,12,14,16,0
7,0,0,4,1,1,17,30.91,5.95,1094.42,0.06,45,0.17,60.8,17,28,10,7,17,0
9,0,4,5,1,5,12,13.95,11.33,1792.07,0.05,36,0.09,99.56,17,19,9,12,12,1
11,0,1,6,2,5,19,28.18,15.47,6743.9,0.15,88,0.06,374.66,33,55,16,15,19,0
9,0,0,5,1,5,18,36.77,10.61,4136.05,0.13,78,0.09,229.78,31,47,19,13,18,0
15,3,5,8,1,1,32,23.49,21.5,10857.5,0.17,101,0.05,603.19,43,58,16,16,35,1
9,1,1,5,1,5,20,18.73,12,2696.88,0.07,52,0.08,149.83,24,28,10,10,21,0
17,1,3,9,1,1,27,18.09,22.08,8817.76,0.13,84,0.05,489.88,41,43,13,14,28,1
5,0,0,3,1,1,12,17.92,4,286.8,0.02,20,0.25,15.93,8,12,6,6,12,0
11,0,1,6,2,5,19,27.2,14.46,5691.65,0.13,81,0.07,316.2,27,54,14,15,19,0
9,0,0,5,1,5,18,33.88,9.56,3095.67,0.11,66,0.1,171.98,25,41,17,13,18,0
5,0,0,3,1,1,14,19.97,9.6,1840.85,0.06,43,0.1,102.27,16,27,10,12,14,0
19,1,0,10,1,10,24,21.2,15.95,5394.42,0.11,77,0.06,299.69,29,48,10,11,25,0
731,51,619,366,24,290,1317,291.06,165.21,7944834.54,16.03,6201,0.01,441379.67,2313,3888,189,27,1368,1
1,0,11,1,1,1,25,89.86,8.16,5983.08,0.24,148,0.12,332.39,68,80,25,6,25,1
5,0,1,3,1,3,13,15.56,9.17,1307.38,0.05,33,0.11,72.63,15,18,9,11,13,0
26,2,9,15,13,1,58,41.83,32.61,44501.35,0.45,243,0.03,2472.3,103,140,30,19,60,1
119,8,79,60,31,17,212,153.75,44.9,309966.93,2.3,1022,0.02,17220.38,449,573,90,18,220,1
15,0,19,8,6,1,75,121.01,21.78,57405.04,0.88,430,0.05,3189.17,191,239,57,13,75,1
11,0,7,6,1,1,38,39.95,30,35958.36,0.4,255,0.03,1997.69,96,159,16,10,38,0
181,5,529,91,31,60,2067,1160.64,77.95,7052586.09,30.16,10342,0.01,391810.36,4034,6308,414,16,2072,1
21,2,6,11,10,1,43,48.53,18.92,17378.71,0.31,175,0.05,965.48,82,93,26,12,45,1
9,2,1,8,1,1,27,34.09,9.88,3329.22,0.11,68,0.1,184.96,24,44,17,14,29,0
3,0,1,2,1,1,2,12.09,6.3,479.73,0.03,20,0.16,26.65,7,13,5,9,2,0
1,0,0,1,1,1,2,5.33,1.5,12,0,4,0.67,0.67,1,3,1,3,2,0
1,0,0,1,1,1,2,5.33,1.5,12,0,4,0.67,0.67,1,3,1,3,2,0
1,0,0,1,1,1,2,5.33,1.5,12,0,4,0.67,0.67,1,3,1,3,2,0
1,0,0,1,1,1,2,5.33,1.5,12,0,4,0.67,0.67,1,3,1,3,2,0
1,0,0,1,1,1,2,5.33,1.5,12,0,4,0.67,0.67,1,3,1,3,2,0
1,0,0,1,1,1,2,5.33,1.5,12,0,4,0.67,0.67,1,3,1,3,2,0
1,0,0,1,1,1,2,5.33,1.5,12,0,4,0.67,0.67,1,3,1,3,2,0
1,0,0,1,1,1,2,5.33,1.5,12,0,4,0.67,0.67,1,3,1,3,2,0
1,0,0,1,1,1,2,5.33,1.5,12,0,4,0.67,0.67,1,3,1,3,2,0
1,0,0,1,1,1,2,0,0,0,0,4,0,0,0,4,0,4,2,0
1,0,0,1,1,1,1,0,0,0,0,1,0,0,0,1,0,1,1,0
1,0,0,1,1,1,0,0,0,0,0,1,0,0,0,1,0,1,0,0
1,0,0,1,1,1,2,0,0,0,0,5,0,0,0,5,0,5,2,0
1,0,0,1,1,1,2,0,0,0,0.01,6,0,0,0,6,0,6,2,0
11,1,4,6,1,1,21,13.86,22.5,7014.99,0.1,68,0.04,389.72,27,41,9,15,22,0
1,0,0,1,1,1,2,20.97,3,188.72,0.02,17,0.33,10.48,7,10,7,6,2,0
1,0,0,1,1,1,2,20.97,3,188.72,0.02,17,0.33,10.48,7,10,7,6,2,0
1,0,0,1,1,1,2,27.35,3,246.13,0.03,21,0.33,13.67,9,12,9,6,2,0
1,0,0,1,1,1,3,30.67,3,276,0.03,23,0.33,15.33,10,13,10,6,3,0
1,0,0,1,1,1,3,30.67,3,276,0.03,23,0.33,15.33,10,13,10,6,3,0
1,0,0,1,1,1,3,30.67,3,276,0.03,23,0.33,15.33,10,13,10,6,3,0
1,0,0,1,1,1,2,27.35,3,246.13,0.03,21,0.33,13.67,9,12,9,6,2,0
1,0,0,1,1,1,3,27.35,3,246.13,0.03,21,0.33,13.67,9,12,9,6,3,0
1,0,0,1,1,1,2,20.97,3,188.72,0.02,17,0.33,10.48,7,10,7,6,2,0
1,0,0,1,1,1,2,20.97,3,188.72,0.02,17,0.33,10.48,7,10,7,6,2,0
1,0,0,1,1,1,2,20.97,3,188.72,0.02,17,0.33,10.48,7,10,7,6,2,0
1,0,0,1,1,1,2,17.92,3,161.32,0.02,15,0.33,8.96,6,9,6,6,2,0
1,0,0,1,1,1,2,17.92,3,161.32,0.02,15,0.33,8.96,6,9,6,6,2,0
1,0,0,1,1,1,2,14.99,3,134.92,0.01,13,0.33,7.5,5,8,5,6,2,0
1,0,0,1,1,1,2,14.99,3,134.92,0.01,13,0.33,7.5,5,8,5,6,2,0
1,0,0,1,1,1,2,14.99,3,134.92,0.01,13,0.33,7.5,5,8,5,6,2,0
1,0,0,1,1,1,2,14.99,3,134.92,0.01,13,0.33,7.5,5,8,5,6,2,0
1,0,0,1,1,1,2,14.99,3,134.92,0.01,13,0.33,7.5,5,8,5,6,2,0
1,0,0,1,1,1,2,17.92,3,161.32,0.02,15,0.33,8.96,6,9,6,6,2,0
1,0,0,1,1,1,2,17.92,3,161.32,0.02,15,0.33,8.96,6,9,6,6,2,0
1,0,0,1,1,1,2,20.97,3,188.72,0.02,17,0.33,10.48,7,10,7,6,2,0
1,0,0,1,1,1,2,20.97,3,188.72,0.02,17,0.33,10.48,7,10,7,6,2,0
1,0,0,1,1,1,1,0,0,0,0,0,0,0,0,0,0,0,1,0
1,0,0,1,1,1,1,0,0,0,0,1,0,0,0,1,0,1,1,0
1,0,0,1,1,1,2,5.33,1.5,12,0,4,0.67,0.67,1,3,1,3,2,0
1,0,0,1,1,1,2,5.33,1.5,12,0,4,0.67,0.67,1,3,1,3,2,0
1,9,0,1,1,1,2,0,0,0,0,9,0,0,9,0,1,0,11,0
1,0,0,1,1,1,1,0,0,0,0,0,0,0,0,0,0,0,1,0
1,0,0,1,1,1,1,0,0,0,0,0,0,0,0,0,0,0,1,0
1,0,0,1,1,1,1,0,0,0,0,1,0,0,0,1,0,1,1,0
1,0,0,1,1,1,4,18.49,2.4,106.51,0.01,14,0.42,5.92,6,8,5,4,4,0
1,0,0,1,1,1,2,5.33,1.5,12,0,4,0.67,0.67,1,3,1,3,2,0
1,0,0,1,1,1,5,8.45,0.75,4.75,0,4,1.33,0.26,3,1,2,1,5,0
1,0,0,1,1,1,1,0,0,0,0,0,0,0,0,0,0,0,1,0
1,0,0,1,1,1,1,0,0,0,0,1,0,0,0,1,0,1,1,0
1,0,0,1,1,1,3,10.8,2.5,67.5,0.01,9,0.4,3.75,3,6,3,5,3,0
1,0,0,1,1,1,2,5.33,1.5,12,0,4,0.67,0.67,1,3,1,3,2,0
1,0,0,1,1,1,2,6.2,2.5,38.77,0.01,6,0.4,2.15,1,5,1,5,2,0
1,0,0,1,1,1,4,9.51,0.5,2.38,0,3,2,0.13,2,1,2,1,4,0
1,0,0,1,1,1,1,0,0,0,0,1,0,0,0,1,0,1,1,0
1,0,0,1,1,1,2,5.33,1.5,12,0,4,0.67,0.67,1,3,1,3,2,0
1,0,0,1,1,1,2,5.33,1.5,12,0,4,0.67,0.67,1,3,1,3,2,0
1,0,0,1,1,1,2,0,0,0,0,4,0,0,0,4,0,4,2,0
1,0,0,1,1,1,1,0,0,0,0,1,0,0,0,1,0,1,1,0
1,0,0,1,1,1,2,0,0,0,0,5,0,0,0,5,0,5,2,0
1,0,0,1,1,1,1,0,0,0,0,1,0,0,0,1,0,1,1,0
1,0,0,1,1,1,2,5.33,1.5,12,0,4,0.67,0.67,1,3,1,3,2,0
1,0,0,1,1,1,2,5.33,1.5,12,0,4,0.67,0.67,1,3,1,3,2,0
1,0,0,1,1,1,1,0,0,0,0,1,0,0,0,1,0,1,1,0
1,0,0,1,1,1,2,10.44,3.5,127.89,0.01,11,0.29,7.11,3,8,3,7,2,0
1,0,0,1,1,1,2,7.49,3,67.38,0.01,8,0.33,3.74,1,7,1,6,2,0
1,0,0,1,1,1,2,9,3,81,0.01,9,0.33,4.5,2,7,2,6,2,0
1,0,0,1,1,1,2,9,3,81,0.01,9,0.33,4.5,2,7,2,6,2,0
1,0,0,1,1,1,2,9,3,81,0.01,9,0.33,4.5,2,7,2,6,2,0
1,0,0,1,1,1,2,10.44,3.5,127.89,0.01,11,0.29,7.11,3,8,3,7,2,0
1,0,0,1,1,1,2,9,3,81,0.01,9,0.33,4.5,2,7,2,6,2,0
1,0,0,1,1,1,2,9,3,81,0.01,9,0.33,4.5,2,7,2,6,2,0
1,0,0,1,1,1,2,7.49,3,67.38,0.01,8,0.33,3.74,1,7,1,6,2,0
1,0,0,1,1,1,2,7.49,3,67.38,0.01,8,0.33,3.74,1,7,1,6,2,0
1,0,0,1,1,1,2,10,3,90,0.01,10,0.33,5,2,8,2,6,2,0
1,0,0,1,1,1,3,10.44,3.5,127.89,0.01,11,0.29,7.11,3,8,3,7,3,0
1,0,0,1,1,1,3,11.39,3.5,139.52,0.01,12,0.29,7.75,3,9,3,7,3,0
1,0,0,1,1,1,2,9,3,81,0.01,9,0.33,4.5,2,7,2,6,2,0
1,0,0,1,1,1,2,10.44,3.5,127.89,0.01,11,0.29,7.11,3,8,3,7,2,0
1,0,0,1,1,1,2,9,3,81,0.01,9,0.33,4.5,2,7,2,6,2,0
1,0,0,1,1,1,2,9,3,81,0.01,9,0.33,4.5,2,7,2,6,2,0
1,0,0,1,1,1,2,10.44,3.5,127.89,0.01,11,0.29,7.11,3,8,3,7,2,0
1,0,0,1,1,1,2,9,3,81,0.01,9,0.33,4.5,2,7,2,6,2,0
1,0,0,1,1,1,2,9,3,81,0.01,9,0.33,4.5,2,7,2,6,2,0
1,0,0,1,1,1,2,9,3,81,0.01,9,0.33,4.5,2,7,2,6,2,0
1,0,0,1,1,1,2,7.49,3,67.38,0.01,8,0.33,3.74,1,7,1,6,2,0
1,0,0,1,1,1,2,9,3,81,0.01,9,0.33,4.5,2,7,2,6,2,0
1,0,0,1,1,1,2,9,3,81,0.01,9,0.33,4.5,2,7,2,6,2,0
1,0,0,1,1,1,2,10.44,3.5,127.89,0.01,11,0.29,7.11,3,8,3,7,2,0
1,0,0,1,1,1,2,9.05,2,36.19,0.01,7,0.5,2,2,5,2,4,2,0
1,0,0,1,1,1,2,9.05,2,36.19,0.01,7,0.5,2,2,5,2,4,2,0
1,0,0,1,1,1,2,9.05,2,36.19,0.01,7,0.5,2,2,5,2,4,2,0
1,0,0,1,1,1,2,9.05,2,36.19,0.01,7,0.5,2,2,5,2,4,2,0
1,0,0,1,1,1,2,9.05,2,36.19,0.01,7,0.5,2,2,5,2,4,2,0
1,0,0,1,1,1,2,9.05,2,36.19,0.01,7,0.5,2,2,5,2,4,2,0
1,0,0,1,1,1,2,9.05,2,36.19,0.01,7,0.5,2,2,5,2,4,2,0
1,0,0,1,1,1,2,9.05,2,36.19,0.01,7,0.5,2,2,5,2,4,2,0
1,0,0,1,1,1,2,9.05,2,36.19,0.01,7,0.5,2,2,5,2,4,2,0
1,0,0,1,1,1,2,9.05,2,36.19,0.01,7,0.5,2,2,5,2,4,2,0
1,0,0,1,1,1,2,9.05,2,36.19,0.01,7,0.5,2,2,5,2,4,2,0
1,0,0,1,1,1,2,9.05,2,36.19,0.01,7,0.5,2,2,5,2,4,2,0
1,0,0,1,1,1,2,9.05,2,36.19,0.01,7,0.5,2,2,5,2,4,2,0
1,0,0,1,1,1,2,10.44,3.5,127.89,0.01,11,0.29,7.11,3,8,3,7,2,0
1,0,0,1,1,1,2,10.44,3.5,127.89,0.01,11,0.29,7.11,3,8,3,7,2,0
1,0,0,1,1,1,2,9.05,2,36.19,0.01,7,0.5,2,2,5,2,4,2,0
1,0,0,1,1,1,0,0,0,0,0,1,0,0,0,1,0,1,0,0
1,0,0,1,1,1,2,5.33,1.5,12,0,4,0.67,0.67,1,3,1,3,2,0
3,0,0,2,1,1,6,11.86,4.38,227.03,0.02,15,0.23,12.61,5,10,4,7,6,0
3,2,0,2,1,1,6,14.43,5.14,381.76,0.02,19,0.19,21.21,9,10,7,8,8,0
5,1,0,3,1,1,10,12.67,10,1267.11,0.04,31,0.1,70.4,14,17,7,10,11,0
3,1,0,2,1,1,6,11.71,4.9,281.06,0.02,16,0.2,15.61,7,9,5,7,7,0
3,1,0,2,1,1,6,11.71,4.9,281.06,0.02,16,0.2,15.61,7,9,5,7,7,0
1,0,0,1,1,1,2,5.33,1.5,12,0,4,0.67,0.67,1,3,1,3,2,0
1,0,0,1,1,1,2,5.33,1.5,12,0,4,0.67,0.67,1,3,1,3,2,0
3,1,0,2,1,1,6,11.23,5.6,352.28,0.02,17,0.18,19.57,7,10,5,8,7,0
7,1,1,4,1,3,13,18.91,10.45,2065.48,0.07,45,0.1,114.75,19,26,10,11,14,0
5,1,0,3,1,1,10,13.33,9,1080,0.04,30,0.11,60,14,16,7,9,11,0
3,1,0,2,1,1,6,11.71,4.9,281.06,0.02,16,0.2,15.61,7,9,5,7,7,0
7,1,1,4,1,3,13,18.91,10.45,2065.48,0.07,45,0.1,114.75,19,26,10,11,14,0
3,1,0,2,1,1,6,11.71,4.9,281.06,0.02,16,0.2,15.61,7,9,5,7,7,0
3,0,0,2,1,1,6,11.86,4.38,227.03,0.02,15,0.23,12.61,5,10,4,7,6,0
3,2,0,2,1,1,7,16.73,5.5,506,0.03,23,0.18,28.11,11,12,8,8,9,0
1,0,0,1,1,1,2,5.33,1.5,12,0,4,0.67,0.67,1,3,1,3,2,0
9,6,0,5,1,1,14,23.12,11.15,2875.94,0.09,57,0.09,159.77,29,28,13,10,20,0
3,1,0,2,1,1,7,14.43,5.14,381.76,0.02,19,0.19,21.21,9,10,7,8,8,0
7,1,1,4,1,3,13,19.62,10,1962.15,0.07,44,0.1,109.01,20,24,11,11,14,0
1,0,0,1,1,1,2,5.33,1.5,12,0,4,0.67,0.67,1,3,1,3,2,0
1,0,0,1,1,1,2,5.33,1.5,12,0,4,0.67,0.67,1,3,1,3,2,0
1,0,0,1,1,1,2,5.33,1.5,12,0,4,0.67,0.67,1,3,1,3,2,0
1,0,0,1,1,1,2,5.33,1.5,12,0,4,0.67,0.67,1,3,1,3,2,0
1,0,0,1,1,1,2,5.33,1.5,12,0,4,0.67,0.67,1,3,1,3,2,0
1,0,0,1,1,1,2,5.33,1.5,12,0,4,0.67,0.67,1,3,1,3,2,0
1,0,0,1,1,1,2,5.33,1.5,12,0,4,0.67,0.67,1,3,1,3,2,0
3,1,0,2,1,1,5,10.95,6,394.38,0.02,19,0.17,21.91,10,9,5,6,6,0
3,1,0,2,1,1,5,10.95,6,394.38,0.02,19,0.17,21.91,10,9,5,6,6,0
3,1,0,2,1,1,5,10.95,6,394.38,0.02,19,0.17,21.91,10,9,5,6,6,0
3,1,0,2,1,1,5,10.95,6,394.38,0.02,19,0.17,21.91,10,9,5,6,6,0
3,1,1,2,1,1,5,10.95,6,394.38,0.02,19,0.17,21.91,10,9,5,6,6,0
1,0,0,1,1,1,3,13,3,117,0.01,13,0.33,6.5,6,7,4,4,3,0
1,0,0,1,1,1,2,11.07,3,99.66,0.01,10,0.33,5.54,4,6,4,6,2,0
1,0,0,1,1,1,2,7.74,1.5,17.41,0,5,0.67,0.97,2,3,2,3,2,0
3,0,1,2,1,1,8,16.92,4.5,342.66,0.03,20,0.22,19.04,9,11,7,7,8,0
3,1,0,2,1,1,7,16.92,4.5,342.66,0.03,20,0.22,19.04,9,11,7,7,8,0
1,0,0,1,1,1,2,11.41,2.5,71.32,0.01,9,0.4,3.96,4,5,4,5,2,0
3,1,0,2,1,1,5,10.95,6,394.38,0.02,19,0.17,21.91,10,9,5,6,6,0
1,0,0,1,1,1,4,16.51,4.8,380.39,0.03,25,0.21,21.13,12,13,5,4,4,0
1,0,0,1,1,1,2,7.74,1.5,17.41,0,5,0.67,0.97,2,3,2,3,2,0
3,1,0,2,1,1,5,10.95,6,394.38,0.02,19,0.17,21.91,10,9,5,6,6,0
3,1,0,2,1,1,5,10.95,6,394.38,0.02,19,0.17,21.91,10,9,5,6,6,0
1,0,0,1,1,1,2,9.83,2,39.3,0.01,7,0.5,2.18,3,4,3,4,2,0
1,0,0,1,1,1,2,7.86,2.5,49.13,0.01,7,0.4,2.73,2,5,2,5,2,0
1,0,0,1,1,1,2,7.49,3,67.38,0.01,8,0.33,3.74,1,7,1,6,2,0
1,0,0,1,1,1,2,7.49,3,67.38,0.01,8,0.33,3.74,1,7,1,6,2,0
1,0,0,1,1,1,2,7.49,3,67.38,0.01,8,0.33,3.74,1,7,1,6,2,0
1,0,0,1,1,1,2,7.49,3,67.38,0.01,8,0.33,3.74,1,7,1,6,2,0
1,0,0,1,1,1,2,7.49,3,67.38,0.01,8,0.33,3.74,1,7,1,6,2,0
1,0,0,1,1,1,2,7.49,3,67.38,0.01,8,0.33,3.74,1,7,1,6,2,0
1,0,0,1,1,1,2,7.49,3,67.38,0.01,8,0.33,3.74,1,7,1,6,2,0
1,0,0,1,1,1,2,10.57,3,95.1,0.01,10,0.33,5.28,3,7,3,6,2,0
1,0,0,1,1,1,0,0,0,0,0,1,0,0,0,1,0,1,0,0
1,0,0,1,1,1,2,5.33,1.5,12,0,4,0.67,0.67,1,3,1,3,2,0
1,0,0,1,1,1,2,5.33,1.5,12,0,4,0.67,0.67,1,3,1,3,2,0
1,0,0,1,1,1,2,5.33,1.5,12,0,4,0.67,0.67,1,3,1,3,2,0
1,0,0,1,1,1,2,5.33,1.5,12,0,4,0.67,0.67,1,3,1,3,2,0
1,0,0,1,1,1,2,5.33,1.5,12,0,4,0.67,0.67,1,3,1,3,2,0
1,0,0,1,1,1,2,5.33,1.5,12,0,4,0.67,0.67,1,3,1,3,2,0
1,0,0,1,1,1,2,5.33,1.5,12,0,4,0.67,0.67,1,3,1,3,2,0
1,0,0,1,1,1,2,13.95,2.5,87.17,0.01,11,0.4,4.84,4,7,4,5,2,0
1,0,0,1,1,1,1,0,0,0,0,1,0,0,0,1,0,1,1,0
1,0,0,1,1,1,1,0,0,0,0,1,0,0,0,1,0,1,1,0
1,0,0,1,1,1,1,0,0,0,0,1,0,0,0,1,0,1,1,0
1,0,0,1,1,1,1,0,0,0,0,1,0,0,0,1,0,1,1,0
1,0,0,1,1,1,1,0,0,0,0,1,0,0,0,1,0,1,1,0
1,0,0,1,1,1,1,0,0,0,0,1,0,0,0,1,0,1,1,0
1,0,0,1,1,1,0,0,0,0,0,1,0,0,0,1,0,1,0,0
5,0,0,3,1,1,2,13.29,4.5,269.08,0.02,18,0.22,14.95,6,12,4,6,2,0
1,0,1,1,1,1,2,16.92,3.5,207.22,0.02,16,0.29,11.51,6,10,6,7,2,0
1,0,0,1,1,1,0,0,0,0,0,1,0,0,0,1,0,1,0,0
1,0,0,1,1,1,2,0,0,0,0,3,0,0,0,3,0,3,2,0
1,0,0,1,1,1,2,0,0,0,0,3,0,0,0,3,0,3,2,0
1,0,0,1,1,1,2,0,0,0,0,3,0,0,0,3,0,3,2,0
1,0,0,1,1,1,2,0,0,0,0,3,0,0,0,3,0,3,2,0
1,0,0,1,1,1,2,0,0,0,0,3,0,0,0,3,0,3,2,0
1,0,0,1,1,1,2,0,0,0,0,3,0,0,0,3,0,3,2,0
1,0,0,1,1,1,2,0,0,0,0,3,0,0,0,3,0,3,2,0
1,0,0,1,1,1,2,0,0,0,0,3,0,0,0,3,0,3,2,0
1,0,0,1,1,1,2,0,0,0,0,3,0,0,0,3,0,3,2,0
1,0,0,1,1,1,2,0,0,0,0,3,0,0,0,3,0,3,2,0
1,0,0,1,1,1,2,0,0,0,0,3,0,0,0,3,0,3,2,0
1,0,0,1,1,1,3,11.63,2,46.53,0.01,9,0.5,2.58,4,5,3,3,3,0
1,0,0,1,1,1,0,5.33,1.5,12,0,4,0.67,0.67,1,3,1,3,0,0
1,0,0,1,1,1,0,5.33,1.5,12,0,4,0.67,0.67,1,3,1,3,0,0
1,0,0,1,1,1,0,5.33,1.5,12,0,4,0.67,0.67,1,3,1,3,0,0
1,0,0,1,1,1,2,0,0,0,0,3,0,0,0,3,0,3,2,0
1,0,0,1,1,1,2,5.33,1.5,12,0,4,0.67,0.67,1,3,1,3,2,0
1,0,0,1,1,1,2,0,0,0,0,3,0,0,0,3,0,3,2,0
1,0,0,1,1,1,2,0,0,0,0,3,0,0,0,3,0,3,2,0
1,0,0,1,1,1,2,0,0,0,0,3,0,0,0,3,0,3,2,0
1,0,0,1,1,1,2,0,0,0,0,3,0,0,0,3,0,3,2,0
1,0,0,1,1,1,2,0,0,0,0,3,0,0,0,3,0,3,2,0
1,0,0,1,1,1,2,0,0,0,0,3,0,0,0,3,0,3,2,0
1,0,0,1,1,1,2,0,0,0,0,3,0,0,0,3,0,3,2,0
1,0,0,1,1,1,2,0,0,0,0,3,0,0,0,3,0,3,2,0
1,0,0,1,1,1,2,0,0,0,0,3,0,0,0,3,0,3,2,0
1,0,0,1,1,1,2,0,0,0,0,3,0,0,0,3,0,3,2,0
1,0,0,1,1,1,2,0,0,0,0,3,0,0,0,3,0,3,2,0
1,0,0,1,1,1,0,7.74,1.5,17.41,0,5,0.67,0.97,2,3,2,3,0,0
1,0,0,1,1,1,0,7.74,1.5,17.41,0,5,0.67,0.97,2,3,2,3,0,0
1,0,0,1,1,1,0,0,0,0,0,3,0,0,0,3,0,3,0,0
1,0,0,1,1,1,0,5.33,1.5,12,0,4,0.67,0.67,1,3,1,3,0,0
1,0,0,1,1,1,2,0,0,0,0,3,0,0,0,3,0,3,2,0
1,0,0,1,1,1,2,0,0,0,0,3,0,0,0,3,0,3,2,0
1,0,0,1,1,1,2,0,0,0,0,3,0,0,0,3,0,3,2,0
1,0,0,1,1,1,2,0,0,0,0,3,0,0,0,3,0,3,2,0
1,0,0,1,1,1,2,0,0,0,0,3,0,0,0,3,0,3,2,0
1,0,0,1,1,1,2,0,0,0,0,3,0,0,0,3,0,3,2,0
1,0,0,1,1,1,2,0,0,0,0,3,0,0,0,3,0,3,2,0
1,0,0,1,1,1,2,0,0,0,0,3,0,0,0,3,0,3,2,0
1,0,0,1,1,1,2,0,0,0,0,3,0,0,0,3,0,3,2,0
1,0,0,1,1,1,2,0,0,0,0,3,0,0,0,3,0,3,2,0
1,0,0,1,1,1,2,0,0,0,0,3,0,0,0,3,0,3,2,0
5,0,5,3,1,1,7,13.32,13.71,2505.06,0.06,43,0.07,139.17,16,27,7,12,7,0
5,0,5,3,1,1,7,13.32,13.71,2505.06,0.06,43,0.07,139.17,16,27,7,12,7,0
1,0,0,1,1,1,1,0,0,0,0,1,0,0,0,1,0,1,1,0
9,0,2,7,2,1,31,34.66,14.62,7413.09,0.17,94,0.07,411.84,39,55,24,18,31,1
387,42,523,195,75,101,1163,267.52,157.53,6638898.42,14.05,5306,0.01,368827.68,2107,3199,214,32,1205,1
5,1,0,4,1,1,15,24.32,6,875.68,0.05,35,0.17,48.65,12,23,9,9,16,0
1,0,4,1,1,1,23,76.92,6,2769.05,0.15,95,0.17,153.84,46,49,23,6,23,1
24,2,12,15,13,4,71,45.17,39.21,69467.01,0.59,290,0.03,3859.28,122,168,42,27,73,1
26,2,7,14,9,7,62,39.94,34.02,46242.35,0.45,221,0.03,2569.02,93,128,41,30,64,1
11,1,1,6,1,6,14,18.32,19,6613.2,0.12,69,0.05,367.4,28,41,14,19,15,1
7,1,2,4,1,4,12,14,10.67,1592.95,0.05,34,0.09,88.5,16,18,9,12,13,0
7,0,0,4,1,1,5,15.29,12.25,2294.38,0.06,42,0.08,127.47,14,28,8,14,5,1
60,7,27,31,26,1,121,87.83,42.11,155774.83,1.23,567,0.02,8654.16,268,299,70,22,128,1
1,0,4,1,1,1,69,138.06,18.21,45776.25,0.84,441,0.05,2543.13,174,267,43,9,69,1
107,8,358,54,25,30,1584,1011.08,65.5,4337591.21,22.07,7731,0.02,240977.31,2972,4759,363,16,1592,1
7,0,12,4,2,4,20,47.39,10.75,5476.95,0.17,101,0.09,304.28,43,58,22,11,20,1
5,1,15,3,3,1,18,56.53,9,4578.72,0.17,100,0.11,254.37,50,50,25,9,19,1
149,3,250,103,88,10,469,88.36,216.34,4135634.05,6.37,2356,0,229757.46,1047,1309,196,81,472,1
121,9,119,72,35,32,244,58.08,132.62,1021587.14,2.57,985,0.01,56754.84,440,545,141,85,253,1
7,0,3,4,1,4,14,18.46,12.5,2884.41,0.08,48,0.08,160.25,25,23,14,14,14,0
33,1,11,17,11,12,63,44.9,26.35,31175.41,0.39,213,0.04,1731.97,93,120,30,17,64,1
9,2,1,8,1,1,27,34.09,9.88,3329.22,0.11,68,0.1,184.96,24,44,17,14,29,0
3,0,1,2,1,1,2,12.09,6.3,479.73,0.03,20,0.16,26.65,7,13,5,9,2,0
1,0,0,1,1,1,2,5.33,1.5,12,0,4,0.67,0.67,1,3,1,3,2,0
1,0,0,1,1,1,2,5.33,1.5,12,0,4,0.67,0.67,1,3,1,3,2,0
1,0,0,1,1,1,2,5.33,1.5,12,0,4,0.67,0.67,1,3,1,3,2,0
1,0,0,1,1,1,2,5.33,1.5,12,0,4,0.67,0.67,1,3,1,3,2,0
1,0,0,1,1,1,2,5.33,1.5,12,0,4,0.67,0.67,1,3,1,3,2,0
1,0,0,1,1,1,2,5.33,1.5,12,0,4,0.67,0.67,1,3,1,3,2,0
1,0,0,1,1,1,2,5.33,1.5,12,0,4,0.67,0.67,1,3,1,3,2,0
1,0,0,1,1,1,2,5.33,1.5,12,0,4,0.67,0.67,1,3,1,3,2,0
1,0,0,1,1,1,2,5.33,1.5,12,0,4,0.67,0.67,1,3,1,3,2,0
1,0,0,1,1,1,2,0,0,0,0,4,0,0,0,4,0,4,2,0
1,0,0,1,1,1,0,0,0,0,0,5,0,0,0,5,0,5,0,0
1,0,0,1,1,1,0,0,0,0,0,5,0,0,0,5,0,5,0,0
1,0,0,1,1,1,1,0,0,0,0,1,0,0,0,1,0,1,1,0
1,0,0,1,1,1,0,0,0,0,0,1,0,0,0,1,0,1,0,0
1,0,0,1,1,1,0,0,0,0,0,1,0,0,0,1,0,1,0,0
1,0,0,1,1,1,2,0,0,0,0.01,6,0,0,0,6,0,6,2,0
1,0,0,1,1,1,2,0,0,0,0,5,0,0,0,5,0,5,2,0
1,0,0,1,1,1,2,0,0,0,0.01,6,0,0,0,6,0,6,2,0
11,1,4,6,1,1,21,13.86,22.5,7014.99,0.1,68,0.04,389.72,27,41,9,15,22,0
1,0,0,1,1,1,0,0,0,0,0,1,0,0,0,1,0,1,0,0
1,0,3,1,1,1,2,5.33,1.5,12,0,4,0.67,0.67,1,3,1,3,2,0
1,0,0,1,1,1,2,5.33,1.5,12,0,4,0.67,0.67,1,3,1,3,2,0
3,1,0,2,1,1,6,11.71,4.9,281.06,0.02,16,0.2,15.61,7,9,5,7,7,0
1,0,1,1,1,1,2,5.33,1.5,12,0,4,0.67,0.67,1,3,1,3,2,0
1,0,0,1,1,1,2,5.33,1.5,12,0,4,0.67,0.67,1,3,1,3,2,0
1,0,0,1,1,1,2,6.97,2,27.86,0,6,0.5,1.55,1,5,1,4,2,0
1,0,1,1,1,1,2,10.8,2.5,67.5,0.01,9,0.4,3.75,3,6,3,5,2,0
1,0,0,1,1,1,2,9.05,2,36.19,0.01,7,0.5,2,2,5,2,4,2,0
1,0,0,1,1,1,2,7.49,3,67.38,0.01,8,0.33,3.74,1,7,1,6,2,0
1,0,0,1,1,1,2,9,3,81,0.01,9,0.33,4.5,2,7,2,6,2,0
1,0,0,1,1,1,2,9,3,81,0.01,9,0.33,4.5,2,7,2,6,2,0
1,0,0,1,1,1,2,7.49,3,67.38,0.01,8,0.33,3.74,1,7,1,6,2,0
1,0,0,1,1,1,2,10.8,2.5,67.5,0.01,9,0.4,3.75,3,6,3,5,2,0
1,0,0,1,1,1,2,9,3,81,0.01,9,0.33,4.5,2,7,2,6,2,0
1,0,0,1,1,1,2,9.05,2,36.19,0.01,7,0.5,2,2,5,2,4,2,0
1,0,0,1,1,1,2,9.05,2,36.19,0.01,7,0.5,2,2,5,2,4,2,0
1,0,0,1,1,1,2,20.97,3,188.72,0.02,17,0.33,10.48,7,10,7,6,2,0
1,0,0,1,1,1,2,20.97,3,188.72,0.02,17,0.33,10.48,7,10,7,6,2,0
1,0,0,1,1,1,2,27.35,3,246.13,0.03,21,0.33,13.67,9,12,9,6,2,0
1,0,0,1,1,1,3,30.67,3,276,0.03,23,0.33,15.33,10,13,10,6,3,0
1,0,0,1,1,1,3,30.67,3,276,0.03,23,0.33,15.33,10,13,10,6,3,0
1,0,0,1,1,1,3,30.67,3,276,0.03,23,0.33,15.33,10,13,10,6,3,0
1,0,0,1,1,1,2,27.35,3,246.13,0.03,21,0.33,13.67,9,12,9,6,2,0
1,0,0,1,1,1,3,27.35,3,246.13,0.03,21,0.33,13.67,9,12,9,6,3,0
1,0,0,1,1,1,2,20.97,3,188.72,0.02,17,0.33,10.48,7,10,7,6,2,0
1,0,0,1,1,1,2,20.97,3,188.72,0.02,17,0.33,10.48,7,10,7,6,2,0
1,0,0,1,1,1,2,20.97,3,188.72,0.02,17,0.33,10.48,7,10,7,6,2,0
1,0,0,1,1,1,2,17.92,3,161.32,0.02,15,0.33,8.96,6,9,6,6,2,0
1,0,0,1,1,1,2,17.92,3,161.32,0.02,15,0.33,8.96,6,9,6,6,2,0
1,0,0,1,1,1,2,14.99,3,134.92,0.01,13,0.33,7.5,5,8,5,6,2,0
1,0,0,1,1,1,2,14.99,3,134.92,0.01,13,0.33,7.5,5,8,5,6,2,0
1,0,0,1,1,1,2,14.99,3,134.92,0.01,13,0.33,7.5,5,8,5,6,2,0
1,0,0,1,1,1,2,14.99,3,134.92,0.01,13,0.33,7.5,5,8,5,6,2,0
1,0,0,1,1,1,2,14.99,3,134.92,0.01,13,0.33,7.5,5,8,5,6,2,0
1,0,0,1,1,1,2,17.92,3,161.32,0.02,15,0.33,8.96,6,9,6,6,2,0
1,0,0,1,1,1,2,17.92,3,161.32,0.02,15,0.33,8.96,6,9,6,6,2,0
1,0,0,1,1,1,2,20.97,3,188.72,0.02,17,0.33,10.48,7,10,7,6,2,0
1,0,0,1,1,1,2,20.97,3,188.72,0.02,17,0.33,10.48,7,10,7,6,2,0
1,0,0,1,1,1,1,0,0,0,0,0,0,0,0,0,0,0,1,0
1,0,0,1,1,1,1,0,0,0,0,1,0,0,0,1,0,1,1,0
1,0,0,1,1,1,2,5.33,1.5,12,0,4,0.67,0.67,1,3,1,3,2,0
1,0,0,1,1,1,2,5.33,1.5,12,0,4,0.67,0.67,1,3,1,3,2,0
1,9,0,1,1,1,2,0,0,0,0,9,0,0,9,0,1,0,11,0
1,0,0,1,1,1,1,0,0,0,0,0,0,0,0,0,0,0,1,0
1,0,0,1,1,1,1,0,0,0,0,0,0,0,0,0,0,0,1,0
1,0,0,1,1,1,1,0,0,0,0,1,0,0,0,1,0,1,1,0
1,0,0,1,1,1,4,18.49,2.4,106.51,0.01,14,0.42,5.92,6,8,5,4,4,0
1,0,0,1,1,1,2,5.33,1.5,12,0,4,0.67,0.67,1,3,1,3,2,0
1,0,0,1,1,1,5,8.45,0.75,4.75,0,4,1.33,0.26,3,1,2,1,5,0
1,0,0,1,1,1,1,0,0,0,0,0,0,0,0,0,0,0,1,0
1,0,0,1,1,1,1,0,0,0,0,1,0,0,0,1,0,1,1,0
1,0,0,1,1,1,3,10.8,2.5,67.5,0.01,9,0.4,3.75,3,6,3,5,3,0
1,0,0,1,1,1,2,5.33,1.5,12,0,4,0.67,0.67,1,3,1,3,2,0
1,0,0,1,1,1,2,6.2,2.5,38.77,0.01,6,0.4,2.15,1,5,1,5,2,0
1,0,0,1,1,1,4,9.51,0.5,2.38,0,3,2,0.13,2,1,2,1,4,0
1,0,0,1,1,1,1,0,0,0,0,1,0,0,0,1,0,1,1,0
1,0,0,1,1,1,2,5.33,1.5,12,0,4,0.67,0.67,1,3,1,3,2,0
1,0,0,1,1,1,2,5.33,1.5,12,0,4,0.67,0.67,1,3,1,3,2,0
1,0,0,1,1,1,2,0,0,0,0,4,0,0,0,4,0,4,2,0
1,0,0,1,1,1,1,0,0,0,0,1,0,0,0,1,0,1,1,0
1,0,0,1,1,1,2,0,0,0,0,5,0,0,0,5,0,5,2,0
1,0,0,1,1,1,1,0,0,0,0,1,0,0,0,1,0,1,1,0
1,0,0,1,1,1,2,5.33,1.5,12,0,4,0.67,0.67,1,3,1,3,2,0
1,0,0,1,1,1,2,5.33,1.5,12,0,4,0.67,0.67,1,3,1,3,2,0
1,0,0,1,1,1,1,0,0,0,0,1,0,0,0,1,0,1,1,0
1,0,0,1,1,1,6,16.68,7.5,938.23,0.04,30,0.13,52.12,12,18,8,10,6,0
1,0,0,1,1,1,2,5.33,1.5,12,0,4,0.67,0.67,1,3,1,3,2,0
1,0,0,1,1,1,2,10.44,3.5,127.89,0.01,11,0.29,7.11,3,8,3,7,2,0
1,0,0,1,1,1,0,0,0,0,0,1,0,0,0,1,0,1,0,0
1,0,0,1,1,1,2,5.33,1.5,12,0,4,0.67,0.67,1,3,1,3,2,0
1,0,0,1,1,1,2,8,3,72,0.01,8,0.33,4,2,6,2,6,2,0
1,0,0,1,1,1,2,0,0,0,0,5,0,0,0,5,0,5,2,0
1,0,0,1,1,1,0,0,0,0,0,1,0,0,0,1,0,1,0,0
1,0,0,1,1,1,2,0,0,0,0.01,6,0,0,0,6,0,6,2,0
1,0,0,1,1,1,2,7.75,2,31.02,0.01,6,0.5,1.72,2,4,2,4,2,0
1,0,0,1,1,1,2,7.74,1.5,17.41,0,5,0.67,0.97,2,3,2,3,2,0
1,1,1,1,1,1,1,0,0,0,0,1,0,0,1,0,1,0,2,0
3,1,0,2,1,1,7,12.44,4.9,298.63,0.02,17,0.2,16.59,7,10,5,7,8,0
1,0,0,1,1,1,0,0,0,0,0,1,0,0,0,1,0,1,0,0
3,1,0,2,2,1,6,10.88,6.3,431.75,0.02,18,0.16,23.99,7,11,5,9,7,0
1,0,0,1,1,1,2,5.33,1.5,12,0,4,0.67,0.67,1,3,1,3,2,0
1,0,0,1,1,1,2,0,0,0,0,5,0,0,0,5,0,5,2,0
1,0,0,1,1,1,0,0,0,0,0,1,0,0,0,1,0,1,0,0
1,0,0,1,1,1,2,0,0,0,0.01,6,0,0,0,6,0,6,2,0
1,0,3,1,1,1,4,0,0,0,0,3,0,0,3,0,2,0,4,0
1,0,0,1,1,1,0,0,0,0,0,1,0,0,0,1,0,1,0,0
3,2,1,2,1,1,5,10.33,4.5,209.28,0.02,14,0.22,11.63,6,8,4,6,7,0
3,1,0,2,1,1,6,13.45,3.6,174.36,0.02,14,0.28,9.69,6,8,5,6,7,0
1,0,0,1,1,1,2,0,0,0,0,5,0,0,0,5,0,5,2,0
1,0,0,1,1,1,0,0,0,0,0,1,0,0,0,1,0,1,0,0
1,0,0,1,1,1,2,0,0,0,0.01,6,0,0,0,6,0,6,2,0
1,0,0,1,1,1,0,0,0,0,0,1,0,0,0,1,0,1,0,0
1,0,0,1,1,1,2,6.55,3,58.95,0.01,7,0.33,3.28,1,6,1,6,2,0
1,0,0,1,1,1,2,5.33,1.5,12,0,4,0.67,0.67,1,3,1,3,2,0
1,0,0,1,1,1,2,8,3,72,0.01,8,0.33,4,2,6,2,6,2,0
1,0,0,1,1,1,2,9,3,81,0.01,9,0.33,4.5,2,7,2,6,2,0
1,0,0,1,1,1,2,8,3,72,0.01,8,0.33,4,2,6,2,6,2,0
1,0,0,1,1,1,2,9.49,3.5,116.27,0.01,10,0.29,6.46,3,7,3,7,2,0
1,0,0,1,1,1,2,11.86,3.5,145.3,0.01,12,0.29,8.07,4,8,4,7,2,0
1,0,0,1,1,1,2,0,0,0,0,5,0,0,0,5,0,5,2,0
1,0,0,1,1,1,0,0,0,0,0,1,0,0,0,1,0,1,0,0
1,0,0,1,1,1,2,0,0,0,0.01,6,0,0,0,6,0,6,2,0
1,0,0,1,1,1,2,7.75,2,31.02,0.01,6,0.5,1.72,2,4,2,4,2,0
1,0,0,1,1,1,3,10.8,3.33,120,0.01,12,0.3,6.67,4,8,3,5,3,0
1,0,0,1,1,1,2,7.75,2,31.02,0.01,6,0.5,1.72,2,4,2,4,2,0
1,0,0,1,1,1,3,12.68,2.5,79.25,0.01,10,0.4,4.4,4,6,4,5,3,0
1,3,1,1,1,1,1,0,0,0,0,1,0,0,1,0,1,0,4,0
1,0,0,1,1,1,2,6.55,3,58.95,0.01,7,0.33,3.28,1,6,1,6,2,0
1,0,0,1,1,1,0,0,0,0,0,1,0,0,0,1,0,1,0,0
1,0,0,1,1,1,2,8,3,72,0.01,8,0.33,4,2,6,2,6,2,0
1,0,0,1,1,1,2,9,3,81,0.01,9,0.33,4.5,2,7,2,6,2,0
1,0,0,1,1,1,2,5.33,1.5,12,0,4,0.67,0.67,1,3,1,3,2,0
1,0,0,1,1,1,2,5.33,1.5,12,0,4,0.67,0.67,1,3,1,3,2,0
1,0,0,1,1,1,2,6.55,3,58.95,0.01,7,0.33,3.28,1,6,1,6,2,0
1,0,0,1,1,1,2,5.33,1.5,12,0,4,0.67,0.67,1,3,1,3,2,0
1,0,0,1,1,1,2,5.33,1.5,12,0,4,0.67,0.67,1,3,1,3,2,0
1,0,0,1,1,1,2,6.55,3,58.95,0.01,7,0.33,3.28,1,6,1,6,2,0
1,0,0,1,1,1,2,0,0,0,0,5,0,0,0,5,0,5,2,0
1,0,0,1,1,1,0,0,0,0,0,1,0,0,0,1,0,1,0,0
1,0,0,1,1,1,2,0,0,0,0.01,6,0,0,0,6,0,6,2,0
1,0,0,1,1,1,0,0,0,0,0,1,0,0,0,1,0,1,0,0
1,0,1,1,1,1,2,9.51,3,85.59,0.01,9,0.33,4.75,3,6,3,6,2,0
1,0,0,1,1,1,2,0,0,0,0,5,0,0,0,5,0,5,2,0
1,0,0,1,1,1,0,0,0,0,0,1,0,0,0,1,0,1,0,0
1,0,0,1,1,1,2,0,0,0,0.01,6,0,0,0,6,0,6,2,0
1,0,0,1,1,1,2,10.44,3.5,127.89,0.01,11,0.29,7.11,3,8,3,7,2,0
1,0,0,1,1,1,2,7.49,3,67.38,0.01,8,0.33,3.74,1,7,1,6,2,0
1,0,0,1,1,1,2,9,3,81,0.01,9,0.33,4.5,2,7,2,6,2,0
1,0,0,1,1,1,2,9,3,81,0.01,9,0.33,4.5,2,7,2,6,2,0
1,0,0,1,1,1,2,9,3,81,0.01,9,0.33,4.5,2,7,2,6,2,0
1,0,0,1,1,1,2,10.44,3.5,127.89,0.01,11,0.29,7.11,3,8,3,7,2,0
1,0,0,1,1,1,2,9,3,81,0.01,9,0.33,4.5,2,7,2,6,2,0
1,0,0,1,1,1,2,9,3,81,0.01,9,0.33,4.5,2,7,2,6,2,0
1,0,0,1,1,1,2,7.49,3,67.38,0.01,8,0.33,3.74,1,7,1,6,2,0
1,0,0,1,1,1,2,7.49,3,67.38,0.01,8,0.33,3.74,1,7,1,6,2,0
1,0,0,1,1,1,2,10,3,90,0.01,10,0.33,5,2,8,2,6,2,0
1,0,0,1,1,1,3,10.44,3.5,127.89,0.01,11,0.29,7.11,3,8,3,7,3,0
1,0,0,1,1,1,3,11.39,3.5,139.52,0.01,12,0.29,7.75,3,9,3,7,3,0
1,0,0,1,1,1,2,9,3,81,0.01,9,0.33,4.5,2,7,2,6,2,0
1,0,0,1,1,1,2,10.44,3.5,127.89,0.01,11,0.29,7.11,3,8,3,7,2,0
1,0,0,1,1,1,2,9,3,81,0.01,9,0.33,4.5,2,7,2,6,2,0
1,0,0,1,1,1,2,9,3,81,0.01,9,0.33,4.5,2,7,2,6,2,0
1,0,0,1,1,1,2,10.44,3.5,127.89,0.01,11,0.29,7.11,3,8,3,7,2,0
1,0,0,1,1,1,2,9,3,81,0.01,9,0.33,4.5,2,7,2,6,2,0
1,0,0,1,1,1,2,9,3,81,0.01,9,0.33,4.5,2,7,2,6,2,0
1,0,0,1,1,1,2,9,3,81,0.01,9,0.33,4.5,2,7,2,6,2,0
1,0,0,1,1,1,2,7.49,3,67.38,0.01,8,0.33,3.74,1,7,1,6,2,0
1,0,0,1,1,1,2,9,3,81,0.01,9,0.33,4.5,2,7,2,6,2,0
1,0,0,1,1,1,2,9,3,81,0.01,9,0.33,4.5,2,7,2,6,2,0
1,0,0,1,1,1,2,10.44,3.5,127.89,0.01,11,0.29,7.11,3,8,3,7,2,0
1,0,0,1,1,1,2,9.05,2,36.19,0.01,7,0.5,2,2,5,2,4,2,0
1,0,0,1,1,1,2,9.05,2,36.19,0.01,7,0.5,2,2,5,2,4,2,0
1,0,0,1,1,1,2,9.05,2,36.19,0.01,7,0.5,2,2,5,2,4,2,0
1,0,0,1,1,1,2,9.05,2,36.19,0.01,7,0.5,2,2,5,2,4,2,0
1,0,0,1,1,1,2,9.05,2,36.19,0.01,7,0.5,2,2,5,2,4,2,0
1,0,0,1,1,1,2,9.05,2,36.19,0.01,7,0.5,2,2,5,2,4,2,0
1,0,0,1,1,1,2,9.05,2,36.19,0.01,7,0.5,2,2,5,2,4,2,0
1,0,0,1,1,1,2,9.05,2,36.19,0.01,7,0.5,2,2,5,2,4,2,0
1,0,0,1,1,1,2,9.05,2,36.19,0.01,7,0.5,2,2,5,2,4,2,0
1,0,0,1,1,1,2,9.05,2,36.19,0.01,7,0.5,2,2,5,2,4,2,0
1,0,0,1,1,1,2,9.05,2,36.19,0.01,7,0.5,2,2,5,2,4,2,0
1,0,0,1,1,1,2,9.05,2,36.19,0.01,7,0.5,2,2,5,2,4,2,0
1,0,0,1,1,1,2,9.05,2,36.19,0.01,7,0.5,2,2,5,2,4,2,0
1,0,0,1,1,1,2,10.44,3.5,127.89,0.01,11,0.29,7.11,3,8,3,7,2,0
1,0,0,1,1,1,2,10.44,3.5,127.89,0.01,11,0.29,7.11,3,8,3,7,2,0
1,0,0,1,1,1,2,9.05,2,36.19,0.01,7,0.5,2,2,5,2,4,2,0
1,0,0,1,1,1,0,0,0,0,0,1,0,0,0,1,0,1,0,0
1,0,0,1,1,1,2,5.33,1.5,12,0,4,0.67,0.67,1,3,1,3,2,0
3,0,0,2,1,1,6,11.86,4.38,227.03,0.02,15,0.23,12.61,5,10,4,7,6,0
3,2,0,2,1,1,6,14.43,5.14,381.76,0.02,19,0.19,21.21,9,10,7,8,8,0
5,1,0,3,1,1,10,12.67,10,1267.11,0.04,31,0.1,70.4,14,17,7,10,11,0
3,1,0,2,1,1,6,11.71,4.9,281.06,0.02,16,0.2,15.61,7,9,5,7,7,0
3,1,0,2,1,1,6,11.71,4.9,281.06,0.02,16,0.2,15.61,7,9,5,7,7,0
1,0,0,1,1,1,2,5.33,1.5,12,0,4,0.67,0.67,1,3,1,3,2,0
1,0,0,1,1,1,2,5.33,1.5,12,0,4,0.67,0.67,1,3,1,3,2,0
3,1,0,2,1,1,6,11.23,5.6,352.28,0.02,17,0.18,19.57,7,10,5,8,7,0
7,1,1,4,1,3,13,18.91,10.45,2065.48,0.07,45,0.1,114.75,19,26,10,11,14,0
5,1,0,3,1,1,10,13.33,9,1080,0.04,30,0.11,60,14,16,7,9,11,0
3,1,0,2,1,1,6,11.71,4.9,281.06,0.02,16,0.2,15.61,7,9,5,7,7,0
7,1,1,4,1,3,13,18.91,10.45,2065.48,0.07,45,0.1,114.75,19,26,10,11,14,0
3,1,0,2,1,1,6,11.71,4.9,281.06,0.02,16,0.2,15.61,7,9,5,7,7,0
3,0,0,2,1,1,6,11.86,4.38,227.03,0.02,15,0.23,12.61,5,10,4,7,6,0
3,2,0,2,1,1,7,16.73,5.5,506,0.03,23,0.18,28.11,11,12,8,8,9,0
1,0,0,1,1,1,2,5.33,1.5,12,0,4,0.67,0.67,1,3,1,3,2,0
9,6,0,5,1,1,14,23.12,11.15,2875.94,0.09,57,0.09,159.77,29,28,13,10,20,0
3,1,0,2,1,1,7,14.43,5.14,381.76,0.02,19,0.19,21.21,9,10,7,8,8,0
7,1,1,4,1,3,13,19.62,10,1962.15,0.07,44,0.1,109.01,20,24,11,11,14,0
1,0,0,1,1,1,2,5.33,1.5,12,0,4,0.67,0.67,1,3,1,3,2,0
1,0,0,1,1,1,2,5.33,1.5,12,0,4,0.67,0.67,1,3,1,3,2,0
1,0,0,1,1,1,2,5.33,1.5,12,0,4,0.67,0.67,1,3,1,3,2,0
1,0,0,1,1,1,2,5.33,1.5,12,0,4,0.67,0.67,1,3,1,3,2,0
1,0,0,1,1,1,2,5.33,1.5,12,0,4,0.67,0.67,1,3,1,3,2,0
1,0,0,1,1,1,2,5.33,1.5,12,0,4,0.67,0.67,1,3,1,3,2,0
1,0,0,1,1,1,2,5.33,1.5,12,0,4,0.67,0.67,1,3,1,3,2,0
3,1,0,2,1,1,5,10.95,6,394.38,0.02,19,0.17,21.91,10,9,5,6,6,0
3,1,0,2,1,1,5,10.95,6,394.38,0.02,19,0.17,21.91,10,9,5,6,6,0
3,1,0,2,1,1,5,10.95,6,394.38,0.02,19,0.17,21.91,10,9,5,6,6,0
3,1,0,2,1,1,5,10.95,6,394.38,0.02,19,0.17,21.91,10,9,5,6,6,0
3,1,1,2,1,1,5,10.95,6,394.38,0.02,19,0.17,21.91,10,9,5,6,6,0
1,0,0,1,1,1,3,13,3,117,0.01,13,0.33,6.5,6,7,4,4,3,0
1,0,0,1,1,1,2,11.07,3,99.66,0.01,10,0.33,5.54,4,6,4,6,2,0
1,0,0,1,1,1,2,7.74,1.5,17.41,0,5,0.67,0.97,2,3,2,3,2,0
3,0,1,2,1,1,8,16.92,4.5,342.66,0.03,20,0.22,19.04,9,11,7,7,8,0
3,1,0,2,1,1,7,16.92,4.5,342.66,0.03,20,0.22,19.04,9,11,7,7,8,0
1,0,0,1,1,1,2,11.41,2.5,71.32,0.01,9,0.4,3.96,4,5,4,5,2,0
3,1,0,2,1,1,5,10.95,6,394.38,0.02,19,0.17,21.91,10,9,5,6,6,0
1,0,0,1,1,1,4,16.51,4.8,380.39,0.03,25,0.21,21.13,12,13,5,4,4,0
1,0,0,1,1,1,2,7.74,1.5,17.41,0,5,0.67,0.97,2,3,2,3,2,0
3,1,0,2,1,1,5,10.95,6,394.38,0.02,19,0.17,21.91,10,9,5,6,6,0
3,1,0,2,1,1,5,10.95,6,394.38,0.02,19,0.17,21.91,10,9,5,6,6,0
1,0,0,1,1,1,2,9.83,2,39.3,0.01,7,0.5,2.18,3,4,3,4,2,0
1,0,0,1,1,1,1,0,0,0,0,1,0,0,0,1,0,1,1,0
1,0,0,1,1,1,1,0,0,0,0,1,0,0,0,1,0,1,1,0
1,0,0,1,1,1,1,0,0,0,0,1,0,0,0,1,0,1,1,0
1,0,0,1,1,1,1,0,0,0,0,1,0,0,0,1,0,1,1,0
1,0,0,1,1,1,1,0,0,0,0,1,0,0,0,1,0,1,1,0
1,0,0,1,1,1,1,0,0,0,0,1,0,0,0,1,0,1,1,0
1,0,0,1,1,1,0,0,0,0,0,1,0,0,0,1,0,1,0,0
5,0,0,3,1,1,2,13.29,4.5,269.08,0.02,18,0.22,14.95,6,12,4,6,2,0
1,0,1,1,1,1,2,16.92,3.5,207.22,0.02,16,0.29,11.51,6,10,6,7,2,0
1,0,0,1,1,1,0,0,0,0,0,1,0,0,0,1,0,1,0,0
1,0,0,1,1,1,2,0,0,0,0,3,0,0,0,3,0,3,2,0
1,0,0,1,1,1,2,0,0,0,0,3,0,0,0,3,0,3,2,0
1,0,0,1,1,1,2,0,0,0,0,3,0,0,0,3,0,3,2,0
1,0,0,1,1,1,2,0,0,0,0,3,0,0,0,3,0,3,2,0
1,0,0,1,1,1,2,0,0,0,0,3,0,0,0,3,0,3,2,0
1,0,0,1,1,1,2,0,0,0,0,3,0,0,0,3,0,3,2,0
1,0,0,1,1,1,2,0,0,0,0,3,0,0,0,3,0,3,2,0
1,0,0,1,1,1,2,0,0,0,0,3,0,0,0,3,0,3,2,0
1,0,0,1,1,1,2,0,0,0,0,3,0,0,0,3,0,3,2,0
1,0,0,1,1,1,2,0,0,0,0,3,0,0,0,3,0,3,2,0
1,0,0,1,1,1,2,0,0,0,0,3,0,0,0,3,0,3,2,0
1,0,0,1,1,1,3,11.63,2,46.53,0.01,9,0.5,2.58,4,5,3,3,3,0
1,0,0,1,1,1,0,5.33,1.5,12,0,4,0.67,0.67,1,3,1,3,0,0
1,0,0,1,1,1,0,5.33,1.5,12,0,4,0.67,0.67,1,3,1,3,0,0
1,0,0,1,1,1,0,5.33,1.5,12,0,4,0.67,0.67,1,3,1,3,0,0
1,0,0,1,1,1,2,0,0,0,0,3,0,0,0,3,0,3,2,0
1,0,0,1,1,1,2,5.33,1.5,12,0,4,0.67,0.67,1,3,1,3,2,0
1,0,0,1,1,1,2,0,0,0,0,3,0,0,0,3,0,3,2,0
1,0,0,1,1,1,2,0,0,0,0,3,0,0,0,3,0,3,2,0
1,0,0,1,1,1,2,0,0,0,0,3,0,0,0,3,0,3,2,0
1,0,0,1,1,1,2,0,0,0,0,3,0,0,0,3,0,3,2,0
1,0,0,1,1,1,2,0,0,0,0,3,0,0,0,3,0,3,2,0
1,0,0,1,1,1,2,0,0,0,0,3,0,0,0,3,0,3,2,0
1,0,0,1,1,1,2,0,0,0,0,3,0,0,0,3,0,3,2,0
1,0,0,1,1,1,2,0,0,0,0,3,0,0,0,3,0,3,2,0
1,0,0,1,1,1,2,0,0,0,0,3,0,0,0,3,0,3,2,0
1,0,0,1,1,1,2,0,0,0,0,3,0,0,0,3,0,3,2,0
1,0,0,1,1,1,2,0,0,0,0,3,0,0,0,3,0,3,2,0
1,0,0,1,1,1,0,7.74,1.5,17.41,0,5,0.67,0.97,2,3,2,3,0,0
1,0,0,1,1,1,0,7.74,1.5,17.41,0,5,0.67,0.97,2,3,2,3,0,0
1,0,0,1,1,1,0,0,0,0,0,3,0,0,0,3,0,3,0,0
1,0,0,1,1,1,0,5.33,1.5,12,0,4,0.67,0.67,1,3,1,3,0,0
1,0,0,1,1,1,2,0,0,0,0,3,0,0,0,3,0,3,2,0
1,0,0,1,1,1,2,0,0,0,0,3,0,0,0,3,0,3,2,0
1,0,0,1,1,1,2,0,0,0,0,3,0,0,0,3,0,3,2,0
1,0,0,1,1,1,2,0,0,0,0,3,0,0,0,3,0,3,2,0
1,0,0,1,1,1,2,0,0,0,0,3,0,0,0,3,0,3,2,0
1,0,0,1,1,1,2,0,0,0,0,3,0,0,0,3,0,3,2,0
1,0,0,1,1,1,2,0,0,0,0,3,0,0,0,3,0,3,2,0
1,0,0,1,1,1,2,0,0,0,0,3,0,0,0,3,0,3,2,0
1,0,0,1,1,1,2,0,0,0,0,3,0,0,0,3,0,3,2,0
1,0,0,1,1,1,2,0,0,0,0,3,0,0,0,3,0,3,2,0
1,0,0,1,1,1,2,0,0,0,0,3,0,0,0,3,0,3,2,0
5,0,5,3,1,1,7,13.32,13.71,2505.06,0.06,43,0.07,139.17,16,27,7,12,7,0
5,0,5,3,1,1,7,13.32,13.71,2505.06,0.06,43,0.07,139.17,16,27,7,12,7,0
1,0,0,1,1,1,2,5.33,1.5,12,0,4,0.67,0.67,1,3,1,3,2,0
1,0,0,1,1,1,1,0,0,0,0,1,0,0,0,1,0,1,1,0
101,19,148,51,18,34,287,112.35,69.9,548896.76,2.62,1182,0.01,30494.26,468,714,77,23,306,1
71,31,101,38,22,9,230,96.29,79.69,611518.68,2.56,1098,0.01,33973.26,454,644,94,33,261,1
17,4,11,9,1,1,36,40.36,24.47,24167.17,0.33,175,0.04,1342.62,87,88,32,18,40,1
21,1,0,11,1,7,23,17.43,17.11,5102.76,0.1,69,0.06,283.49,28,41,9,11,24,0
27,4,3,14,1,8,36,41.31,15.14,9471.93,0.21,124,0.07,526.22,53,71,21,12,40,1
33,4,15,17,7,9,82,46.03,39.19,70687.64,0.6,318,0.03,3927.09,132,186,32,19,86,1
19,6,6,10,6,5,51,36.96,29.82,32861.57,0.37,210,0.03,1825.64,82,128,22,16,57,1
33,4,11,17,1,17,40,33.51,20.9,14637.64,0.23,149,0.05,813.2,57,92,15,11,44,0
1,0,9,1,1,1,26,89.88,6.23,3489.23,0.19,112,0.16,193.85,54,58,26,6,26,0
25,6,12,13,7,5,66,50.12,29.91,44844.19,0.5,263,0.03,2491.34,113,150,34,18,72,1
20,3,7,13,13,1,59,48.27,28.91,40340.23,0.47,246,0.03,2241.12,106,140,33,18,62,1
47,4,26,24,16,1,82,102.15,24.05,59082.72,0.82,411,0.04,3282.37,185,226,50,13,86,1
53,5,26,27,17,1,88,111.45,23.95,63915.29,0.89,434,0.04,3550.85,195,239,57,14,93,1
1,0,1,1,1,1,32,111.27,11.31,14243.48,0.42,232,0.09,791.3,99,133,35,8,32,1
131,9,259,66,30,37,975,559.47,62.93,2215667.45,11.74,4477,0.02,123092.66,1707,2770,217,16,984,1
7,4,0,4,4,1,9,25.81,8.4,1821.42,0.07,52,0.12,101.19,21,31,10,8,13,0
7,4,0,4,4,1,15,35.22,11.14,4372.79,0.13,88,0.09,242.93,39,49,14,8,19,1
3,2,0,2,2,1,11,36.12,6.46,1508.02,0.08,54,0.15,83.78,24,30,13,7,13,1
98,56,165,78,75,1,311,67.04,172.23,1988772.19,3.85,1489,0.01,110487.34,661,828,142,74,367,1
81,6,55,46,13,16,143,53.58,91.28,446404.72,1.63,641,0.01,24800.26,275,366,119,79,149,1
19,0,7,10,7,7,41,40.22,15.43,9572.82,0.21,123,0.06,531.82,54,69,21,12,41,0
7,0,3,4,3,3,15,22.48,8.25,1530.09,0.06,41,0.12,85.01,18,23,12,11,15,0
1,0,0,1,1,1,0,0,0,0,0,1,0,0,0,1,0,1,0,0
9,2,1,8,1,1,27,34.09,9.88,3329.22,0.11,68,0.1,184.96,24,44,17,14,29,0
3,0,1,2,1,1,2,12.09,6.3,479.73,0.03,20,0.16,26.65,7,13,5,9,2,0
1,0,0,1,1,1,2,5.33,1.5,12,0,4,0.67,0.67,1,3,1,3,2,0
1,0,0,1,1,1,2,5.33,1.5,12,0,4,0.67,0.67,1,3,1,3,2,0
1,0,0,1,1,1,2,5.33,1.5,12,0,4,0.67,0.67,1,3,1,3,2,0
1,0,0,1,1,1,2,5.33,1.5,12,0,4,0.67,0.67,1,3,1,3,2,0
1,0,0,1,1,1,2,5.33,1.5,12,0,4,0.67,0.67,1,3,1,3,2,0
1,0,0,1,1,1,2,5.33,1.5,12,0,4,0.67,0.67,1,3,1,3,2,0
1,0,0,1,1,1,2,5.33,1.5,12,0,4,0.67,0.67,1,3,1,3,2,0
1,0,0,1,1,1,2,5.33,1.5,12,0,4,0.67,0.67,1,3,1,3,2,0
1,0,0,1,1,1,2,5.33,1.5,12,0,4,0.67,0.67,1,3,1,3,2,0
1,0,0,1,1,1,2,0,0,0,0,4,0,0,0,4,0,4,2,0
1,0,0,1,1,1,0,0,0,0,0,5,0,0,0,5,0,5,0,0
1,0,0,1,1,1,0,0,0,0,0,5,0,0,0,5,0,5,0,0
1,0,0,1,1,1,1,0,0,0,0,1,0,0,0,1,0,1,1,0
1,0,0,1,1,1,0,0,0,0,0,1,0,0,0,1,0,1,0,0
1,0,0,1,1,1,2,0,0,0,0,5,0,0,0,5,0,5,2,0
1,0,0,1,1,1,2,0,0,0,0.01,6,0,0,0,6,0,6,2,0
11,1,4,6,1,1,21,13.86,22.5,7014.99,0.1,68,0.04,389.72,27,41,9,15,22,0
1,0,0,1,1,1,2,20.97,3,188.72,0.02,17,0.33,10.48,7,10,7,6,2,0
1,0,0,1,1,1,2,20.97,3,188.72,0.02,17,0.33,10.48,7,10,7,6,2,0
1,0,0,1,1,1,2,27.35,3,246.13,0.03,21,0.33,13.67,9,12,9,6,2,0
1,0,0,1,1,1,3,30.67,3,276,0.03,23,0.33,15.33,10,13,10,6,3,0
1,0,0,1,1,1,3,30.67,3,276,0.03,23,0.33,15.33,10,13,10,6,3,0
1,0,0,1,1,1,3,30.67,3,276,0.03,23,0.33,15.33,10,13,10,6,3,0
1,0,0,1,1,1,2,27.35,3,246.13,0.03,21,0.33,13.67,9,12,9,6,2,0
1,0,0,1,1,1,3,27.35,3,246.13,0.03,21,0.33,13.67,9,12,9,6,3,0
1,0,0,1,1,1,2,20.97,3,188.72,0.02,17,0.33,10.48,7,10,7,6,2,0
1,0,0,1,1,1,2,20.97,3,188.72,0.02,17,0.33,10.48,7,10,7,6,2,0
1,0,0,1,1,1,2,20.97,3,188.72,0.02,17,0.33,10.48,7,10,7,6,2,0
1,0,0,1,1,1,2,17.92,3,161.32,0.02,15,0.33,8.96,6,9,6,6,2,0
1,0,0,1,1,1,2,17.92,3,161.32,0.02,15,0.33,8.96,6,9,6,6,2,0
1,0,0,1,1,1,2,14.99,3,134.92,0.01,13,0.33,7.5,5,8,5,6,2,0
1,0,0,1,1,1,2,14.99,3,134.92,0.01,13,0.33,7.5,5,8,5,6,2,0
1,0,0,1,1,1,2,14.99,3,134.92,0.01,13,0.33,7.5,5,8,5,6,2,0
1,0,0,1,1,1,2,14.99,3,134.92,0.01,13,0.33,7.5,5,8,5,6,2,0
1,0,0,1,1,1,2,14.99,3,134.92,0.01,13,0.33,7.5,5,8,5,6,2,0
1,0,0,1,1,1,2,17.92,3,161.32,0.02,15,0.33,8.96,6,9,6,6,2,0
1,0,0,1,1,1,2,17.92,3,161.32,0.02,15,0.33,8.96,6,9,6,6,2,0
1,0,0,1,1,1,2,20.97,3,188.72,0.02,17,0.33,10.48,7,10,7,6,2,0
1,0,0,1,1,1,2,20.97,3,188.72,0.02,17,0.33,10.48,7,10,7,6,2,0
1,0,0,1,1,1,1,0,0,0,0,0,0,0,0,0,0,0,1,0
1,0,0,1,1,1,1,0,0,0,0,1,0,0,0,1,0,1,1,0
1,0,0,1,1,1,2,5.33,1.5,12,0,4,0.67,0.67,1,3,1,3,2,0
1,0,0,1,1,1,2,5.33,1.5,12,0,4,0.67,0.67,1,3,1,3,2,0
1,9,0,1,1,1,2,0,0,0,0,9,0,0,9,0,1,0,11,0
1,0,0,1,1,1,1,0,0,0,0,0,0,0,0,0,0,0,1,0
1,0,0,1,1,1,1,0,0,0,0,0,0,0,0,0,0,0,1,0
1,0,0,1,1,1,1,0,0,0,0,1,0,0,0,1,0,1,1,0
1,0,0,1,1,1,4,18.49,2.4,106.51,0.01,14,0.42,5.92,6,8,5,4,4,0
1,0,0,1,1,1,2,5.33,1.5,12,0,4,0.67,0.67,1,3,1,3,2,0
1,0,0,1,1,1,5,8.45,0.75,4.75,0,4,1.33,0.26,3,1,2,1,5,0
1,0,0,1,1,1,1,0,0,0,0,0,0,0,0,0,0,0,1,0
1,0,0,1,1,1,1,0,0,0,0,1,0,0,0,1,0,1,1,0
1,0,0,1,1,1,3,10.8,2.5,67.5,0.01,9,0.4,3.75,3,6,3,5,3,0
1,0,0,1,1,1,2,5.33,1.5,12,0,4,0.67,0.67,1,3,1,3,2,0
1,0,0,1,1,1,2,6.2,2.5,38.77,0.01,6,0.4,2.15,1,5,1,5,2,0
1,0,0,1,1,1,4,9.51,0.5,2.38,0,3,2,0.13,2,1,2,1,4,0
1,0,0,1,1,1,1,0,0,0,0,1,0,0,0,1,0,1,1,0
1,0,0,1,1,1,2,5.33,1.5,12,0,4,0.67,0.67,1,3,1,3,2,0
1,0,0,1,1,1,2,5.33,1.5,12,0,4,0.67,0.67,1,3,1,3,2,0
1,0,0,1,1,1,2,0,0,0,0,4,0,0,0,4,0,4,2,0
1,0,0,1,1,1,1,0,0,0,0,1,0,0,0,1,0,1,1,0
1,0,0,1,1,1,2,0,0,0,0,5,0,0,0,5,0,5,2,0
1,0,0,1,1,1,1,0,0,0,0,1,0,0,0,1,0,1,1,0
1,0,0,1,1,1,2,5.33,1.5,12,0,4,0.67,0.67,1,3,1,3,2,0
1,0,0,1,1,1,2,5.33,1.5,12,0,4,0.67,0.67,1,3,1,3,2,0
1,0,0,1,1,1,1,0,0,0,0,1,0,0,0,1,0,1,1,0
1,0,0,1,1,1,6,16.68,7.5,938.23,0.04,30,0.13,52.12,12,18,8,10,6,0
1,0,0,1,1,1,2,5.33,1.5,12,0,4,0.67,0.67,1,3,1,3,2,0
1,0,0,1,1,1,2,10.44,3.5,127.89,0.01,11,0.29,7.11,3,8,3,7,2,0
1,0,0,1,1,1,2,10.44,3.5,127.89,0.01,11,0.29,7.11,3,8,3,7,2,0
1,0,0,1,1,1,2,7.49,3,67.38,0.01,8,0.33,3.74,1,7,1,6,2,0
1,0,0,1,1,1,2,9,3,81,0.01,9,0.33,4.5,2,7,2,6,2,0
1,0,0,1,1,1,2,9,3,81,0.01,9,0.33,4.5,2,7,2,6,2,0
1,0,0,1,1,1,2,9,3,81,0.01,9,0.33,4.5,2,7,2,6,2,0
1,0,0,1,1,1,2,10.44,3.5,127.89,0.01,11,0.29,7.11,3,8,3,7,2,0
1,0,0,1,1,1,2,9,3,81,0.01,9,0.33,4.5,2,7,2,6,2,0
1,0,0,1,1,1,2,9,3,81,0.01,9,0.33,4.5,2,7,2,6,2,0
1,0,0,1,1,1,2,7.49,3,67.38,0.01,8,0.33,3.74,1,7,1,6,2,0
1,0,0,1,1,1,2,7.49,3,67.38,0.01,8,0.33,3.74,1,7,1,6,2,0
1,0,0,1,1,1,2,10,3,90,0.01,10,0.33,5,2,8,2,6,2,0
1,0,0,1,1,1,3,10.44,3.5,127.89,0.01,11,0.29,7.11,3,8,3,7,3,0
1,0,0,1,1,1,3,11.39,3.5,139.52,0.01,12,0.29,7.75,3,9,3,7,3,0
1,0,0,1,1,1,2,9,3,81,0.01,9,0.33,4.5,2,7,2,6,2,0
1,0,0,1,1,1,2,10.44,3.5,127.89,0.01,11,0.29,7.11,3,8,3,7,2,0
1,0,0,1,1,1,2,9,3,81,0.01,9,0.33,4.5,2,7,2,6,2,0
1,0,0,1,1,1,2,9,3,81,0.01,9,0.33,4.5,2,7,2,6,2,0
1,0,0,1,1,1,2,10.44,3.5,127.89,0.01,11,0.29,7.11,3,8,3,7,2,0
1,0,0,1,1,1,2,9,3,81,0.01,9,0.33,4.5,2,7,2,6,2,0
1,0,0,1,1,1,2,9,3,81,0.01,9,0.33,4.5,2,7,2,6,2,0
1,0,0,1,1,1,2,9,3,81,0.01,9,0.33,4.5,2,7,2,6,2,0
1,0,0,1,1,1,2,7.49,3,67.38,0.01,8,0.33,3.74,1,7,1,6,2,0
1,0,0,1,1,1,2,9,3,81,0.01,9,0.33,4.5,2,7,2,6,2,0
1,0,0,1,1,1,2,9,3,81,0.01,9,0.33,4.5,2,7,2,6,2,0
1,0,0,1,1,1,2,10.44,3.5,127.89,0.01,11,0.29,7.11,3,8,3,7,2,0
1,0,0,1,1,1,2,9.05,2,36.19,0.01,7,0.5,2,2,5,2,4,2,0
1,0,0,1,1,1,2,9.05,2,36.19,0.01,7,0.5,2,2,5,2,4,2,0
1,0,0,1,1,1,2,9.05,2,36.19,0.01,7,0.5,2,2,5,2,4,2,0
1,0,0,1,1,1,2,9.05,2,36.19,0.01,7,0.5,2,2,5,2,4,2,0
1,0,0,1,1,1,2,9.05,2,36.19,0.01,7,0.5,2,2,5,2,4,2,0
1,0,0,1,1,1,2,9.05,2,36.19,0.01,7,0.5,2,2,5,2,4,2,0
1,0,0,1,1,1,2,9.05,2,36.19,0.01,7,0.5,2,2,5,2,4,2,0
1,0,0,1,1,1,2,9.05,2,36.19,0.01,7,0.5,2,2,5,2,4,2,0
1,0,0,1,1,1,2,9.05,2,36.19,0.01,7,0.5,2,2,5,2,4,2,0
1,0,0,1,1,1,2,9.05,2,36.19,0.01,7,0.5,2,2,5,2,4,2,0
1,0,0,1,1,1,2,9.05,2,36.19,0.01,7,0.5,2,2,5,2,4,2,0
1,0,0,1,1,1,2,9.05,2,36.19,0.01,7,0.5,2,2,5,2,4,2,0
1,0,0,1,1,1,2,9.05,2,36.19,0.01,7,0.5,2,2,5,2,4,2,0
1,0,0,1,1,1,2,10.44,3.5,127.89,0.01,11,0.29,7.11,3,8,3,7,2,0
1,0,0,1,1,1,2,10.44,3.5,127.89,0.01,11,0.29,7.11,3,8,3,7,2,0
1,0,0,1,1,1,2,9.05,2,36.19,0.01,7,0.5,2,2,5,2,4,2,0
1,0,0,1,1,1,0,0,0,0,0,1,0,0,0,1,0,1,0,0
1,0,0,1,1,1,2,5.33,1.5,12,0,4,0.67,0.67,1,3,1,3,2,0
3,0,0,2,1,1,6,11.86,4.38,227.03,0.02,15,0.23,12.61,5,10,4,7,6,0
3,2,0,2,1,1,6,14.43,5.14,381.76,0.02,19,0.19,21.21,9,10,7,8,8,0
5,1,0,3,1,1,10,12.67,10,1267.11,0.04,31,0.1,70.4,14,17,7,10,11,0
3,1,0,2,1,1,6,11.71,4.9,281.06,0.02,16,0.2,15.61,7,9,5,7,7,0
3,1,0,2,1,1,6,11.71,4.9,281.06,0.02,16,0.2,15.61,7,9,5,7,7,0
1,0,0,1,1,1,2,5.33,1.5,12,0,4,0.67,0.67,1,3,1,3,2,0
1,0,0,1,1,1,2,5.33,1.5,12,0,4,0.67,0.67,1,3,1,3,2,0
3,1,0,2,1,1,6,11.23,5.6,352.28,0.02,17,0.18,19.57,7,10,5,8,7,0
7,1,1,4,1,3,13,18.91,10.45,2065.48,0.07,45,0.1,114.75,19,26,10,11,14,0
5,1,0,3,1,1,10,13.33,9,1080,0.04,30,0.11,60,14,16,7,9,11,0
3,1,0,2,1,1,6,11.71,4.9,281.06,0.02,16,0.2,15.61,7,9,5,7,7,0
7,1,1,4,1,3,13,18.91,10.45,2065.48,0.07,45,0.1,114.75,19,26,10,11,14,0
3,1,0,2,1,1,6,11.71,4.9,281.06,0.02,16,0.2,15.61,7,9,5,7,7,0
3,0,0,2,1,1,6,11.86,4.38,227.03,0.02,15,0.23,12.61,5,10,4,7,6,0
3,2,0,2,1,1,7,16.73,5.5,506,0.03,23,0.18,28.11,11,12,8,8,9,0
1,0,0,1,1,1,2,5.33,1.5,12,0,4,0.67,0.67,1,3,1,3,2,0
9,6,0,5,1,1,14,23.12,11.15,2875.94,0.09,57,0.09,159.77,29,28,13,10,20,0
3,1,0,2,1,1,7,14.43,5.14,381.76,0.02,19,0.19,21.21,9,10,7,8,8,0
7,1,1,4,1,3,13,19.62,10,1962.15,0.07,44,0.1,109.01,20,24,11,11,14,0
1,0,0,1,1,1,2,5.33,1.5,12,0,4,0.67,0.67,1,3,1,3,2,0
1,0,0,1,1,1,2,5.33,1.5,12,0,4,0.67,0.67,1,3,1,3,2,0
1,0,0,1,1,1,2,5.33,1.5,12,0,4,0.67,0.67,1,3,1,3,2,0
1,0,0,1,1,1,2,5.33,1.5,12,0,4,0.67,0.67,1,3,1,3,2,0
1,0,0,1,1,1,2,5.33,1.5,12,0,4,0.67,0.67,1,3,1,3,2,0
1,0,0,1,1,1,2,5.33,1.5,12,0,4,0.67,0.67,1,3,1,3,2,0
3,1,0,2,1,1,5,10.95,6,394.38,0.02,19,0.17,21.91,10,9,5,6,6,0
3,1,0,2,1,1,5,10.95,6,394.38,0.02,19,0.17,21.91,10,9,5,6,6,0
3,1,0,2,1,1,5,10.95,6,394.38,0.02,19,0.17,21.91,10,9,5,6,6,0
3,1,0,2,1,1,5,10.95,6,394.38,0.02,19,0.17,21.91,10,9,5,6,6,0
3,1,1,2,1,1,5,10.95,6,394.38,0.02,19,0.17,21.91,10,9,5,6,6,0
1,0,0,1,1,1,3,13,3,117,0.01,13,0.33,6.5,6,7,4,4,3,0
1,0,0,1,1,1,2,11.07,3,99.66,0.01,10,0.33,5.54,4,6,4,6,2,0
1,0,0,1,1,1,2,7.74,1.5,17.41,0,5,0.67,0.97,2,3,2,3,2,0
3,0,1,2,1,1,8,16.92,4.5,342.66,0.03,20,0.22,19.04,9,11,7,7,8,0
3,1,0,2,1,1,7,16.92,4.5,342.66,0.03,20,0.22,19.04,9,11,7,7,8,0
1,0,0,1,1,1,2,11.41,2.5,71.32,0.01,9,0.4,3.96,4,5,4,5,2,0
3,1,0,2,1,1,5,10.95,6,394.38,0.02,19,0.17,21.91,10,9,5,6,6,0
1,0,0,1,1,1,4,16.51,4.8,380.39,0.03,25,0.21,21.13,12,13,5,4,4,0
1,0,0,1,1,1,2,7.74,1.5,17.41,0,5,0.67,0.97,2,3,2,3,2,0
3,1,0,2,1,1,5,10.95,6,394.38,0.02,19,0.17,21.91,10,9,5,6,6,0
3,1,0,2,1,1,5,10.95,6,394.38,0.02,19,0.17,21.91,10,9,5,6,6,0
1,0,0,1,1,1,2,9.83,2,39.3,0.01,7,0.5,2.18,3,4,3,4,2,0
1,0,0,1,1,1,2,7.86,2.5,49.13,0.01,7,0.4,2.73,2,5,2,5,2,0
1,0,0,1,1,1,2,7.49,3,67.38,0.01,8,0.33,3.74,1,7,1,6,2,0
1,0,0,1,1,1,2,7.49,3,67.38,0.01,8,0.33,3.74,1,7,1,6,2,0
1,0,0,1,1,1,2,7.49,3,67.38,0.01,8,0.33,3.74,1,7,1,6,2,0
1,0,0,1,1,1,2,7.49,3,67.38,0.01,8,0.33,3.74,1,7,1,6,2,0
1,0,0,1,1,1,2,7.49,3,67.38,0.01,8,0.33,3.74,1,7,1,6,2,0
1,0,0,1,1,1,2,7.49,3,67.38,0.01,8,0.33,3.74,1,7,1,6,2,0
1,0,0,1,1,1,2,7.49,3,67.38,0.01,8,0.33,3.74,1,7,1,6,2,0
1,0,0,1,1,1,2,10.57,3,95.1,0.01,10,0.33,5.28,3,7,3,6,2,0
1,0,0,1,1,1,0,0,0,0,0,1,0,0,0,1,0,1,0,0
1,0,0,1,1,1,2,5.33,1.5,12,0,4,0.67,0.67,1,3,1,3,2,0
1,0,0,1,1,1,2,5.33,1.5,12,0,4,0.67,0.67,1,3,1,3,2,0
1,0,0,1,1,1,2,5.33,1.5,12,0,4,0.67,0.67,1,3,1,3,2,0
1,0,0,1,1,1,2,5.33,1.5,12,0,4,0.67,0.67,1,3,1,3,2,0
1,0,0,1,1,1,2,5.33,1.5,12,0,4,0.67,0.67,1,3,1,3,2,0
1,0,0,1,1,1,2,5.33,1.5,12,0,4,0.67,0.67,1,3,1,3,2,0
1,0,0,1,1,1,2,5.33,1.5,12,0,4,0.67,0.67,1,3,1,3,2,0
1,0,0,1,1,1,2,13.95,2.5,87.17,0.01,11,0.4,4.84,4,7,4,5,2,0
1,0,0,1,1,1,1,0,0,0,0,1,0,0,0,1,0,1,1,0
1,0,0,1,1,1,1,0,0,0,0,1,0,0,0,1,0,1,1,0
1,0,0,1,1,1,1,0,0,0,0,1,0,0,0,1,0,1,1,0
1,0,0,1,1,1,1,0,0,0,0,1,0,0,0,1,0,1,1,0
1,0,0,1,1,1,1,0,0,0,0,1,0,0,0,1,0,1,1,0
1,0,0,1,1,1,1,0,0,0,0,1,0,0,0,1,0,1,1,0
1,0,0,1,1,1,0,0,0,0,0,1,0,0,0,1,0,1,0,0
1,0,0,1,1,1,2,0,0,0,0,3,0,0,0,3,0,3,2,0
1,0,0,1,1,1,2,0,0,0,0,3,0,0,0,3,0,3,2,0
1,0,0,1,1,1,2,0,0,0,0,3,0,0,0,3,0,3,2,0
1,0,0,1,1,1,2,0,0,0,0,3,0,0,0,3,0,3,2,0
1,0,0,1,1,1,2,0,0,0,0,3,0,0,0,3,0,3,2,0
1,0,0,1,1,1,2,0,0,0,0,3,0,0,0,3,0,3,2,0
1,0,0,1,1,1,2,0,0,0,0,3,0,0,0,3,0,3,2,0
1,0,0,1,1,1,2,0,0,0,0,3,0,0,0,3,0,3,2,0
1,0,0,1,1,1,2,0,0,0,0,3,0,0,0,3,0,3,2,0
1,0,0,1,1,1,2,0,0,0,0,3,0,0,0,3,0,3,2,0
1,0,0,1,1,1,2,0,0,0,0,3,0,0,0,3,0,3,2,0
1,0,0,1,1,1,3,11.63,2,46.53,0.01,9,0.5,2.58,4,5,3,3,3,0
1,0,0,1,1,1,0,5.33,1.5,12,0,4,0.67,0.67,1,3,1,3,0,0
1,0,0,1,1,1,0,5.33,1.5,12,0,4,0.67,0.67,1,3,1,3,0,0
1,0,0,1,1,1,0,5.33,1.5,12,0,4,0.67,0.67,1,3,1,3,0,0
1,0,0,1,1,1,2,0,0,0,0,3,0,0,0,3,0,3,2,0
1,0,0,1,1,1,2,5.33,1.5,12,0,4,0.67,0.67,1,3,1,3,2,0
1,0,0,1,1,1,2,0,0,0,0,3,0,0,0,3,0,3,2,0
1,0,0,1,1,1,2,0,0,0,0,3,0,0,0,3,0,3,2,0
1,0,0,1,1,1,2,0,0,0,0,3,0,0,0,3,0,3,2,0
1,0,0,1,1,1,2,0,0,0,0,3,0,0,0,3,0,3,2,0
1,0,0,1,1,1,2,0,0,0,0,3,0,0,0,3,0,3,2,0
1,0,0,1,1,1,2,0,0,0,0,3,0,0,0,3,0,3,2,0
1,0,0,1,1,1,2,0,0,0,0,3,0,0,0,3,0,3,2,0
1,0,0,1,1,1,2,0,0,0,0,3,0,0,0,3,0,3,2,0
1,0,0,1,1,1,2,0,0,0,0,3,0,0,0,3,0,3,2,0
1,0,0,1,1,1,2,0,0,0,0,3,0,0,0,3,0,3,2,0
1,0,0,1,1,1,2,0,0,0,0,3,0,0,0,3,0,3,2,0
1,0,0,1,1,1,0,7.74,1.5,17.41,0,5,0.67,0.97,2,3,2,3,0,0
1,0,0,1,1,1,0,7.74,1.5,17.41,0,5,0.67,0.97,2,3,2,3,0,0
1,0,0,1,1,1,0,0,0,0,0,3,0,0,0,3,0,3,0,0
1,0,0,1,1,1,0,5.33,1.5,12,0,4,0.67,0.67,1,3,1,3,0,0
1,0,0,1,1,1,2,0,0,0,0,3,0,0,0,3,0,3,2,0
1,0,0,1,1,1,2,0,0,0,0,3,0,0,0,3,0,3,2,0
1,0,0,1,1,1,2,0,0,0,0,3,0,0,0,3,0,3,2,0
1,0,0,1,1,1,2,0,0,0,0,3,0,0,0,3,0,3,2,0
1,0,0,1,1,1,2,0,0,0,0,3,0,0,0,3,0,3,2,0
1,0,0,1,1,1,2,0,0,0,0,3,0,0,0,3,0,3,2,0
1,0,0,1,1,1,2,0,0,0,0,3,0,0,0,3,0,3,2,0
1,0,0,1,1,1,2,0,0,0,0,3,0,0,0,3,0,3,2,0
1,0,0,1,1,1,2,0,0,0,0,3,0,0,0,3,0,3,2,0
1,0,0,1,1,1,2,0,0,0,0,3,0,0,0,3,0,3,2,0
1,0,0,1,1,1,2,0,0,0,0,3,0,0,0,3,0,3,2,0
1,0,0,1,1,1,1,0,0,0,0,1,0,0,0,1,0,1,1,0
29,3,8,15,3,10,94,32.34,46.88,71061.75,0.51,306,0.02,3947.88,100,206,16,15,97,1
81,10,77,41,7,28,483,53.83,183.04,1803408.58,3.28,1839,0.01,100189.37,572,1267,25,16,493,1
1,0,1,1,1,1,12,7.5,9.75,712.55,0.02,22,0.1,39.59,13,9,4,6,12,1
11,4,11,6,6,1,29,44.56,12,6416.47,0.18,106,0.08,356.47,48,58,22,11,33,0
19,5,11,10,6,4,34,42.38,16.67,11773.23,0.24,131,0.06,654.07,60,71,27,15,39,0
1,0,2,1,1,1,9,19.16,12.38,2933.78,0.08,58,0.08,162.99,22,36,8,9,9,1
49,15,89,25,16,12,813,350.88,71.88,1812966.04,8.41,3404,0.01,100720.34,1214,2190,152,18,828,0
1,0,0,1,1,1,2,5.33,1.5,12,0,4,0.67,0.67,1,3,1,3,2,0
1,0,0,1,1,1,2,5.33,1.5,12,0,4,0.67,0.67,1,3,1,3,2,0
1,0,0,1,1,1,2,5.33,1.5,12,0,4,0.67,0.67,1,3,1,3,2,0
1,0,0,1,1,1,2,5.33,1.5,12,0,4,0.67,0.67,1,3,1,3,2,0
1,0,0,1,1,1,2,5.33,1.5,12,0,4,0.67,0.67,1,3,1,3,2,0
1,0,0,1,1,1,2,5.33,1.5,12,0,4,0.67,0.67,1,3,1,3,2,0
1,0,0,1,1,1,2,5.33,1.5,12,0,4,0.67,0.67,1,3,1,3,2,0
1,0,0,1,1,1,2,5.33,1.5,12,0,4,0.67,0.67,1,3,1,3,2,0
1,0,0,1,1,1,2,5.33,1.5,12,0,4,0.67,0.67,1,3,1,3,2,0
1,0,0,1,1,1,2,0,0,0,0,4,0,0,0,4,0,4,2,0
1,0,0,1,1,1,1,0,0,0,0,1,0,0,0,1,0,1,1,0
1,0,0,1,1,1,2,0,0,0,0,5,0,0,0,5,0,5,2,0
1,0,0,1,1,1,1,0,0,0,0,0,0,0,0,0,0,0,1,0
1,0,0,1,1,1,1,0,0,0,0,1,0,0,0,1,0,1,1,0
1,0,0,1,1,1,2,5.33,1.5,12,0,4,0.67,0.67,1,3,1,3,2,0
1,0,0,1,1,1,2,5.33,1.5,12,0,4,0.67,0.67,1,3,1,3,2,0
1,9,0,1,1,1,2,0,0,0,0,9,0,0,9,0,1,0,11,0
1,0,0,1,1,1,1,0,0,0,0,0,0,0,0,0,0,0,1,0
1,0,0,1,1,1,1,0,0,0,0,0,0,0,0,0,0,0,1,0
1,0,0,1,1,1,1,0,0,0,0,1,0,0,0,1,0,1,1,0
1,0,0,1,1,1,4,18.49,2.4,106.51,0.01,14,0.42,5.92,6,8,5,4,4,0
1,0,0,1,1,1,2,5.33,1.5,12,0,4,0.67,0.67,1,3,1,3,2,0
1,0,0,1,1,1,5,8.45,0.75,4.75,0,4,1.33,0.26,3,1,2,1,5,0
1,0,0,1,1,1,1,0,0,0,0,0,0,0,0,0,0,0,1,0
1,0,0,1,1,1,1,0,0,0,0,1,0,0,0,1,0,1,1,0
1,0,0,1,1,1,3,10.8,2.5,67.5,0.01,9,0.4,3.75,3,6,3,5,3,0
1,0,0,1,1,1,2,5.33,1.5,12,0,4,0.67,0.67,1,3,1,3,2,0
1,0,0,1,1,1,2,6.2,2.5,38.77,0.01,6,0.4,2.15,1,5,1,5,2,0
1,0,0,1,1,1,4,9.51,0.5,2.38,0,3,2,0.13,2,1,2,1,4,0
1,0,0,1,1,1,1,0,0,0,0,1,0,0,0,1,0,1,1,0
1,0,0,1,1,1,2,5.33,1.5,12,0,4,0.67,0.67,1,3,1,3,2,0
1,0,0,1,1,1,2,5.33,1.5,12,0,4,0.67,0.67,1,3,1,3,2,0
1,0,0,1,1,1,2,0,0,0,0,4,0,0,0,4,0,4,2,0
1,0,0,1,1,1,1,0,0,0,0,1,0,0,0,1,0,1,1,0
1,0,0,1,1,1,2,0,0,0,0,5,0,0,0,5,0,5,2,0
1,0,0,1,1,1,1,0,0,0,0,1,0,0,0,1,0,1,1,0
1,0,0,1,1,1,2,5.33,1.5,12,0,4,0.67,0.67,1,3,1,3,2,0
1,0,0,1,1,1,2,5.33,1.5,12,0,4,0.67,0.67,1,3,1,3,2,0
1,0,0,1,1,1,1,0,0,0,0,1,0,0,0,1,0,1,1,0
1,0,0,1,1,1,1,0,0,0,0,1,0,0,0,1,0,1,1,0
1,0,0,1,1,1,1,0,0,0,0,1,0,0,0,1,0,1,1,0
1,0,0,1,1,1,1,0,0,0,0,1,0,0,0,1,0,1,1,0
1,0,0,1,1,1,1,0,0,0,0,1,0,0,0,1,0,1,1,0
1,0,0,1,1,1,1,0,0,0,0,1,0,0,0,1,0,1,1,0
1,0,0,1,1,1,1,0,0,0,0,1,0,0,0,1,0,1,1,0
1,0,0,1,1,1,0,0,0,0,0,1,0,0,0,1,0,1,0,0
1,0,0,1,1,1,2,0,0,0,0,3,0,0,0,3,0,3,2,0
1,0,0,1,1,1,2,0,0,0,0,3,0,0,0,3,0,3,2,0
1,0,0,1,1,1,2,0,0,0,0,3,0,0,0,3,0,3,2,0
1,0,0,1,1,1,2,0,0,0,0,3,0,0,0,3,0,3,2,0
1,0,0,1,1,1,2,0,0,0,0,3,0,0,0,3,0,3,2,0
1,0,0,1,1,1,2,0,0,0,0,3,0,0,0,3,0,3,2,0
1,0,0,1,1,1,2,0,0,0,0,3,0,0,0,3,0,3,2,0
1,0,0,1,1,1,2,0,0,0,0,3,0,0,0,3,0,3,2,0
1,0,0,1,1,1,2,0,0,0,0,3,0,0,0,3,0,3,2,0
1,0,0,1,1,1,2,0,0,0,0,3,0,0,0,3,0,3,2,0
1,0,0,1,1,1,2,0,0,0,0,3,0,0,0,3,0,3,2,0
1,0,0,1,1,1,3,11.63,2,46.53,0.01,9,0.5,2.58,4,5,3,3,3,0
1,0,0,1,1,1,0,5.33,1.5,12,0,4,0.67,0.67,1,3,1,3,0,0
1,0,0,1,1,1,0,5.33,1.5,12,0,4,0.67,0.67,1,3,1,3,0,0
1,0,0,1,1,1,0,5.33,1.5,12,0,4,0.67,0.67,1,3,1,3,0,0
1,0,0,1,1,1,2,0,0,0,0,3,0,0,0,3,0,3,2,0
1,0,0,1,1,1,2,5.33,1.5,12,0,4,0.67,0.67,1,3,1,3,2,0
1,0,0,1,1,1,2,0,0,0,0,3,0,0,0,3,0,3,2,0
1,0,0,1,1,1,2,0,0,0,0,3,0,0,0,3,0,3,2,0
1,0,0,1,1,1,2,0,0,0,0,3,0,0,0,3,0,3,2,0
1,0,0,1,1,1,2,0,0,0,0,3,0,0,0,3,0,3,2,0
1,0,0,1,1,1,2,0,0,0,0,3,0,0,0,3,0,3,2,0
1,0,0,1,1,1,2,0,0,0,0,3,0,0,0,3,0,3,2,0
1,0,0,1,1,1,2,0,0,0,0,3,0,0,0,3,0,3,2,0
1,0,0,1,1,1,2,0,0,0,0,3,0,0,0,3,0,3,2,0
1,0,0,1,1,1,2,0,0,0,0,3,0,0,0,3,0,3,2,0
1,0,0,1,1,1,2,0,0,0,0,3,0,0,0,3,0,3,2,0
1,0,0,1,1,1,2,0,0,0,0,3,0,0,0,3,0,3,2,0
1,0,0,1,1,1,0,7.74,1.5,17.41,0,5,0.67,0.97,2,3,2,3,0,0
1,0,0,1,1,1,0,7.74,1.5,17.41,0,5,0.67,0.97,2,3,2,3,0,0
1,0,0,1,1,1,0,0,0,0,0,3,0,0,0,3,0,3,0,0
1,0,0,1,1,1,0,5.33,1.5,12,0,4,0.67,0.67,1,3,1,3,0,0
1,0,0,1,1,1,2,0,0,0,0,3,0,0,0,3,0,3,2,0
1,0,0,1,1,1,2,0,0,0,0,3,0,0,0,3,0,3,2,0
1,0,0,1,1,1,2,0,0,0,0,3,0,0,0,3,0,3,2,0
1,0,0,1,1,1,2,0,0,0,0,3,0,0,0,3,0,3,2,0
1,0,0,1,1,1,2,0,0,0,0,3,0,0,0,3,0,3,2,0
1,0,0,1,1,1,2,0,0,0,0,3,0,0,0,3,0,3,2,0
1,0,0,1,1,1,2,0,0,0,0,3,0,0,0,3,0,3,2,0
1,0,0,1,1,1,2,0,0,0,0,3,0,0,0,3,0,3,2,0
1,0,0,1,1,1,2,0,0,0,0,3,0,0,0,3,0,3,2,0
1,0,0,1,1,1,2,0,0,0,0,3,0,0,0,3,0,3,2,0
1,0,0,1,1,1,2,0,0,0,0,3,0,0,0,3,0,3,2,0
1,0,0,1,1,1,1,0,0,0,0,1,0,0,0,1,0,1,1,0
3,1,19,2,2,1,195,24.23,141,481645.37,1.14,766,0.01,26758.08,235,531,10,12,196,1
1,0,27,1,1,1,412,19.25,316.29,1925547.43,2.02,1522,0,106974.86,492,1030,7,9,412,0
1,0,1,1,1,1,12,7.5,9.75,712.55,0.02,22,0.1,39.59,13,9,4,6,12,1
7,0,4,4,1,3,12,22.55,6.82,1048.17,0.05,35,0.15,58.23,15,20,11,10,12,0
11,4,12,6,6,1,29,44.56,12,6416.47,0.18,106,0.08,356.47,48,58,22,11,33,0
17,4,12,9,6,4,34,44.69,14.56,9474.82,0.22,124,0.07,526.38,56,68,25,13,38,0
1,0,1,1,1,1,6,17.05,9.33,1485.11,0.05,43,0.11,82.51,16,27,6,7,6,1
45,11,102,23,15,12,1200,514.4,76.12,2980261.45,13.05,5049,0.01,165570.1,1782,3267,199,17,1211,0
1,0,0,1,1,1,2,5.33,1.5,12,0,4,0.67,0.67,1,3,1,3,2,0
1,0,0,1,1,1,2,5.33,1.5,12,0,4,0.67,0.67,1,3,1,3,2,0
1,0,0,1,1,1,2,5.33,1.5,12,0,4,0.67,0.67,1,3,1,3,2,0
1,0,0,1,1,1,2,5.33,1.5,12,0,4,0.67,0.67,1,3,1,3,2,0
1,0,0,1,1,1,2,5.33,1.5,12,0,4,0.67,0.67,1,3,1,3,2,0
1,0,0,1,1,1,2,5.33,1.5,12,0,4,0.67,0.67,1,3,1,3,2,0
1,0,0,1,1,1,2,5.33,1.5,12,0,4,0.67,0.67,1,3,1,3,2,0
1,0,0,1,1,1,2,5.33,1.5,12,0,4,0.67,0.67,1,3,1,3,2,0
1,0,0,1,1,1,2,5.33,1.5,12,0,4,0.67,0.67,1,3,1,3,2,0
1,0,0,1,1,1,2,0,0,0,0,4,0,0,0,4,0,4,2,0
1,0,0,1,1,1,1,0,0,0,0,1,0,0,0,1,0,1,1,0
1,0,0,1,1,1,2,0,0,0,0,5,0,0,0,5,0,5,2,0
1,0,0,1,1,1,1,0,0,0,0,0,0,0,0,0,0,0,1,0
1,0,0,1,1,1,1,0,0,0,0,1,0,0,0,1,0,1,1,0
1,0,0,1,1,1,2,5.33,1.5,12,0,4,0.67,0.67,1,3,1,3,2,0
1,0,0,1,1,1,2,5.33,1.5,12,0,4,0.67,0.67,1,3,1,3,2,0
1,9,0,1,1,1,2,0,0,0,0,9,0,0,9,0,1,0,11,0
1,0,0,1,1,1,1,0,0,0,0,0,0,0,0,0,0,0,1,0
1,0,0,1,1,1,1,0,0,0,0,0,0,0,0,0,0,0,1,0
1,0,0,1,1,1,1,0,0,0,0,1,0,0,0,1,0,1,1,0
1,0,0,1,1,1,4,18.49,2.4,106.51,0.01,14,0.42,5.92,6,8,5,4,4,0
1,0,0,1,1,1,2,5.33,1.5,12,0,4,0.67,0.67,1,3,1,3,2,0
1,0,0,1,1,1,5,8.45,0.75,4.75,0,4,1.33,0.26,3,1,2,1,5,0
1,0,0,1,1,1,1,0,0,0,0,0,0,0,0,0,0,0,1,0
1,0,0,1,1,1,1,0,0,0,0,1,0,0,0,1,0,1,1,0
1,0,0,1,1,1,3,10.8,2.5,67.5,0.01,9,0.4,3.75,3,6,3,5,3,0
1,0,0,1,1,1,2,5.33,1.5,12,0,4,0.67,0.67,1,3,1,3,2,0
1,0,0,1,1,1,2,6.2,2.5,38.77,0.01,6,0.4,2.15,1,5,1,5,2,0
1,0,0,1,1,1,4,9.51,0.5,2.38,0,3,2,0.13,2,1,2,1,4,0
1,0,0,1,1,1,1,0,0,0,0,1,0,0,0,1,0,1,1,0
1,0,0,1,1,1,2,5.33,1.5,12,0,4,0.67,0.67,1,3,1,3,2,0
1,0,0,1,1,1,2,5.33,1.5,12,0,4,0.67,0.67,1,3,1,3,2,0
1,0,0,1,1,1,2,0,0,0,0,4,0,0,0,4,0,4,2,0
1,0,0,1,1,1,1,0,0,0,0,1,0,0,0,1,0,1,1,0
1,0,0,1,1,1,2,0,0,0,0,5,0,0,0,5,0,5,2,0
1,0,0,1,1,1,1,0,0,0,0,1,0,0,0,1,0,1,1,0
1,0,0,1,1,1,2,5.33,1.5,12,0,4,0.67,0.67,1,3,1,3,2,0
1,0,0,1,1,1,2,5.33,1.5,12,0,4,0.67,0.67,1,3,1,3,2,0
1,0,0,1,1,1,1,0,0,0,0,1,0,0,0,1,0,1,1,0
1,0,0,1,1,1,1,0,0,0,0,1,0,0,0,1,0,1,1,0
1,0,0,1,1,1,1,0,0,0,0,1,0,0,0,1,0,1,1,0
1,0,0,1,1,1,1,0,0,0,0,1,0,0,0,1,0,1,1,0
1,0,0,1,1,1,1,0,0,0,0,1,0,0,0,1,0,1,1,0
1,0,0,1,1,1,0,0,0,0,0,1,0,0,0,1,0,1,0,0
1,0,0,1,1,1,2,0,0,0,0,3,0,0,0,3,0,3,2,0
1,0,0,1,1,1,2,0,0,0,0,3,0,0,0,3,0,3,2,0
1,0,0,1,1,1,2,0,0,0,0,3,0,0,0,3,0,3,2,0
1,0,0,1,1,1,2,0,0,0,0,3,0,0,0,3,0,3,2,0
1,0,0,1,1,1,2,0,0,0,0,3,0,0,0,3,0,3,2,0
1,0,0,1,1,1,2,0,0,0,0,3,0,0,0,3,0,3,2,0
1,0,0,1,1,1,2,0,0,0,0,3,0,0,0,3,0,3,2,0
1,0,0,1,1,1,2,0,0,0,0,3,0,0,0,3,0,3,2,0
1,0,0,1,1,1,2,0,0,0,0,3,0,0,0,3,0,3,2,0
1,0,0,1,1,1,2,0,0,0,0,3,0,0,0,3,0,3,2,0
1,0,0,1,1,1,2,0,0,0,0,3,0,0,0,3,0,3,2,0
1,0,0,1,1,1,3,11.63,2,46.53,0.01,9,0.5,2.58,4,5,3,3,3,0
1,0,0,1,1,1,0,5.33,1.5,12,0,4,0.67,0.67,1,3,1,3,0,0
1,0,0,1,1,1,0,5.33,1.5,12,0,4,0.67,0.67,1,3,1,3,0,0
1,0,0,1,1,1,0,5.33,1.5,12,0,4,0.67,0.67,1,3,1,3,0,0
1,0,0,1,1,1,2,0,0,0,0,3,0,0,0,3,0,3,2,0
1,0,0,1,1,1,2,5.33,1.5,12,0,4,0.67,0.67,1,3,1,3,2,0
1,0,0,1,1,1,2,0,0,0,0,3,0,0,0,3,0,3,2,0
1,0,0,1,1,1,2,0,0,0,0,3,0,0,0,3,0,3,2,0
1,0,0,1,1,1,2,0,0,0,0,3,0,0,0,3,0,3,2,0
1,0,0,1,1,1,2,0,0,0,0,3,0,0,0,3,0,3,2,0
1,0,0,1,1,1,2,0,0,0,0,3,0,0,0,3,0,3,2,0
1,0,0,1,1,1,2,0,0,0,0,3,0,0,0,3,0,3,2,0
1,0,0,1,1,1,2,0,0,0,0,3,0,0,0,3,0,3,2,0
1,0,0,1,1,1,2,0,0,0,0,3,0,0,0,3,0,3,2,0
1,0,0,1,1,1,2,0,0,0,0,3,0,0,0,3,0,3,2,0
1,0,0,1,1,1,2,0,0,0,0,3,0,0,0,3,0,3,2,0
1,0,0,1,1,1,2,0,0,0,0,3,0,0,0,3,0,3,2,0
1,0,0,1,1,1,0,7.74,1.5,17.41,0,5,0.67,0.97,2,3,2,3,0,0
1,0,0,1,1,1,0,7.74,1.5,17.41,0,5,0.67,0.97,2,3,2,3,0,0
1,0,0,1,1,1,0,0,0,0,0,3,0,0,0,3,0,3,0,0
1,0,0,1,1,1,0,5.33,1.5,12,0,4,0.67,0.67,1,3,1,3,0,0
1,0,0,1,1,1,2,0,0,0,0,3,0,0,0,3,0,3,2,0
1,0,0,1,1,1,2,0,0,0,0,3,0,0,0,3,0,3,2,0
1,0,0,1,1,1,2,0,0,0,0,3,0,0,0,3,0,3,2,0
1,0,0,1,1,1,2,0,0,0,0,3,0,0,0,3,0,3,2,0
1,0,0,1,1,1,2,0,0,0,0,3,0,0,0,3,0,3,2,0
1,0,0,1,1,1,2,0,0,0,0,3,0,0,0,3,0,3,2,0
1,0,0,1,1,1,2,0,0,0,0,3,0,0,0,3,0,3,2,0
1,0,0,1,1,1,2,0,0,0,0,3,0,0,0,3,0,3,2,0
1,0,0,1,1,1,2,0,0,0,0,3,0,0,0,3,0,3,2,0
1,0,0,1,1,1,2,0,0,0,0,3,0,0,0,3,0,3,2,0
1,0,0,1,1,1,2,0,0,0,0,3,0,0,0,3,0,3,2,0
1,0,0,1,1,1,0,0,0,0,0,1,0,0,0,1,0,1,0,0
15,5,33,8,1,5,33,27.46,26.82,19755.03,0.25,146,0.04,1097.5,57,89,17,16,38,0
1,0,1,1,1,1,5,6.19,2.25,31.35,0,6,0.44,1.74,3,3,2,3,5,0
5,1,11,3,3,1,16,25.76,8.08,1680.68,0.07,46,0.12,93.37,21,25,13,10,17,0
1,0,11,1,1,1,7,25.48,7.2,1321.03,0.06,44,0.14,73.39,18,26,10,8,7,0
9,4,32,5,5,1,39,41,15,9225,0.21,123,0.07,512.5,50,73,20,12,43,0
5,1,5,3,3,1,9,22.34,5.6,700.55,0.04,30,0.18,38.92,14,16,10,8,10,0
1,0,0,1,1,1,2,5.33,1.5,12,0,4,0.67,0.67,1,3,1,3,2,0
1,0,0,1,1,1,2,5.33,1.5,12,0,4,0.67,0.67,1,3,1,3,2,0
1,0,0,1,1,1,2,5.33,1.5,12,0,4,0.67,0.67,1,3,1,3,2,0
1,0,0,1,1,1,2,5.33,1.5,12,0,4,0.67,0.67,1,3,1,3,2,0
1,0,0,1,1,1,2,5.33,1.5,12,0,4,0.67,0.67,1,3,1,3,2,0
1,0,0,1,1,1,2,5.33,1.5,12,0,4,0.67,0.67,1,3,1,3,2,0
1,0,0,1,1,1,2,5.33,1.5,12,0,4,0.67,0.67,1,3,1,3,2,0
1,0,0,1,1,1,1,0,0,0,0,0,0,0,0,0,0,0,1,0
1,0,0,1,1,1,1,0,0,0,0,1,0,0,0,1,0,1,1,0
1,0,0,1,1,1,2,5.33,1.5,12,0,4,0.67,0.67,1,3,1,3,2,0
1,0,0,1,1,1,2,5.33,1.5,12,0,4,0.67,0.67,1,3,1,3,2,0
1,9,0,1,1,1,2,0,0,0,0,9,0,0,9,0,1,0,11,0
1,0,0,1,1,1,1,0,0,0,0,0,0,0,0,0,0,0,1,0
1,0,0,1,1,1,1,0,0,0,0,0,0,0,0,0,0,0,1,0
1,0,0,1,1,1,1,0,0,0,0,1,0,0,0,1,0,1,1,0
1,0,0,1,1,1,4,18.49,2.4,106.51,0.01,14,0.42,5.92,6,8,5,4,4,0
1,0,0,1,1,1,2,5.33,1.5,12,0,4,0.67,0.67,1,3,1,3,2,0
1,0,0,1,1,1,5,8.45,0.75,4.75,0,4,1.33,0.26,3,1,2,1,5,0
1,0,0,1,1,1,1,0,0,0,0,0,0,0,0,0,0,0,1,0
1,0,0,1,1,1,1,0,0,0,0,1,0,0,0,1,0,1,1,0
1,0,0,1,1,1,3,10.8,2.5,67.5,0.01,9,0.4,3.75,3,6,3,5,3,0
1,0,0,1,1,1,2,5.33,1.5,12,0,4,0.67,0.67,1,3,1,3,2,0
1,0,0,1,1,1,2,6.2,2.5,38.77,0.01,6,0.4,2.15,1,5,1,5,2,0
1,0,0,1,1,1,4,9.51,0.5,2.38,0,3,2,0.13,2,1,2,1,4,0
1,0,0,1,1,1,1,0,0,0,0,1,0,0,0,1,0,1,1,0
1,0,0,1,1,1,1,0,0,0,0,1,0,0,0,1,0,1,1,0
1,0,0,1,1,1,1,0,0,0,0,1,0,0,0,1,0,1,1,0
1,0,0,1,1,1,1,0,0,0,0,1,0,0,0,1,0,1,1,0
1,0,0,1,1,1,1,0,0,0,0,1,0,0,0,1,0,1,1,0
1,0,0,1,1,1,1,0,0,0,0,1,0,0,0,1,0,1,1,0
1,0,0,1,1,1,1,0,0,0,0,1,0,0,0,1,0,1,1,0
1,0,0,1,1,1,0,0,0,0,0,1,0,0,0,1,0,1,0,0
1,0,0,1,1,1,2,0,0,0,0,3,0,0,0,3,0,3,2,0
1,0,0,1,1,1,2,0,0,0,0,3,0,0,0,3,0,3,2,0
1,0,0,1,1,1,2,0,0,0,0,3,0,0,0,3,0,3,2,0
1,0,0,1,1,1,2,0,0,0,0,3,0,0,0,3,0,3,2,0
1,0,0,1,1,1,2,0,0,0,0,3,0,0,0,3,0,3,2,0
1,0,0,1,1,1,2,0,0,0,0,3,0,0,0,3,0,3,2,0
1,0,0,1,1,1,2,0,0,0,0,3,0,0,0,3,0,3,2,0
1,0,0,1,1,1,2,0,0,0,0,3,0,0,0,3,0,3,2,0
1,0,0,1,1,1,2,0,0,0,0,3,0,0,0,3,0,3,2,0
1,0,0,1,1,1,2,0,0,0,0,3,0,0,0,3,0,3,2,0
1,0,0,1,1,1,2,0,0,0,0,3,0,0,0,3,0,3,2,0
1,0,0,1,1,1,3,11.63,2,46.53,0.01,9,0.5,2.58,4,5,3,3,3,0
1,0,0,1,1,1,0,5.33,1.5,12,0,4,0.67,0.67,1,3,1,3,0,0
1,0,0,1,1,1,0,5.33,1.5,12,0,4,0.67,0.67,1,3,1,3,0,0
1,0,0,1,1,1,0,5.33,1.5,12,0,4,0.67,0.67,1,3,1,3,0,0
1,0,0,1,1,1,2,0,0,0,0,3,0,0,0,3,0,3,2,0
1,0,0,1,1,1,2,5.33,1.5,12,0,4,0.67,0.67,1,3,1,3,2,0
1,0,0,1,1,1,2,0,0,0,0,3,0,0,0,3,0,3,2,0
1,0,0,1,1,1,2,0,0,0,0,3,0,0,0,3,0,3,2,0
1,0,0,1,1,1,2,0,0,0,0,3,0,0,0,3,0,3,2,0
1,0,0,1,1,1,2,0,0,0,0,3,0,0,0,3,0,3,2,0
1,0,0,1,1,1,2,0,0,0,0,3,0,0,0,3,0,3,2,0
1,0,0,1,1,1,2,0,0,0,0,3,0,0,0,3,0,3,2,0
1,0,0,1,1,1,2,0,0,0,0,3,0,0,0,3,0,3,2,0
1,0,0,1,1,1,2,0,0,0,0,3,0,0,0,3,0,3,2,0
1,0,0,1,1,1,2,0,0,0,0,3,0,0,0,3,0,3,2,0
1,0,0,1,1,1,2,0,0,0,0,3,0,0,0,3,0,3,2,0
1,0,0,1,1,1,2,0,0,0,0,3,0,0,0,3,0,3,2,0
1,0,0,1,1,1,0,7.74,1.5,17.41,0,5,0.67,0.97,2,3,2,3,0,0
1,0,0,1,1,1,0,7.74,1.5,17.41,0,5,0.67,0.97,2,3,2,3,0,0
1,0,0,1,1,1,0,0,0,0,0,3,0,0,0,3,0,3,0,0
1,0,0,1,1,1,0,5.33,1.5,12,0,4,0.67,0.67,1,3,1,3,0,0
1,0,0,1,1,1,2,0,0,0,0,3,0,0,0,3,0,3,2,0
1,0,0,1,1,1,2,0,0,0,0,3,0,0,0,3,0,3,2,0
1,0,0,1,1,1,2,0,0,0,0,3,0,0,0,3,0,3,2,0
1,0,0,1,1,1,2,0,0,0,0,3,0,0,0,3,0,3,2,0
1,0,0,1,1,1,2,0,0,0,0,3,0,0,0,3,0,3,2,0
1,0,0,1,1,1,2,0,0,0,0,3,0,0,0,3,0,3,2,0
1,0,0,1,1,1,2,0,0,0,0,3,0,0,0,3,0,3,2,0
1,0,0,1,1,1,2,0,0,0,0,3,0,0,0,3,0,3,2,0
1,0,0,1,1,1,2,0,0,0,0,3,0,0,0,3,0,3,2,0
1,0,0,1,1,1,2,0,0,0,0,3,0,0,0,3,0,3,2,0
1,0,0,1,1,1,2,0,0,0,0,3,0,0,0,3,0,3,2,0
5,0,5,3,1,1,7,13.32,13.71,2505.06,0.06,43,0.07,139.17,16,27,7,12,7,0
5,0,5,3,1,1,7,13.32,13.71,2505.06,0.06,43,0.07,139.17,16,27,7,12,7,0
1,0,0,1,1,1,1,0,0,0,0,1,0,0,0,1,0,1,1,0
21,4,16,11,4,5,85,33.99,47.25,75877.16,0.54,306,0.02,4215.4,105,201,20,18,89,1
243,5,89,122,39,82,1121,147.76,208.88,6446813.91,10.29,4687,0,358156.32,1492,3195,75,21,1126,1
1,0,0,1,1,1,16,2.15,6.5,91,0,14,0.15,5.06,13,1,1,1,16,1
17,1,6,9,8,1,37,45.1,16.64,12487.55,0.25,143,0.06,693.75,64,79,25,13,38,1
33,5,11,17,15,4,73,78.27,20.64,33335.21,0.54,282,0.05,1851.96,127,155,40,13,78,1
1,0,1,1,1,1,13,49.62,8.88,3916.66,0.15,102,0.11,217.59,33,69,13,7,13,1
1,0,3,1,1,1,5,34.38,3.75,483.48,0.04,33,0.27,26.86,15,18,10,5,5,0
61,19,138,31,19,13,1409,836.5,66.11,3655422.23,18.43,6716,0.02,203079,2355,4361,285,16,1428,1
9,2,1,8,1,1,27,34.09,9.88,3329.22,0.11,68,0.1,184.96,24,44,17,14,29,0
3,0,1,2,1,1,2,12.09,6.3,479.73,0.03,20,0.16,26.65,7,13,5,9,2,0
1,0,0,1,1,1,2,5.33,1.5,12,0,4,0.67,0.67,1,3,1,3,2,0
1,0,0,1,1,1,2,5.33,1.5,12,0,4,0.67,0.67,1,3,1,3,2,0
1,0,0,1,1,1,2,5.33,1.5,12,0,4,0.67,0.67,1,3,1,3,2,0
1,0,0,1,1,1,2,5.33,1.5,12,0,4,0.67,0.67,1,3,1,3,2,0
1,0,0,1,1,1,2,5.33,1.5,12,0,4,0.67,0.67,1,3,1,3,2,0
1,0,0,1,1,1,2,5.33,1.5,12,0,4,0.67,0.67,1,3,1,3,2,0
1,0,0,1,1,1,2,5.33,1.5,12,0,4,0.67,0.67,1,3,1,3,2,0
1,0,0,1,1,1,2,5.33,1.5,12,0,4,0.67,0.67,1,3,1,3,2,0
1,0,0,1,1,1,2,5.33,1.5,12,0,4,0.67,0.67,1,3,1,3,2,0
1,0,0,1,1,1,2,0,0,0,0,4,0,0,0,4,0,4,2,0
1,0,0,1,1,1,1,0,0,0,0,1,0,0,0,1,0,1,1,0
1,0,0,1,1,1,2,0,0,0,0,5,0,0,0,5,0,5,2,0
11,1,4,6,1,1,21,13.86,22.5,7014.99,0.1,68,0.04,389.72,27,41,9,15,22,0
1,0,0,1,1,1,1,0,0,0,0,0,0,0,0,0,0,0,1,0
1,0,0,1,1,1,1,0,0,0,0,1,0,0,0,1,0,1,1,0
1,0,0,1,1,1,2,5.33,1.5,12,0,4,0.67,0.67,1,3,1,3,2,0
1,0,0,1,1,1,2,5.33,1.5,12,0,4,0.67,0.67,1,3,1,3,2,0
1,9,0,1,1,1,2,0,0,0,0,9,0,0,9,0,1,0,11,0
1,0,0,1,1,1,1,0,0,0,0,0,0,0,0,0,0,0,1,0
1,0,0,1,1,1,1,0,0,0,0,0,0,0,0,0,0,0,1,0
1,0,0,1,1,1,1,0,0,0,0,1,0,0,0,1,0,1,1,0
1,0,0,1,1,1,4,18.49,2.4,106.51,0.01,14,0.42,5.92,6,8,5,4,4,0
1,0,0,1,1,1,2,5.33,1.5,12,0,4,0.67,0.67,1,3,1,3,2,0
1,0,0,1,1,1,5,8.45,0.75,4.75,0,4,1.33,0.26,3,1,2,1,5,0
1,0,0,1,1,1,1,0,0,0,0,0,0,0,0,0,0,0,1,0
1,0,0,1,1,1,1,0,0,0,0,1,0,0,0,1,0,1,1,0
1,0,0,1,1,1,3,10.8,2.5,67.5,0.01,9,0.4,3.75,3,6,3,5,3,0
1,0,0,1,1,1,2,5.33,1.5,12,0,4,0.67,0.67,1,3,1,3,2,0
1,0,0,1,1,1,2,6.2,2.5,38.77,0.01,6,0.4,2.15,1,5,1,5,2,0
1,0,0,1,1,1,4,9.51,0.5,2.38,0,3,2,0.13,2,1,2,1,4,0
1,0,0,1,1,1,1,0,0,0,0,1,0,0,0,1,0,1,1,0
1,0,0,1,1,1,2,5.33,1.5,12,0,4,0.67,0.67,1,3,1,3,2,0
1,0,0,1,1,1,2,5.33,1.5,12,0,4,0.67,0.67,1,3,1,3,2,0
1,0,0,1,1,1,2,0,0,0,0,4,0,0,0,4,0,4,2,0
1,0,0,1,1,1,1,0,0,0,0,1,0,0,0,1,0,1,1,0
1,0,0,1,1,1,2,0,0,0,0,5,0,0,0,5,0,5,2,0
1,0,0,1,1,1,1,0,0,0,0,1,0,0,0,1,0,1,1,0
1,0,0,1,1,1,2,5.33,1.5,12,0,4,0.67,0.67,1,3,1,3,2,0
1,0,0,1,1,1,2,5.33,1.5,12,0,4,0.67,0.67,1,3,1,3,2,0
1,0,0,1,1,1,1,0,0,0,0,1,0,0,0,1,0,1,1,0
1,0,0,1,1,1,1,0,0,0,0,1,0,0,0,1,0,1,1,0
1,0,0,1,1,1,1,0,0,0,0,1,0,0,0,1,0,1,1,0
1,0,0,1,1,1,1,0,0,0,0,1,0,0,0,1,0,1,1,0
1,0,0,1,1,1,1,0,0,0,0,1,0,0,0,1,0,1,1,0
1,0,0,1,1,1,1,0,0,0,0,1,0,0,0,1,0,1,1,0
1,0,0,1,1,1,1,0,0,0,0,1,0,0,0,1,0,1,1,0
9,3,0,5,5,4,4,6.95,27.62,5307.06,0.06,47,0.04,294.84,17,30,4,13,7,0
1,0,0,1,1,1,0,0,0,0,0,1,0,0,0,1,0,1,0,0
1,0,0,1,1,1,0,0,0,0,0,1,0,0,0,1,0,1,0,0
7,1,0,4,2,3,15,14.41,13,2434.85,0.06,42,0.08,135.27,18,24,9,13,16,0
1,0,0,1,1,1,0,0,0,0,0,1,0,0,0,1,0,1,0,0
1,0,0,1,1,1,2,0,0,0,0,3,0,0,0,3,0,3,2,0
1,0,0,1,1,1,2,0,0,0,0,3,0,0,0,3,0,3,2,0
1,0,0,1,1,1,2,0,0,0,0,3,0,0,0,3,0,3,2,0
1,0,0,1,1,1,2,0,0,0,0,3,0,0,0,3,0,3,2,0
1,0,0,1,1,1,2,0,0,0,0,3,0,0,0,3,0,3,2,0
1,0,0,1,1,1,2,0,0,0,0,3,0,0,0,3,0,3,2,0
1,0,0,1,1,1,2,0,0,0,0,3,0,0,0,3,0,3,2,0
1,0,0,1,1,1,2,0,0,0,0,3,0,0,0,3,0,3,2,0
1,0,0,1,1,1,2,0,0,0,0,3,0,0,0,3,0,3,2,0
1,0,0,1,1,1,2,0,0,0,0,3,0,0,0,3,0,3,2,0
1,0,0,1,1,1,2,0,0,0,0,3,0,0,0,3,0,3,2,0
1,0,0,1,1,1,3,11.63,2,46.53,0.01,9,0.5,2.58,4,5,3,3,3,0
1,0,0,1,1,1,0,5.33,1.5,12,0,4,0.67,0.67,1,3,1,3,0,0
1,0,0,1,1,1,0,5.33,1.5,12,0,4,0.67,0.67,1,3,1,3,0,0
1,0,0,1,1,1,0,5.33,1.5,12,0,4,0.67,0.67,1,3,1,3,0,0
1,0,0,1,1,1,2,0,0,0,0,3,0,0,0,3,0,3,2,0
1,0,0,1,1,1,2,5.33,1.5,12,0,4,0.67,0.67,1,3,1,3,2,0
1,0,0,1,1,1,2,0,0,0,0,3,0,0,0,3,0,3,2,0
1,0,0,1,1,1,2,0,0,0,0,3,0,0,0,3,0,3,2,0
1,0,0,1,1,1,2,0,0,0,0,3,0,0,0,3,0,3,2,0
1,0,0,1,1,1,2,0,0,0,0,3,0,0,0,3,0,3,2,0
1,0,0,1,1,1,2,0,0,0,0,3,0,0,0,3,0,3,2,0
1,0,0,1,1,1,2,0,0,0,0,3,0,0,0,3,0,3,2,0
1,0,0,1,1,1,2,0,0,0,0,3,0,0,0,3,0,3,2,0
1,0,0,1,1,1,2,0,0,0,0,3,0,0,0,3,0,3,2,0
1,0,0,1,1,1,2,0,0,0,0,3,0,0,0,3,0,3,2,0
1,0,0,1,1,1,2,0,0,0,0,3,0,0,0,3,0,3,2,0
1,0,0,1,1,1,2,0,0,0,0,3,0,0,0,3,0,3,2,0
1,0,0,1,1,1,0,7.74,1.5,17.41,0,5,0.67,0.97,2,3,2,3,0,0
1,0,0,1,1,1,0,7.74,1.5,17.41,0,5,0.67,0.97,2,3,2,3,0,0
1,0,0,1,1,1,0,0,0,0,0,3,0,0,0,3,0,3,0,0
1,0,0,1,1,1,0,5.33,1.5,12,0,4,0.67,0.67,1,3,1,3,0,0
1,0,0,1,1,1,2,0,0,0,0,3,0,0,0,3,0,3,2,0
1,0,0,1,1,1,2,0,0,0,0,3,0,0,0,3,0,3,2,0
1,0,0,1,1,1,2,0,0,0,0,3,0,0,0,3,0,3,2,0
1,0,0,1,1,1,2,0,0,0,0,3,0,0,0,3,0,3,2,0
1,0,0,1,1,1,2,0,0,0,0,3,0,0,0,3,0,3,2,0
1,0,0,1,1,1,2,0,0,0,0,3,0,0,0,3,0,3,2,0
1,0,0,1,1,1,2,0,0,0,0,3,0,0,0,3,0,3,2,0
1,0,0,1,1,1,2,0,0,0,0,3,0,0,0,3,0,3,2,0
1,0,0,1,1,1,2,0,0,0,0,3,0,0,0,3,0,3,2,0
1,0,0,1,1,1,2,0,0,0,0,3,0,0,0,3,0,3,2,0
1,0,0,1,1,1,2,0,0,0,0,3,0,0,0,3,0,3,2,0
5,0,5,3,1,1,7,13.32,13.71,2505.06,0.06,43,0.07,139.17,16,27,7,12,7,0
5,0,5,3,1,1,7,13.32,13.71,2505.06,0.06,43,0.07,139.17,16,27,7,12,7,0
1,0,0,1,1,1,0,0,0,0,0,1,0,0,0,1,0,1,0,0
5,0,17,3,3,1,10,27.6,10.56,3078.75,0.1,60,0.09,171.04,26,34,16,13,10,1
33,0,0,17,17,1,113,224.73,8.78,17341.46,0.66,337,0.11,963.41,128,209,51,7,113,0
9,1,7,5,1,1,20,9.35,28.17,7418.3,0.09,62,0.04,412.13,26,36,6,13,21,0
39,6,58,20,11,5,173,94.58,43.08,175516.18,1.36,634,0.02,9750.9,236,398,63,23,179,1
1,0,13,1,1,1,17,33.72,11.54,4488.77,0.13,86,0.09,249.38,30,56,13,10,17,0
23,5,10,12,3,8,61,67.99,15.47,16262.02,0.35,195,0.06,903.45,69,126,29,13,66,1
27,4,43,14,4,9,80,58.98,32.08,60705.77,0.63,323,0.03,3372.54,105,218,36,22,84,1
25,3,3,13,4,9,69,46.2,21.58,21520.88,0.33,190,0.05,1195.6,74,116,24,14,72,1
30,4,19,16,4,8,67,50.67,23.63,28282.32,0.4,209,0.04,1571.24,72,137,32,21,71,0
21,1,17,11,5,4,58,41.68,32.4,43783.93,0.45,226,0.03,2432.44,76,150,34,29,59,1
1,0,0,1,1,1,18,2.13,8,136,0.01,17,0.13,7.56,16,1,1,1,18,0
33,8,16,17,8,9,111,55.26,44.84,111104.84,0.83,423,0.02,6172.49,158,265,37,21,119,1
39,5,33,20,10,9,112,91.39,34,105646.44,1.04,460,0.03,5869.25,238,222,84,24,117,0
9,0,13,5,2,1,27,43.61,13.76,8256.62,0.2,112,0.07,458.7,43,69,25,16,27,1
7,1,0,4,2,4,37,36.09,26.07,24531.29,0.31,182,0.04,1362.85,73,109,21,15,38,0
19,7,9,10,9,1,86,50.73,33.71,57646.53,0.57,303,0.03,3202.58,110,193,31,19,93,1
33,4,7,17,13,1,53,59.53,20.2,24290.23,0.4,223,0.05,1349.46,101,122,30,12,57,1
29,2,2,15,11,1,44,57.07,16.09,14779.23,0.31,175,0.06,821.07,79,96,27,11,46,0
27,5,3,14,10,1,41,52.88,17.81,16781.22,0.31,177,0.06,932.29,74,103,27,13,46,0
1,0,3,1,1,1,13,38.04,9.14,3180.21,0.12,78,0.11,176.68,32,46,14,8,13,0
35,3,87,18,2,18,467,393.29,28.3,314983.04,3.71,1580,0.04,17499.06,566,1014,120,12,470,0
5,0,0,3,1,1,15,16.07,7.71,956.57,0.04,31,0.13,53.14,12,19,7,9,15,0
3,0,0,2,2,1,12,34.85,6.75,1587.77,0.08,52,0.15,88.21,21,31,14,9,12,1
1,0,0,1,1,1,0,0,0,0,0,1,0,0,0,1,0,1,0,0
1,0,0,1,1,1,3,7.74,1.5,17.41,0,5,0.67,0.97,2,3,2,3,3,0
1,2,42,1,1,1,280,354.2,15.27,82618.21,1.8,844,0.07,4589.9,294,550,77,8,282,1
1,0,0,1,1,1,0,0,0,0,0,1,0,0,0,1,0,1,0,0
1,0,0,1,1,1,3,7.74,1.5,17.41,0,5,0.67,0.97,2,3,2,3,3,0
1,2,42,1,1,1,280,354.2,15.27,82618.21,1.8,844,0.07,4589.9,294,550,77,8,282,1
1,0,0,1,1,1,0,0,0,0,0,1,0,0,0,1,0,1,0,0
9,2,1,8,1,1,27,34.09,9.88,3329.22,0.11,68,0.1,184.96,24,44,17,14,29,0
3,0,1,2,1,1,2,12.09,6.3,479.73,0.03,20,0.16,26.65,7,13,5,9,2,0
1,0,0,1,1,1,2,5.33,1.5,12,0,4,0.67,0.67,1,3,1,3,2,0
1,0,0,1,1,1,2,5.33,1.5,12,0,4,0.67,0.67,1,3,1,3,2,0
1,0,0,1,1,1,2,5.33,1.5,12,0,4,0.67,0.67,1,3,1,3,2,0
1,0,0,1,1,1,2,5.33,1.5,12,0,4,0.67,0.67,1,3,1,3,2,0
1,0,0,1,1,1,2,5.33,1.5,12,0,4,0.67,0.67,1,3,1,3,2,0
1,0,0,1,1,1,2,5.33,1.5,12,0,4,0.67,0.67,1,3,1,3,2,0
1,0,0,1,1,1,2,5.33,1.5,12,0,4,0.67,0.67,1,3,1,3,2,0
1,0,0,1,1,1,2,5.33,1.5,12,0,4,0.67,0.67,1,3,1,3,2,0
1,0,0,1,1,1,2,5.33,1.5,12,0,4,0.67,0.67,1,3,1,3,2,0
1,0,0,1,1,1,2,0,0,0,0,4,0,0,0,4,0,4,2,0
1,0,0,1,1,1,1,0,0,0,0,1,0,0,0,1,0,1,1,0
1,0,0,1,1,1,2,0,0,0,0,5,0,0,0,5,0,5,2,0
11,1,4,6,1,1,21,13.86,22.5,7014.99,0.1,68,0.04,389.72,27,41,9,15,22,0
1,0,0,1,1,1,1,0,0,0,0,0,0,0,0,0,0,0,1,0
1,0,0,1,1,1,2,8,3,72,0.01,8,0.33,4,2,6,2,6,2,0
1,0,0,1,1,1,2,8,3,72,0.01,8,0.33,4,2,6,2,6,2,0
1,0,0,1,1,1,2,8,3,72,0.01,8,0.33,4,2,6,2,6,2,0
1,0,0,1,1,1,2,8,3,72,0.01,8,0.33,4,2,6,2,6,2,0
1,0,0,1,1,1,2,8,3,72,0.01,8,0.33,4,2,6,2,6,2,0
1,0,0,1,1,1,2,8,3,72,0.01,8,0.33,4,2,6,2,6,2,0
1,0,0,1,1,1,2,8,3,72,0.01,8,0.33,4,2,6,2,6,2,0
1,0,0,1,1,1,2,8,3,72,0.01,8,0.33,4,2,6,2,6,2,0
1,0,0,1,1,1,2,8,3,72,0.01,8,0.33,4,2,6,2,6,2,0
1,0,0,1,1,1,2,8,3,72,0.01,8,0.33,4,2,6,2,6,2,0
1,0,0,1,1,1,1,0,0,0,0,1,0,0,0,1,0,1,1,0
1,0,0,1,1,1,2,5.33,1.5,12,0,4,0.67,0.67,1,3,1,3,2,0
1,0,0,1,1,1,2,5.33,1.5,12,0,4,0.67,0.67,1,3,1,3,2,0
1,9,0,1,1,1,2,0,0,0,0,9,0,0,9,0,1,0,11,0
1,0,0,1,1,1,2,8,3,72,0.01,8,0.33,4,2,6,2,6,2,0
1,0,0,1,1,1,2,8,3,72,0.01,8,0.33,4,2,6,2,6,2,0
1,0,0,1,1,1,3,21.46,5.5,649.15,0.04,31,0.18,36.06,11,20,7,7,3,0
1,0,0,1,1,1,3,21.46,5.5,649.15,0.04,31,0.18,36.06,11,20,7,7,3,0
1,0,0,1,1,1,3,21.46,5.5,649.15,0.04,31,0.18,36.06,11,20,7,7,3,0
1,0,0,1,1,1,3,21.46,5.5,649.15,0.04,31,0.18,36.06,11,20,7,7,3,0
1,0,0,1,1,1,3,21.46,5.5,649.15,0.04,31,0.18,36.06,11,20,7,7,3,0
1,0,0,1,1,1,3,21.46,5.5,649.15,0.04,31,0.18,36.06,11,20,7,7,3,0
1,0,0,1,1,1,2,8,3,72,0.01,8,0.33,4,2,6,2,6,2,0
1,0,0,1,1,1,2,8,3,72,0.01,8,0.33,4,2,6,2,6,2,0
1,0,0,1,1,1,1,0,0,0,0,0,0,0,0,0,0,0,1,0
1,0,0,1,1,1,1,0,0,0,0,0,0,0,0,0,0,0,1,0
1,0,0,1,1,1,1,0,0,0,0,1,0,0,0,1,0,1,1,0
1,0,0,1,1,1,4,18.49,2.4,106.51,0.01,14,0.42,5.92,6,8,5,4,4,0
1,0,0,1,1,1,2,5.33,1.5,12,0,4,0.67,0.67,1,3,1,3,2,0
1,0,0,1,1,1,5,8.45,0.75,4.75,0,4,1.33,0.26,3,1,2,1,5,0
1,0,0,1,1,1,1,0,0,0,0,0,0,0,0,0,0,0,1,0
1,0,0,1,1,1,1,0,0,0,0,1,0,0,0,1,0,1,1,0
1,0,0,1,1,1,3,10.8,2.5,67.5,0.01,9,0.4,3.75,3,6,3,5,3,0
1,0,0,1,1,1,2,5.33,1.5,12,0,4,0.67,0.67,1,3,1,3,2,0
1,0,0,1,1,1,2,6.2,2.5,38.77,0.01,6,0.4,2.15,1,5,1,5,2,0
1,0,0,1,1,1,4,9.51,0.5,2.38,0,3,2,0.13,2,1,2,1,4,0
1,0,0,1,1,1,1,0,0,0,0,1,0,0,0,1,0,1,1,0
1,0,0,1,1,1,2,5.33,1.5,12,0,4,0.67,0.67,1,3,1,3,2,0
1,0,0,1,1,1,2,5.33,1.5,12,0,4,0.67,0.67,1,3,1,3,2,0
1,0,0,1,1,1,2,0,0,0,0,4,0,0,0,4,0,4,2,0
1,0,0,1,1,1,1,0,0,0,0,1,0,0,0,1,0,1,1,0
1,0,0,1,1,1,2,0,0,0,0,5,0,0,0,5,0,5,2,0
1,0,0,1,1,1,1,0,0,0,0,1,0,0,0,1,0,1,1,0
1,0,0,1,1,1,2,5.33,1.5,12,0,4,0.67,0.67,1,3,1,3,2,0
1,0,0,1,1,1,2,5.33,1.5,12,0,4,0.67,0.67,1,3,1,3,2,0
1,0,0,1,1,1,1,0,0,0,0,1,0,0,0,1,0,1,1,0
1,0,0,1,1,1,1,0,0,0,0,1,0,0,0,1,0,1,1,0
1,0,0,1,1,1,1,0,0,0,0,1,0,0,0,1,0,1,1,0
1,0,0,1,1,1,1,0,0,0,0,1,0,0,0,1,0,1,1,0
1,0,0,1,1,1,1,0,0,0,0,1,0,0,0,1,0,1,1,0
1,0,0,1,1,1,1,0,0,0,0,1,0,0,0,1,0,1,1,0
1,0,0,1,1,1,1,0,0,0,0,1,0,0,0,1,0,1,1,0
1,0,0,1,1,1,0,0,0,0,0,1,0,0,0,1,0,1,0,0
1,0,0,1,1,1,2,0,0,0,0,3,0,0,0,3,0,3,2,0
1,0,0,1,1,1,2,0,0,0,0,3,0,0,0,3,0,3,2,0
1,0,0,1,1,1,2,0,0,0,0,3,0,0,0,3,0,3,2,0
1,0,0,1,1,1,2,0,0,0,0,3,0,0,0,3,0,3,2,0
1,0,0,1,1,1,2,0,0,0,0,3,0,0,0,3,0,3,2,0
1,0,0,1,1,1,2,0,0,0,0,3,0,0,0,3,0,3,2,0
1,0,0,1,1,1,2,0,0,0,0,3,0,0,0,3,0,3,2,0
1,0,0,1,1,1,2,0,0,0,0,3,0,0,0,3,0,3,2,0
1,0,0,1,1,1,2,0,0,0,0,3,0,0,0,3,0,3,2,0
1,0,0,1,1,1,2,0,0,0,0,3,0,0,0,3,0,3,2,0
1,0,0,1,1,1,2,0,0,0,0,3,0,0,0,3,0,3,2,0
1,0,0,1,1,1,3,11.63,2,46.53,0.01,9,0.5,2.58,4,5,3,3,3,0
1,0,0,1,1,1,0,5.33,1.5,12,0,4,0.67,0.67,1,3,1,3,0,0
1,0,0,1,1,1,0,5.33,1.5,12,0,4,0.67,0.67,1,3,1,3,0,0
1,0,0,1,1,1,0,5.33,1.5,12,0,4,0.67,0.67,1,3,1,3,0,0
1,0,0,1,1,1,2,0,0,0,0,3,0,0,0,3,0,3,2,0
1,0,0,1,1,1,2,5.33,1.5,12,0,4,0.67,0.67,1,3,1,3,2,0
1,0,0,1,1,1,2,0,0,0,0,3,0,0,0,3,0,3,2,0
1,0,0,1,1,1,2,0,0,0,0,3,0,0,0,3,0,3,2,0
1,0,0,1,1,1,2,0,0,0,0,3,0,0,0,3,0,3,2,0
1,0,0,1,1,1,2,0,0,0,0,3,0,0,0,3,0,3,2,0
1,0,0,1,1,1,2,0,0,0,0,3,0,0,0,3,0,3,2,0
1,0,0,1,1,1,2,0,0,0,0,3,0,0,0,3,0,3,2,0
1,0,0,1,1,1,2,0,0,0,0,3,0,0,0,3,0,3,2,0
1,0,0,1,1,1,2,0,0,0,0,3,0,0,0,3,0,3,2,0
1,0,0,1,1,1,2,0,0,0,0,3,0,0,0,3,0,3,2,0
1,0,0,1,1,1,2,0,0,0,0,3,0,0,0,3,0,3,2,0
1,0,0,1,1,1,2,0,0,0,0,3,0,0,0,3,0,3,2,0
1,0,0,1,1,1,0,7.74,1.5,17.41,0,5,0.67,0.97,2,3,2,3,0,0
1,0,0,1,1,1,0,7.74,1.5,17.41,0,5,0.67,0.97,2,3,2,3,0,0
1,0,0,1,1,1,0,0,0,0,0,3,0,0,0,3,0,3,0,0
1,0,0,1,1,1,0,5.33,1.5,12,0,4,0.67,0.67,1,3,1,3,0,0
1,0,0,1,1,1,2,0,0,0,0,3,0,0,0,3,0,3,2,0
1,0,0,1,1,1,2,0,0,0,0,3,0,0,0,3,0,3,2,0
1,0,0,1,1,1,2,0,0,0,0,3,0,0,0,3,0,3,2,0
1,0,0,1,1,1,2,0,0,0,0,3,0,0,0,3,0,3,2,0
1,0,0,1,1,1,2,0,0,0,0,3,0,0,0,3,0,3,2,0
1,0,0,1,1,1,2,0,0,0,0,3,0,0,0,3,0,3,2,0
1,0,0,1,1,1,2,0,0,0,0,3,0,0,0,3,0,3,2,0
1,0,0,1,1,1,2,0,0,0,0,3,0,0,0,3,0,3,2,0
1,0,0,1,1,1,2,0,0,0,0,3,0,0,0,3,0,3,2,0
1,0,0,1,1,1,2,0,0,0,0,3,0,0,0,3,0,3,2,0
1,0,0,1,1,1,2,0,0,0,0,3,0,0,0,3,0,3,2,0
1,0,0,1,1,1,0,0,0,0,0,1,0,0,0,1,0,1,0,0
5,0,5,3,1,1,7,13.32,13.71,2505.06,0.06,43,0.07,139.17,16,27,7,12,7,0
5,0,5,3,1,1,7,13.32,13.71,2505.06,0.06,43,0.07,139.17,16,27,7,12,7,0
1,0,0,1,1,1,0,0,0,0,0,1,0,0,0,1,0,1,0,0
5,0,0,3,1,1,7,10.85,17,3136.11,0.06,42,0.06,174.23,17,25,7,14,7,0
5,0,1,3,1,1,6,12.57,13.13,2165.61,0.05,37,0.08,120.31,15,22,8,14,6,0
5,0,1,3,2,1,14,17.84,21,7866.44,0.12,84,0.05,437.02,42,42,11,11,14,0
13,0,6,7,3,6,26,23.39,29.87,20863.11,0.23,141,0.03,1159.06,56,85,15,16,26,0
13,0,5,7,1,1,53,27.14,62.12,104712.92,0.56,347,0.02,5817.38,176,171,17,12,53,0
7,0,1,4,1,1,21,33.7,5.33,958.49,0.06,46,0.19,53.25,16,30,9,6,21,0
1,0,0,1,1,1,6,34.58,9.63,3203.61,0.11,70,0.1,177.98,28,42,16,11,6,0
9,0,4,5,1,1,22,14.85,30,13366,0.15,109,0.03,742.56,42,67,7,10,22,0
21,1,30,11,3,5,128,54.46,47.18,121239.71,0.86,435,0.02,6735.54,163,272,38,22,129,0
105,12,78,53,15,31,373,133.1,88.19,1035291.39,3.91,1718,0.01,57516.19,597,1121,88,26,385,0
1,0,24,1,1,1,99,48.76,74.29,269083.18,1.21,712,0.01,14949.07,240,472,21,13,99,0
9,0,12,5,5,1,36,33.69,16.32,8977.94,0.18,110,0.06,498.77,37,73,17,15,36,0
21,0,17,11,1,9,48,22.48,35.81,28825.19,0.27,161,0.03,1601.4,49,112,13,19,48,0
1,0,0,1,1,1,20,130.16,2.57,860.66,0.11,73,0.39,47.81,36,37,21,3,20,0
3,0,0,2,1,1,11,15.84,18,5133.65,0.1,73,0.06,285.2,24,49,6,9,11,0
3,0,14,2,1,1,20,22.7,27.5,17168.81,0.21,140,0.04,953.82,55,85,11,11,20,0
13,0,4,7,6,1,31,45.95,13.5,8375.28,0.21,120,0.07,465.29,54,66,24,12,31,0
17,0,6,9,8,1,39,55.46,14.67,11930.29,0.27,155,0.07,662.79,72,83,27,11,39,0
3,0,1,2,2,1,7,19.48,4.81,451.25,0.03,24,0.21,25.07,11,13,8,7,7,0
11,0,4,6,5,1,25,35.31,13,5967.52,0.15,91,0.08,331.53,40,51,20,13,25,0
11,0,4,6,5,1,25,35.31,13,5967.52,0.15,91,0.08,331.53,40,51,20,13,25,0
1,0,2,1,1,1,21,78.71,11.3,10041.78,0.3,183,0.09,557.88,71,112,22,7,21,0
61,0,162,31,16,17,1079,649.55,43.39,1222822.28,9.39,3551,0.02,67934.57,1242,2309,229,16,1079,0
18,1,4,12,5,3,55,41.18,23.8,23325.94,0.33,161,0.04,1295.89,68,93,40,28,56,0
10,1,1,6,4,1,27,27.81,15.42,6610.26,0.14,85,0.06,367.24,37,48,18,15,28,0
1,0,0,1,1,1,0,0,0,0,0,1,0,0,0,1,0,1,0,0
9,2,1,8,1,1,27,34.09,9.88,3329.22,0.11,68,0.1,184.96,24,44,17,14,29,0
3,0,1,2,1,1,2,12.09,6.3,479.73,0.03,20,0.16,26.65,7,13,5,9,2,0
1,0,0,1,1,1,2,5.33,1.5,12,0,4,0.67,0.67,1,3,1,3,2,0
1,0,0,1,1,1,2,5.33,1.5,12,0,4,0.67,0.67,1,3,1,3,2,0
1,0,0,1,1,1,2,5.33,1.5,12,0,4,0.67,0.67,1,3,1,3,2,0
1,0,0,1,1,1,2,5.33,1.5,12,0,4,0.67,0.67,1,3,1,3,2,0
1,0,0,1,1,1,2,5.33,1.5,12,0,4,0.67,0.67,1,3,1,3,2,0
1,0,0,1,1,1,2,5.33,1.5,12,0,4,0.67,0.67,1,3,1,3,2,0
1,0,0,1,1,1,2,5.33,1.5,12,0,4,0.67,0.67,1,3,1,3,2,0
1,0,0,1,1,1,2,5.33,1.5,12,0,4,0.67,0.67,1,3,1,3,2,0
1,0,0,1,1,1,2,5.33,1.5,12,0,4,0.67,0.67,1,3,1,3,2,0
1,0,0,1,1,1,2,0,0,0,0,4,0,0,0,4,0,4,2,0
1,0,0,1,1,1,1,0,0,0,0,1,0,0,0,1,0,1,1,0
1,0,0,1,1,1,2,0,0,0,0,5,0,0,0,5,0,5,2,0
11,1,4,6,1,1,21,13.86,22.5,7014.99,0.1,68,0.04,389.72,27,41,9,15,22,0
1,0,0,1,1,1,2,20.97,3,188.72,0.02,17,0.33,10.48,7,10,7,6,2,0
1,0,0,1,1,1,2,20.97,3,188.72,0.02,17,0.33,10.48,7,10,7,6,2,0
1,0,0,1,1,1,2,27.35,3,246.13,0.03,21,0.33,13.67,9,12,9,6,2,0
1,0,0,1,1,1,3,30.67,3,276,0.03,23,0.33,15.33,10,13,10,6,3,0
1,0,0,1,1,1,3,30.67,3,276,0.03,23,0.33,15.33,10,13,10,6,3,0
1,0,0,1,1,1,3,30.67,3,276,0.03,23,0.33,15.33,10,13,10,6,3,0
1,0,0,1,1,1,2,27.35,3,246.13,0.03,21,0.33,13.67,9,12,9,6,2,0
1,0,0,1,1,1,3,27.35,3,246.13,0.03,21,0.33,13.67,9,12,9,6,3,0
1,0,0,1,1,1,2,20.97,3,188.72,0.02,17,0.33,10.48,7,10,7,6,2,0
1,0,0,1,1,1,2,20.97,3,188.72,0.02,17,0.33,10.48,7,10,7,6,2,0
1,0,0,1,1,1,2,20.97,3,188.72,0.02,17,0.33,10.48,7,10,7,6,2,0
1,0,0,1,1,1,2,17.92,3,161.32,0.02,15,0.33,8.96,6,9,6,6,2,0
1,0,0,1,1,1,2,17.92,3,161.32,0.02,15,0.33,8.96,6,9,6,6,2,0
1,0,0,1,1,1,2,14.99,3,134.92,0.01,13,0.33,7.5,5,8,5,6,2,0
1,0,0,1,1,1,2,14.99,3,134.92,0.01,13,0.33,7.5,5,8,5,6,2,0
1,0,0,1,1,1,2,14.99,3,134.92,0.01,13,0.33,7.5,5,8,5,6,2,0
1,0,0,1,1,1,2,14.99,3,134.92,0.01,13,0.33,7.5,5,8,5,6,2,0
1,0,0,1,1,1,2,14.99,3,134.92,0.01,13,0.33,7.5,5,8,5,6,2,0
1,0,0,1,1,1,2,17.92,3,161.32,0.02,15,0.33,8.96,6,9,6,6,2,0
1,0,0,1,1,1,2,17.92,3,161.32,0.02,15,0.33,8.96,6,9,6,6,2,0
1,0,0,1,1,1,2,20.97,3,188.72,0.02,17,0.33,10.48,7,10,7,6,2,0
1,0,0,1,1,1,2,20.97,3,188.72,0.02,17,0.33,10.48,7,10,7,6,2,0
1,0,0,1,1,1,1,0,0,0,0,0,0,0,0,0,0,0,1,0
1,0,0,1,1,1,1,0,0,0,0,1,0,0,0,1,0,1,1,0
1,0,0,1,1,1,2,5.33,1.5,12,0,4,0.67,0.67,1,3,1,3,2,0
1,0,0,1,1,1,2,5.33,1.5,12,0,4,0.67,0.67,1,3,1,3,2,0
1,9,0,1,1,1,2,0,0,0,0,9,0,0,9,0,1,0,11,0
1,0,0,1,1,1,1,0,0,0,0,0,0,0,0,0,0,0,1,0
1,0,0,1,1,1,1,0,0,0,0,0,0,0,0,0,0,0,1,0
1,0,0,1,1,1,1,0,0,0,0,1,0,0,0,1,0,1,1,0
1,0,0,1,1,1,4,18.49,2.4,106.51,0.01,14,0.42,5.92,6,8,5,4,4,0
1,0,0,1,1,1,2,5.33,1.5,12,0,4,0.67,0.67,1,3,1,3,2,0
1,0,0,1,1,1,5,8.45,0.75,4.75,0,4,1.33,0.26,3,1,2,1,5,0
1,0,0,1,1,1,1,0,0,0,0,0,0,0,0,0,0,0,1,0
1,0,0,1,1,1,1,0,0,0,0,1,0,0,0,1,0,1,1,0
1,0,0,1,1,1,3,10.8,2.5,67.5,0.01,9,0.4,3.75,3,6,3,5,3,0
1,0,0,1,1,1,2,5.33,1.5,12,0,4,0.67,0.67,1,3,1,3,2,0
1,0,0,1,1,1,2,6.2,2.5,38.77,0.01,6,0.4,2.15,1,5,1,5,2,0
1,0,0,1,1,1,4,9.51,0.5,2.38,0,3,2,0.13,2,1,2,1,4,0
1,0,0,1,1,1,1,0,0,0,0,1,0,0,0,1,0,1,1,0
1,0,0,1,1,1,2,5.33,1.5,12,0,4,0.67,0.67,1,3,1,3,2,0
1,0,0,1,1,1,2,5.33,1.5,12,0,4,0.67,0.67,1,3,1,3,2,0
1,0,0,1,1,1,2,0,0,0,0,4,0,0,0,4,0,4,2,0
1,0,0,1,1,1,1,0,0,0,0,1,0,0,0,1,0,1,1,0
1,0,0,1,1,1,2,0,0,0,0,5,0,0,0,5,0,5,2,0
1,0,0,1,1,1,1,0,0,0,0,1,0,0,0,1,0,1,1,0
1,0,0,1,1,1,2,5.33,1.5,12,0,4,0.67,0.67,1,3,1,3,2,0
1,0,0,1,1,1,2,5.33,1.5,12,0,4,0.67,0.67,1,3,1,3,2,0
1,0,0,1,1,1,1,0,0,0,0,1,0,0,0,1,0,1,1,0
1,0,0,1,1,1,1,0,0,0,0,1,0,0,0,1,0,1,1,0
1,0,0,1,1,1,1,0,0,0,0,1,0,0,0,1,0,1,1,0
1,0,0,1,1,1,0,0,0,0,0,1,0,0,0,1,0,1,0,0
1,0,0,1,1,1,2,0,0,0,0,3,0,0,0,3,0,3,2,0
1,0,0,1,1,1,2,0,0,0,0,3,0,0,0,3,0,3,2,0
1,0,0,1,1,1,2,0,0,0,0,3,0,0,0,3,0,3,2,0
1,0,0,1,1,1,2,0,0,0,0,3,0,0,0,3,0,3,2,0
1,0,0,1,1,1,2,0,0,0,0,3,0,0,0,3,0,3,2,0
1,0,0,1,1,1,2,0,0,0,0,3,0,0,0,3,0,3,2,0
1,0,0,1,1,1,2,0,0,0,0,3,0,0,0,3,0,3,2,0
1,0,0,1,1,1,2,0,0,0,0,3,0,0,0,3,0,3,2,0
1,0,0,1,1,1,2,0,0,0,0,3,0,0,0,3,0,3,2,0
1,0,0,1,1,1,2,0,0,0,0,3,0,0,0,3,0,3,2,0
1,0,0,1,1,1,2,0,0,0,0,3,0,0,0,3,0,3,2,0
1,0,0,1,1,1,3,11.63,2,46.53,0.01,9,0.5,2.58,4,5,3,3,3,0
1,0,0,1,1,1,0,5.33,1.5,12,0,4,0.67,0.67,1,3,1,3,0,0
1,0,0,1,1,1,0,5.33,1.5,12,0,4,0.67,0.67,1,3,1,3,0,0
1,0,0,1,1,1,0,5.33,1.5,12,0,4,0.67,0.67,1,3,1,3,0,0
1,0,0,1,1,1,2,0,0,0,0,3,0,0,0,3,0,3,2,0
1,0,0,1,1,1,2,5.33,1.5,12,0,4,0.67,0.67,1,3,1,3,2,0
1,0,0,1,1,1,2,0,0,0,0,3,0,0,0,3,0,3,2,0
1,0,0,1,1,1,2,0,0,0,0,3,0,0,0,3,0,3,2,0
1,0,0,1,1,1,2,0,0,0,0,3,0,0,0,3,0,3,2,0
1,0,0,1,1,1,2,0,0,0,0,3,0,0,0,3,0,3,2,0
1,0,0,1,1,1,2,0,0,0,0,3,0,0,0,3,0,3,2,0
1,0,0,1,1,1,2,0,0,0,0,3,0,0,0,3,0,3,2,0
1,0,0,1,1,1,2,0,0,0,0,3,0,0,0,3,0,3,2,0
1,0,0,1,1,1,2,0,0,0,0,3,0,0,0,3,0,3,2,0
1,0,0,1,1,1,2,0,0,0,0,3,0,0,0,3,0,3,2,0
1,0,0,1,1,1,2,0,0,0,0,3,0,0,0,3,0,3,2,0
1,0,0,1,1,1,2,0,0,0,0,3,0,0,0,3,0,3,2,0
1,0,0,1,1,1,0,7.74,1.5,17.41,0,5,0.67,0.97,2,3,2,3,0,0
1,0,0,1,1,1,0,7.74,1.5,17.41,0,5,0.67,0.97,2,3,2,3,0,0
1,0,0,1,1,1,0,0,0,0,0,3,0,0,0,3,0,3,0,0
1,0,0,1,1,1,0,5.33,1.5,12,0,4,0.67,0.67,1,3,1,3,0,0
1,0,0,1,1,1,2,0,0,0,0,3,0,0,0,3,0,3,2,0
1,0,0,1,1,1,2,0,0,0,0,3,0,0,0,3,0,3,2,0
1,0,0,1,1,1,2,0,0,0,0,3,0,0,0,3,0,3,2,0
1,0,0,1,1,1,2,0,0,0,0,3,0,0,0,3,0,3,2,0
1,0,0,1,1,1,2,0,0,0,0,3,0,0,0,3,0,3,2,0
1,0,0,1,1,1,2,0,0,0,0,3,0,0,0,3,0,3,2,0
1,0,0,1,1,1,2,0,0,0,0,3,0,0,0,3,0,3,2,0
1,0,0,1,1,1,2,0,0,0,0,3,0,0,0,3,0,3,2,0
1,0,0,1,1,1,2,0,0,0,0,3,0,0,0,3,0,3,2,0
1,0,0,1,1,1,2,0,0,0,0,3,0,0,0,3,0,3,2,0
1,0,0,1,1,1,2,0,0,0,0,3,0,0,0,3,0,3,2,0
1,0,0,1,1,1,0,0,0,0,0,1,0,0,0,1,0,1,0,0
1,0,1,1,1,1,4,27.47,1.5,61.81,0.01,13,0.67,3.43,6,7,6,3,4,0
1,0,0,1,1,1,6,17.09,8,1093.93,0.05,35,0.13,60.77,14,21,7,8,6,0
9,2,15,5,1,3,33,17.01,26.71,12142.23,0.15,109,0.04,674.57,34,75,7,11,35,0
7,1,4,4,3,1,18,26.96,10.29,2852.5,0.09,59,0.1,158.47,24,35,14,12,19,0
1,0,0,1,1,1,2,5.33,1.5,12,0,4,0.67,0.67,1,3,1,3,2,0
1,0,0,1,1,1,2,5.33,1.5,12,0,4,0.67,0.67,1,3,1,3,2,0
1,0,0,1,1,1,2,0,0,0,0,4,0,0,0,4,0,4,2,0
1,0,0,1,1,1,1,0,0,0,0,1,0,0,0,1,0,1,1,0
1,0,0,1,1,1,2,0,0,0,0,5,0,0,0,5,0,5,2,0
1,0,0,1,1,1,1,0,0,0,0,1,0,0,0,1,0,1,1,0
1,0,0,1,1,1,2,5.33,1.5,12,0,4,0.67,0.67,1,3,1,3,2,0
1,0,0,1,1,1,2,5.33,1.5,12,0,4,0.67,0.67,1,3,1,3,2,0
1,0,0,1,1,1,2,0,0,0,0,4,0,0,0,4,0,4,2,0
1,0,0,1,1,1,1,0,0,0,0,1,0,0,0,1,0,1,1,0
1,0,0,1,1,1,2,0,0,0,0,5,0,0,0,5,0,5,2,0
1,0,0,1,1,1,1,0,0,0,0,1,0,0,0,1,0,1,1,0
1,0,0,1,1,1,2,5.33,1.5,12,0,4,0.67,0.67,1,3,1,3,2,0
1,0,0,1,1,1,2,5.33,1.5,12,0,4,0.67,0.67,1,3,1,3,2,0
1,0,0,1,1,1,1,0,0,0,0,1,0,0,0,1,0,1,1,0
1,0,0,1,1,1,1,0,0,0,0,1,0,0,0,1,0,1,1,0
1,0,0,1,1,1,1,0,0,0,0,1,0,0,0,1,0,1,1,0
1,0,0,1,1,1,1,0,0,0,0,1,0,0,0,1,0,1,1,0
1,0,0,1,1,1,1,0,0,0,0,1,0,0,0,1,0,1,1,0
1,0,0,1,1,1,1,0,0,0,0,1,0,0,0,1,0,1,1,0
1,0,0,1,1,1,1,0,0,0,0,1,0,0,0,1,0,1,1,0
1,0,0,1,1,1,0,0,0,0,0,1,0,0,0,1,0,1,0,0
1,0,0,1,1,1,2,0,0,0,0,3,0,0,0,3,0,3,2,0
1,0,0,1,1,1,2,0,0,0,0,3,0,0,0,3,0,3,2,0
1,0,0,1,1,1,2,0,0,0,0,3,0,0,0,3,0,3,2,0
1,0,0,1,1,1,2,0,0,0,0,3,0,0,0,3,0,3,2,0
1,0,0,1,1,1,2,0,0,0,0,3,0,0,0,3,0,3,2,0
1,0,0,1,1,1,2,0,0,0,0,3,0,0,0,3,0,3,2,0
1,0,0,1,1,1,2,0,0,0,0,3,0,0,0,3,0,3,2,0
1,0,0,1,1,1,2,0,0,0,0,3,0,0,0,3,0,3,2,0
1,0,0,1,1,1,2,0,0,0,0,3,0,0,0,3,0,3,2,0
1,0,0,1,1,1,2,0,0,0,0,3,0,0,0,3,0,3,2,0
1,0,0,1,1,1,2,0,0,0,0,3,0,0,0,3,0,3,2,0
1,0,0,1,1,1,3,11.63,2,46.53,0.01,9,0.5,2.58,4,5,3,3,3,0
1,0,0,1,1,1,0,5.33,1.5,12,0,4,0.67,0.67,1,3,1,3,0,0
1,0,0,1,1,1,0,5.33,1.5,12,0,4,0.67,0.67,1,3,1,3,0,0
1,0,0,1,1,1,0,5.33,1.5,12,0,4,0.67,0.67,1,3,1,3,0,0
1,0,0,1,1,1,2,0,0,0,0,3,0,0,0,3,0,3,2,0
1,0,0,1,1,1,2,5.33,1.5,12,0,4,0.67,0.67,1,3,1,3,2,0
1,0,0,1,1,1,2,0,0,0,0,3,0,0,0,3,0,3,2,0
1,0,0,1,1,1,2,0,0,0,0,3,0,0,0,3,0,3,2,0
1,0,0,1,1,1,2,0,0,0,0,3,0,0,0,3,0,3,2,0
1,0,0,1,1,1,2,0,0,0,0,3,0,0,0,3,0,3,2,0
1,0,0,1,1,1,2,0,0,0,0,3,0,0,0,3,0,3,2,0
1,0,0,1,1,1,2,0,0,0,0,3,0,0,0,3,0,3,2,0
1,0,0,1,1,1,2,0,0,0,0,3,0,0,0,3,0,3,2,0
1,0,0,1,1,1,2,0,0,0,0,3,0,0,0,3,0,3,2,0
1,0,0,1,1,1,2,0,0,0,0,3,0,0,0,3,0,3,2,0
1,0,0,1,1,1,2,0,0,0,0,3,0,0,0,3,0,3,2,0
1,0,0,1,1,1,2,0,0,0,0,3,0,0,0,3,0,3,2,0
1,0,0,1,1,1,0,7.74,1.5,17.41,0,5,0.67,0.97,2,3,2,3,0,0
1,0,0,1,1,1,0,7.74,1.5,17.41,0,5,0.67,0.97,2,3,2,3,0,0
1,0,0,1,1,1,0,0,0,0,0,3,0,0,0,3,0,3,0,0
1,0,0,1,1,1,0,5.33,1.5,12,0,4,0.67,0.67,1,3,1,3,0,0
1,0,0,1,1,1,2,0,0,0,0,3,0,0,0,3,0,3,2,0
1,0,0,1,1,1,2,0,0,0,0,3,0,0,0,3,0,3,2,0
1,0,0,1,1,1,2,0,0,0,0,3,0,0,0,3,0,3,2,0
1,0,0,1,1,1,2,0,0,0,0,3,0,0,0,3,0,3,2,0
1,0,0,1,1,1,2,0,0,0,0,3,0,0,0,3,0,3,2,0
1,0,0,1,1,1,2,0,0,0,0,3,0,0,0,3,0,3,2,0
1,0,0,1,1,1,2,0,0,0,0,3,0,0,0,3,0,3,2,0
1,0,0,1,1,1,2,0,0,0,0,3,0,0,0,3,0,3,2,0
1,0,0,1,1,1,2,0,0,0,0,3,0,0,0,3,0,3,2,0
1,0,0,1,1,1,2,0,0,0,0,3,0,0,0,3,0,3,2,0
1,0,0,1,1,1,2,0,0,0,0,3,0,0,0,3,0,3,2,0
1,0,0,1,1,1,0,0,0,0,0,1,0,0,0,1,0,1,0,0
5,0,5,3,1,1,7,13.32,13.71,2505.06,0.06,43,0.07,139.17,16,27,7,12,7,0
5,0,5,3,1,1,7,13.32,13.71,2505.06,0.06,43,0.07,139.17,16,27,7,12,7,0
1,0,0,1,1,1,0,0,0,0,0,1,0,0,0,1,0,1,0,0
37,0,10,19,11,7,111,61.15,77.5,367257.39,1.58,784,0.01,20403.19,310,474,44,22,111,0
27,2,14,14,8,7,145,112.36,60.91,416860.11,2.28,1065,0.02,23158.9,402,663,66,20,147,0
1,0,0,1,1,1,10,86,1.6,220.17,0.05,33,0.63,12.23,16,17,15,3,10,0
17,0,6,9,6,5,335,255.64,45.15,521103.35,3.85,1683,0.02,28950.19,608,1075,101,15,335,0
1,0,0,1,1,1,0,0,0,0,0,1,0,0,0,1,0,1,0,0
29,0,10,15,9,7,101,74.71,57.54,247345.66,1.43,699,0.02,13741.43,274,425,50,21,101,0
9,2,10,5,5,1,56,52.3,34.8,63339.46,0.61,342,0.03,3518.86,116,226,25,15,58,0
1,0,0,1,1,1,10,78.68,1.71,231.23,0.04,33,0.58,12.85,16,17,14,3,10,0
17,0,5,9,6,5,175,132.79,40.17,214260.87,1.78,859,0.02,11903.38,316,543,59,15,175,0
1,0,0,1,1,1,0,0,0,0,0,1,0,0,0,1,0,1,0,0
29,0,10,15,9,7,101,74.71,57.54,247345.66,1.43,699,0.02,13741.43,274,425,50,21,101,0
15,2,14,8,5,3,82,87.79,39.59,137611.34,1.16,569,0.03,7645.07,194,375,49,20,84,0
1,0,0,1,1,1,10,86,1.6,220.17,0.05,33,0.63,12.23,16,17,15,3,10,0
17,0,128,9,6,5,855,525.77,52.73,1461715.65,9.24,3581,0.02,81206.42,1305,2276,198,16,855,0
1,0,0,1,1,1,0,0,0,0,0,1,0,0,0,1,0,1,0,0
1,0,0,1,1,1,8,58.17,1.64,155.76,0.03,25,0.61,8.65,12,13,11,3,8,0
5,0,1,3,2,3,185,162.41,38.16,236511.26,2.07,995,0.03,13139.51,364,631,62,13,185,0
1,0,0,1,1,1,0,0,0,0,0,1,0,0,0,1,0,1,0,0
11,0,1,6,3,3,41,41.06,32.02,42091.79,0.44,238,0.03,2338.43,91,147,27,19,41,0
7,0,17,4,1,3,47,77.88,30.05,70308.81,0.78,393,0.03,3906.05,136,257,43,19,47,0
1,0,0,1,1,1,4,16.84,1.5,37.9,0.01,9,0.67,2.11,4,5,4,3,4,0
17,0,140,9,6,5,787,511.58,44.73,1023408.15,7.63,3035,0.02,56856.01,1099,1936,172,14,787,0
1,0,0,1,1,1,0,0,0,0,0,1,0,0,0,1,0,1,0,0
1,0,0,1,1,1,8,58.17,1.64,155.76,0.03,25,0.61,8.65,12,13,11,3,8,0
5,0,1,3,2,3,181,156.05,38.68,233406.68,2,975,0.03,12967.04,357,618,60,13,181,0
1,0,0,1,1,1,0,0,0,0,0,1,0,0,0,1,0,1,0,0
5,0,0,3,1,1,7,10.85,17,3136.11,0.06,42,0.06,174.23,17,25,7,14,7,0
5,0,1,3,1,1,6,12.57,13.13,2165.61,0.05,37,0.08,120.31,15,22,8,14,6,0
1,0,0,1,1,1,0,0,0,0,0,1,0,0,0,1,0,1,0,0
9,2,1,8,1,1,27,34.09,9.88,3329.22,0.11,68,0.1,184.96,24,44,17,14,29,0
1,0,0,1,1,1,0,0,0,0,0,1,0,0,0,1,0,1,0,0
1,0,0,1,1,1,4,16.84,1.5,37.9,0.01,9,0.67,2.11,4,5,4,3,4,0
1,0,0,1,1,1,0,0,0,0,0,1,0,0,0,1,0,1,0,0
1,0,0,1,1,1,4,16.84,1.5,37.9,0.01,9,0.67,2.11,4,5,4,3,4,0
1,0,0,1,1,1,0,0,0,0,0,1,0,0,0,1,0,1,0,0
1,0,0,1,1,1,4,16.84,1.5,37.9,0.01,9,0.67,2.11,4,5,4,3,4,0
1,0,0,1,1,1,0,0,0,0,0,1,0,0,0,1,0,1,0,0
1,0,0,1,1,1,8,58.17,1.64,155.76,0.03,25,0.61,8.65,12,13,11,3,8,0
1,0,0,1,1,1,0,0,0,0,0,1,0,0,0,1,0,1,0,0
1,0,0,1,1,1,8,58.17,1.64,155.76,0.03,25,0.61,8.65,12,13,11,3,8,0
3,0,1,2,1,1,2,12.09,6.3,479.73,0.03,20,0.16,26.65,7,13,5,9,2,0
1,0,0,1,1,1,2,5.33,1.5,12,0,4,0.67,0.67,1,3,1,3,2,0
1,0,0,1,1,1,2,5.33,1.5,12,0,4,0.67,0.67,1,3,1,3,2,0
1,0,0,1,1,1,2,5.33,1.5,12,0,4,0.67,0.67,1,3,1,3,2,0
1,0,0,1,1,1,2,5.33,1.5,12,0,4,0.67,0.67,1,3,1,3,2,0
1,0,0,1,1,1,2,5.33,1.5,12,0,4,0.67,0.67,1,3,1,3,2,0
1,0,0,1,1,1,2,5.33,1.5,12,0,4,0.67,0.67,1,3,1,3,2,0
1,0,0,1,1,1,2,5.33,1.5,12,0,4,0.67,0.67,1,3,1,3,2,0
1,0,0,1,1,1,2,5.33,1.5,12,0,4,0.67,0.67,1,3,1,3,2,0
1,0,0,1,1,1,2,5.33,1.5,12,0,4,0.67,0.67,1,3,1,3,2,0
1,0,0,1,1,1,2,0,0,0,0,4,0,0,0,4,0,4,2,0
1,0,0,1,1,1,1,0,0,0,0,1,0,0,0,1,0,1,1,0
1,0,0,1,1,1,2,0,0,0,0,5,0,0,0,5,0,5,2,0
11,1,4,6,1,1,21,13.86,22.5,7014.99,0.1,68,0.04,389.72,27,41,9,15,22,0
1,0,0,1,1,1,1,0,0,0,0,0,0,0,0,0,0,0,1,0
1,0,0,1,1,1,1,0,0,0,0,1,0,0,0,1,0,1,1,0
1,0,0,1,1,1,2,5.33,1.5,12,0,4,0.67,0.67,1,3,1,3,2,0
1,0,0,1,1,1,2,5.33,1.5,12,0,4,0.67,0.67,1,3,1,3,2,0
1,9,0,1,1,1,2,0,0,0,0,9,0,0,9,0,1,0,11,0
1,0,0,1,1,1,1,0,0,0,0,0,0,0,0,0,0,0,1,0
1,0,0,1,1,1,1,0,0,0,0,0,0,0,0,0,0,0,1,0
1,0,0,1,1,1,1,0,0,0,0,1,0,0,0,1,0,1,1,0
1,0,0,1,1,1,4,18.49,2.4,106.51,0.01,14,0.42,5.92,6,8,5,4,4,0
1,0,0,1,1,1,2,5.33,1.5,12,0,4,0.67,0.67,1,3,1,3,2,0
1,0,0,1,1,1,5,8.45,0.75,4.75,0,4,1.33,0.26,3,1,2,1,5,0
1,0,0,1,1,1,1,0,0,0,0,0,0,0,0,0,0,0,1,0
1,0,0,1,1,1,1,0,0,0,0,1,0,0,0,1,0,1,1,0
1,0,0,1,1,1,3,10.8,2.5,67.5,0.01,9,0.4,3.75,3,6,3,5,3,0
1,0,0,1,1,1,2,5.33,1.5,12,0,4,0.67,0.67,1,3,1,3,2,0
1,0,0,1,1,1,2,6.2,2.5,38.77,0.01,6,0.4,2.15,1,5,1,5,2,0
1,0,0,1,1,1,4,9.51,0.5,2.38,0,3,2,0.13,2,1,2,1,4,0
1,0,0,1,1,1,1,0,0,0,0,1,0,0,0,1,0,1,1,0
1,0,0,1,1,1,2,5.33,1.5,12,0,4,0.67,0.67,1,3,1,3,2,0
1,0,0,1,1,1,2,5.33,1.5,12,0,4,0.67,0.67,1,3,1,3,2,0
1,0,0,1,1,1,2,0,0,0,0,4,0,0,0,4,0,4,2,0
1,0,0,1,1,1,1,0,0,0,0,1,0,0,0,1,0,1,1,0
1,0,0,1,1,1,2,0,0,0,0,5,0,0,0,5,0,5,2,0
1,0,0,1,1,1,1,0,0,0,0,1,0,0,0,1,0,1,1,0
1,0,0,1,1,1,2,5.33,1.5,12,0,4,0.67,0.67,1,3,1,3,2,0
1,0,0,1,1,1,2,5.33,1.5,12,0,4,0.67,0.67,1,3,1,3,2,0
1,0,0,1,1,1,1,0,0,0,0,1,0,0,0,1,0,1,1,0
1,0,0,1,1,1,1,0,0,0,0,1,0,0,0,1,0,1,1,0
1,0,0,1,1,1,1,0,0,0,0,1,0,0,0,1,0,1,1,0
1,0,0,1,1,1,1,0,0,0,0,1,0,0,0,1,0,1,1,0
1,0,0,1,1,1,1,0,0,0,0,1,0,0,0,1,0,1,1,0
1,0,0,1,1,1,0,0,0,0,0,1,0,0,0,1,0,1,0,0
1,0,0,1,1,1,2,0,0,0,0,3,0,0,0,3,0,3,2,0
1,0,0,1,1,1,2,0,0,0,0,3,0,0,0,3,0,3,2,0
1,0,0,1,1,1,2,0,0,0,0,3,0,0,0,3,0,3,2,0
1,0,0,1,1,1,2,0,0,0,0,3,0,0,0,3,0,3,2,0
1,0,0,1,1,1,2,0,0,0,0,3,0,0,0,3,0,3,2,0
1,0,0,1,1,1,2,0,0,0,0,3,0,0,0,3,0,3,2,0
1,0,0,1,1,1,2,0,0,0,0,3,0,0,0,3,0,3,2,0
1,0,0,1,1,1,2,0,0,0,0,3,0,0,0,3,0,3,2,0
1,0,0,1,1,1,2,0,0,0,0,3,0,0,0,3,0,3,2,0
1,0,0,1,1,1,2,0,0,0,0,3,0,0,0,3,0,3,2,0
1,0,0,1,1,1,2,0,0,0,0,3,0,0,0,3,0,3,2,0
1,0,0,1,1,1,3,11.63,2,46.53,0.01,9,0.5,2.58,4,5,3,3,3,0
1,0,0,1,1,1,0,5.33,1.5,12,0,4,0.67,0.67,1,3,1,3,0,0
1,0,0,1,1,1,0,5.33,1.5,12,0,4,0.67,0.67,1,3,1,3,0,0
1,0,0,1,1,1,0,5.33,1.5,12,0,4,0.67,0.67,1,3,1,3,0,0
1,0,0,1,1,1,2,0,0,0,0,3,0,0,0,3,0,3,2,0
1,0,0,1,1,1,2,5.33,1.5,12,0,4,0.67,0.67,1,3,1,3,2,0
1,0,0,1,1,1,2,0,0,0,0,3,0,0,0,3,0,3,2,0
1,0,0,1,1,1,2,0,0,0,0,3,0,0,0,3,0,3,2,0
1,0,0,1,1,1,2,0,0,0,0,3,0,0,0,3,0,3,2,0
1,0,0,1,1,1,2,0,0,0,0,3,0,0,0,3,0,3,2,0
1,0,0,1,1,1,2,0,0,0,0,3,0,0,0,3,0,3,2,0
1,0,0,1,1,1,2,0,0,0,0,3,0,0,0,3,0,3,2,0
1,0,0,1,1,1,2,0,0,0,0,3,0,0,0,3,0,3,2,0
1,0,0,1,1,1,2,0,0,0,0,3,0,0,0,3,0,3,2,0
1,0,0,1,1,1,2,0,0,0,0,3,0,0,0,3,0,3,2,0
1,0,0,1,1,1,2,0,0,0,0,3,0,0,0,3,0,3,2,0
1,0,0,1,1,1,2,0,0,0,0,3,0,0,0,3,0,3,2,0
1,0,0,1,1,1,0,7.74,1.5,17.41,0,5,0.67,0.97,2,3,2,3,0,0
1,0,0,1,1,1,0,7.74,1.5,17.41,0,5,0.67,0.97,2,3,2,3,0,0
1,0,0,1,1,1,0,0,0,0,0,3,0,0,0,3,0,3,0,0
1,0,0,1,1,1,0,5.33,1.5,12,0,4,0.67,0.67,1,3,1,3,0,0
1,0,0,1,1,1,2,0,0,0,0,3,0,0,0,3,0,3,2,0
1,0,0,1,1,1,2,0,0,0,0,3,0,0,0,3,0,3,2,0
1,0,0,1,1,1,2,0,0,0,0,3,0,0,0,3,0,3,2,0
1,0,0,1,1,1,2,0,0,0,0,3,0,0,0,3,0,3,2,0
1,0,0,1,1,1,2,0,0,0,0,3,0,0,0,3,0,3,2,0
1,0,0,1,1,1,2,0,0,0,0,3,0,0,0,3,0,3,2,0
1,0,0,1,1,1,2,0,0,0,0,3,0,0,0,3,0,3,2,0
1,0,0,1,1,1,2,0,0,0,0,3,0,0,0,3,0,3,2,0
1,0,0,1,1,1,2,0,0,0,0,3,0,0,0,3,0,3,2,0
1,0,0,1,1,1,2,0,0,0,0,3,0,0,0,3,0,3,2,0
1,0,0,1,1,1,2,0,0,0,0,3,0,0,0,3,0,3,2,0
1,0,0,1,1,1,0,0,0,0,0,1,0,0,0,1,0,1,0,0
1,2,25,1,1,1,19,60.37,9.43,5366.74,0.19,116,0.11,298.15,44,72,21,9,21,0
1,2,25,1,1,1,12,39.26,8.24,2662.74,0.11,68,0.12,147.93,28,40,17,10,14,0
1,2,25,1,1,1,15,43.27,8.89,3418.56,0.13,80,0.11,189.92,32,48,18,10,17,0
1,2,25,1,1,1,13,39.26,8.24,2662.74,0.11,68,0.12,147.93,28,40,17,10,15,0
1,2,25,1,1,1,19,60.37,9.43,5366.74,0.19,116,0.11,298.15,44,72,21,9,21,0
1,2,25,1,1,1,15,39.26,8.24,2662.74,0.11,68,0.12,147.93,28,40,17,10,17,0
1,2,25,1,1,1,13,39.26,8.24,2662.74,0.11,68,0.12,147.93,28,40,17,10,15,0
1,2,25,1,1,1,13,39.26,8.24,2662.74,0.11,68,0.12,147.93,28,40,17,10,15,0
1,2,25,1,1,1,19,60.37,9.43,5366.74,0.19,116,0.11,298.15,44,72,21,9,21,0
1,2,25,1,1,1,13,39.26,8.24,2662.74,0.11,68,0.12,147.93,28,40,17,10,15,0
1,2,25,1,1,1,14,39.26,8.24,2662.74,0.11,68,0.12,147.93,28,40,17,10,16,0
1,2,25,1,1,1,13,39.26,8.24,2662.74,0.11,68,0.12,147.93,28,40,17,10,15,0
9,2,41,5,1,1,20,47.89,12,6896.24,0.19,116,0.08,383.12,38,78,19,12,22,0
17,2,49,9,1,1,29,64.95,14.61,13862.44,0.32,185,0.07,770.14,56,129,23,12,31,0
1,2,25,1,1,1,8,33.62,6,1210.43,0.07,44,0.17,67.25,20,24,15,9,10,0
1,2,25,1,1,1,10,38.53,6.75,1755.38,0.09,56,0.15,97.52,24,32,16,9,12,0
1,2,25,1,1,1,10,38.53,6.75,1755.38,0.09,56,0.15,97.52,24,32,16,9,12,0
1,2,25,1,1,1,10,38.53,6.75,1755.38,0.09,56,0.15,97.52,24,32,16,9,12,0
13,5,26,7,1,7,12,16.12,17,4658.33,0.09,57,0.06,258.8,22,35,11,17,17,0
1,2,25,1,1,1,7,33.62,6,1210.43,0.07,44,0.17,67.25,20,24,15,9,9,0
1,2,25,1,1,1,7,33.62,6,1210.43,0.07,44,0.17,67.25,20,24,15,9,9,0
1,2,25,1,1,1,7,33.62,6,1210.43,0.07,44,0.17,67.25,20,24,15,9,9,0
1,2,25,1,1,1,7,33.62,6,1210.43,0.07,44,0.17,67.25,20,24,15,9,9,0
1,2,25,1,1,1,7,33.62,6,1210.43,0.07,44,0.17,67.25,20,24,15,9,9,0
1,2,25,1,1,1,7,33.62,6,1210.43,0.07,44,0.17,67.25,20,24,15,9,9,0
1,2,25,1,1,1,7,33.62,6,1210.43,0.07,44,0.17,67.25,20,24,15,9,9,0
1,2,25,1,1,1,7,33.62,6,1210.43,0.07,44,0.17,67.25,20,24,15,9,9,0
1,2,25,1,1,1,7,33.62,6,1210.43,0.07,44,0.17,67.25,20,24,15,9,9,0
25,8,28,13,13,1,209,261.25,20.54,110258.11,1.79,937,0.05,6125.45,270,667,46,7,217,0
1,0,145,1,1,1,965,702.5,85.39,5122733.98,20,8612,0.01,284596.29,2879,5733,118,7,965,0
7,2,33,4,4,1,38,67.96,15.03,15354.19,0.34,186,0.07,853.01,74,112,32,13,40,0
7,2,33,4,4,1,32,61.47,14.3,12570.48,0.29,162,0.07,698.36,66,96,30,13,34,0
7,2,33,4,4,1,30,55.71,13.46,10098.99,0.25,140,0.07,561.05,58,82,28,13,32,0
5,0,9,3,1,1,16,30.86,6.22,1194.67,0.06,48,0.16,66.37,16,32,9,7,16,0
1,2,25,1,1,1,22,64.59,9.82,6226.07,0.21,128,0.1,345.89,48,80,22,9,24,0
1,2,25,1,1,1,22,64.59,9.82,6226.07,0.21,128,0.1,345.89,48,80,22,9,24,0
1,2,25,1,1,1,22,64.59,9.82,6226.07,0.21,128,0.1,345.89,48,80,22,9,24,0
1,2,25,1,1,1,33,90.04,11.57,12056.16,0.35,200,0.09,669.79,72,128,28,9,35,0
1,2,25,1,1,1,33,90.04,11.57,12056.16,0.35,200,0.09,669.79,72,128,28,9,35,0
1,2,25,1,1,1,34,90.04,11.57,12056.16,0.35,200,0.09,669.79,72,128,28,9,36,0
9,2,41,5,1,1,18,47.89,12,6896.24,0.19,116,0.08,383.12,38,78,19,12,20,0
1,2,25,1,1,1,8,33.62,6,1210.43,0.07,44,0.17,67.25,20,24,15,9,10,0
5,2,37,3,1,1,13,37.97,10.24,3977.83,0.13,80,0.1,220.99,29,51,17,12,15,0
1,2,25,1,1,1,21,56.14,9,4547.07,0.17,104,0.11,252.62,40,64,20,9,23,0
1,2,25,1,1,1,18,47.18,9.47,4234.11,0.15,92,0.11,235.23,36,56,19,10,20,0
1,2,25,1,1,1,14,43.12,7.41,2369.02,0.11,68,0.13,131.61,28,40,17,9,16,0
7,1,3,4,4,1,16,39.86,8.17,2658.56,0.11,73,0.12,147.7,35,38,15,7,17,0
1,0,3,1,1,1,9,33.75,9.6,3110.4,0.11,81,0.1,172.8,32,49,10,6,9,0
3,1,1,2,2,1,6,18.6,5.25,512.78,0.03,25,0.19,28.49,12,13,8,7,7,0
1,0,0,1,1,1,2,5.33,1.5,12,0,4,0.67,0.67,1,3,1,3,2,0
1,0,0,1,1,1,2,5.33,1.5,12,0,4,0.67,0.67,1,3,1,3,2,0
1,0,0,1,1,1,2,5.33,1.5,12,0,4,0.67,0.67,1,3,1,3,2,0
1,0,0,1,1,1,2,5.33,1.5,12,0,4,0.67,0.67,1,3,1,3,2,0
1,0,0,1,1,1,2,5.33,1.5,12,0,4,0.67,0.67,1,3,1,3,2,0
1,0,0,1,1,1,2,5.33,1.5,12,0,4,0.67,0.67,1,3,1,3,2,0
1,0,0,1,1,1,2,5.33,1.5,12,0,4,0.67,0.67,1,3,1,3,2,0
1,0,0,1,1,1,1,0,0,0,0,0,0,0,0,0,0,0,1,0
1,0,0,1,1,1,1,0,0,0,0,1,0,0,0,1,0,1,1,0
1,0,0,1,1,1,2,5.33,1.5,12,0,4,0.67,0.67,1,3,1,3,2,0
1,0,0,1,1,1,2,5.33,1.5,12,0,4,0.67,0.67,1,3,1,3,2,0
1,9,0,1,1,1,2,0,0,0,0,9,0,0,9,0,1,0,11,0
1,0,0,1,1,1,1,0,0,0,0,0,0,0,0,0,0,0,1,0
1,0,0,1,1,1,1,0,0,0,0,0,0,0,0,0,0,0,1,0
1,0,0,1,1,1,1,0,0,0,0,1,0,0,0,1,0,1,1,0
1,0,0,1,1,1,4,18.49,2.4,106.51,0.01,14,0.42,5.92,6,8,5,4,4,0
1,0,0,1,1,1,2,5.33,1.5,12,0,4,0.67,0.67,1,3,1,3,2,0
1,0,0,1,1,1,5,8.45,0.75,4.75,0,4,1.33,0.26,3,1,2,1,5,0
1,0,0,1,1,1,1,0,0,0,0,0,0,0,0,0,0,0,1,0
1,0,0,1,1,1,1,0,0,0,0,1,0,0,0,1,0,1,1,0
1,0,0,1,1,1,3,10.8,2.5,67.5,0.01,9,0.4,3.75,3,6,3,5,3,0
1,0,0,1,1,1,2,5.33,1.5,12,0,4,0.67,0.67,1,3,1,3,2,0
1,0,0,1,1,1,2,6.2,2.5,38.77,0.01,6,0.4,2.15,1,5,1,5,2,0
1,0,0,1,1,1,4,9.51,0.5,2.38,0,3,2,0.13,2,1,2,1,4,0
1,0,0,1,1,1,1,0,0,0,0,1,0,0,0,1,0,1,1,0
1,0,0,1,1,1,1,0,0,0,0,1,0,0,0,1,0,1,1,0
1,0,0,1,1,1,1,0,0,0,0,1,0,0,0,1,0,1,1,0
1,0,0,1,1,1,1,0,0,0,0,1,0,0,0,1,0,1,1,0
1,0,0,1,1,1,1,0,0,0,0,1,0,0,0,1,0,1,1,0
1,0,0,1,1,1,1,0,0,0,0,1,0,0,0,1,0,1,1,0
1,0,0,1,1,1,1,0,0,0,0,1,0,0,0,1,0,1,1,0
1,0,0,1,1,1,0,0,0,0,0,1,0,0,0,1,0,1,0,0
1,0,0,1,1,1,2,0,0,0,0,3,0,0,0,3,0,3,2,0
1,0,0,1,1,1,2,0,0,0,0,3,0,0,0,3,0,3,2,0
1,0,0,1,1,1,2,0,0,0,0,3,0,0,0,3,0,3,2,0
1,0,0,1,1,1,2,0,0,0,0,3,0,0,0,3,0,3,2,0
1,0,0,1,1,1,2,0,0,0,0,3,0,0,0,3,0,3,2,0
1,0,0,1,1,1,2,0,0,0,0,3,0,0,0,3,0,3,2,0
1,0,0,1,1,1,2,0,0,0,0,3,0,0,0,3,0,3,2,0
1,0,0,1,1,1,2,0,0,0,0,3,0,0,0,3,0,3,2,0
1,0,0,1,1,1,2,0,0,0,0,3,0,0,0,3,0,3,2,0
1,0,0,1,1,1,2,0,0,0,0,3,0,0,0,3,0,3,2,0
1,0,0,1,1,1,2,0,0,0,0,3,0,0,0,3,0,3,2,0
1,0,0,1,1,1,3,11.63,2,46.53,0.01,9,0.5,2.58,4,5,3,3,3,0
1,0,0,1,1,1,0,5.33,1.5,12,0,4,0.67,0.67,1,3,1,3,0,0
1,0,0,1,1,1,0,5.33,1.5,12,0,4,0.67,0.67,1,3,1,3,0,0
1,0,0,1,1,1,0,5.33,1.5,12,0,4,0.67,0.67,1,3,1,3,0,0
1,0,0,1,1,1,2,0,0,0,0,3,0,0,0,3,0,3,2,0
1,0,0,1,1,1,2,5.33,1.5,12,0,4,0.67,0.67,1,3,1,3,2,0
1,0,0,1,1,1,2,0,0,0,0,3,0,0,0,3,0,3,2,0
1,0,0,1,1,1,2,0,0,0,0,3,0,0,0,3,0,3,2,0
1,0,0,1,1,1,2,0,0,0,0,3,0,0,0,3,0,3,2,0
1,0,0,1,1,1,2,0,0,0,0,3,0,0,0,3,0,3,2,0
1,0,0,1,1,1,2,0,0,0,0,3,0,0,0,3,0,3,2,0
1,0,0,1,1,1,2,0,0,0,0,3,0,0,0,3,0,3,2,0
1,0,0,1,1,1,2,0,0,0,0,3,0,0,0,3,0,3,2,0
1,0,0,1,1,1,2,0,0,0,0,3,0,0,0,3,0,3,2,0
1,0,0,1,1,1,2,0,0,0,0,3,0,0,0,3,0,3,2,0
1,0,0,1,1,1,2,0,0,0,0,3,0,0,0,3,0,3,2,0
1,0,0,1,1,1,2,0,0,0,0,3,0,0,0,3,0,3,2,0
1,0,0,1,1,1,0,7.74,1.5,17.41,0,5,0.67,0.97,2,3,2,3,0,0
1,0,0,1,1,1,0,7.74,1.5,17.41,0,5,0.67,0.97,2,3,2,3,0,0
1,0,0,1,1,1,0,0,0,0,0,3,0,0,0,3,0,3,0,0
1,0,0,1,1,1,0,5.33,1.5,12,0,4,0.67,0.67,1,3,1,3,0,0
1,0,0,1,1,1,2,0,0,0,0,3,0,0,0,3,0,3,2,0
1,0,0,1,1,1,2,0,0,0,0,3,0,0,0,3,0,3,2,0
1,0,0,1,1,1,2,0,0,0,0,3,0,0,0,3,0,3,2,0
1,0,0,1,1,1,2,0,0,0,0,3,0,0,0,3,0,3,2,0
1,0,0,1,1,1,2,0,0,0,0,3,0,0,0,3,0,3,2,0
1,0,0,1,1,1,2,0,0,0,0,3,0,0,0,3,0,3,2,0
1,0,0,1,1,1,2,0,0,0,0,3,0,0,0,3,0,3,2,0
1,0,0,1,1,1,2,0,0,0,0,3,0,0,0,3,0,3,2,0
1,0,0,1,1,1,2,0,0,0,0,3,0,0,0,3,0,3,2,0
1,0,0,1,1,1,2,0,0,0,0,3,0,0,0,3,0,3,2,0
1,0,0,1,1,1,2,0,0,0,0,3,0,0,0,3,0,3,2,0
5,0,5,3,1,1,7,13.32,13.71,2505.06,0.06,43,0.07,139.17,16,27,7,12,7,0
5,0,5,3,1,1,7,13.32,13.71,2505.06,0.06,43,0.07,139.17,16,27,7,12,7,0
1,0,0,1,1,1,1,0,0,0,0,1,0,0,0,1,0,1,1,0
29,2,109,15,7,1,135,65.71,58.84,227518.97,1.29,700,0.02,12639.94,269,431,32,14,137,0
7,2,39,4,3,1,36,26.59,41,44690,0.36,218,0.02,2482.78,82,136,16,16,38,0
3,1,23,2,2,1,19,18.93,25.2,12024.41,0.16,107,0.04,668.02,42,65,10,12,20,0
3,1,24,2,2,1,19,21.52,22.91,11295.75,0.16,109,0.04,627.54,42,67,11,12,20,0
1,0,2,1,1,1,39,74.43,12.73,12056.63,0.32,195,0.08,669.81,80,115,22,7,39,1
17,5,9,9,9,1,43,56.82,14.87,12564.22,0.28,161,0.07,698.01,73,88,27,11,48,0
17,5,9,9,9,1,43,56.82,14.87,12564.22,0.28,161,0.07,698.01,73,88,27,11,48,0
11,3,6,6,6,1,29,42.16,12.57,6662.86,0.18,106,0.08,370.16,48,58,21,11,32,0
11,3,6,6,6,1,29,42.16,12.57,6662.86,0.18,106,0.08,370.16,48,58,21,11,32,0
11,0,11,6,1,1,30,54.23,22.48,27402.38,0.41,234,0.04,1522.35,83,151,24,13,30,0
193,65,901,97,76,20,1672,944.7,105.51,10517129.91,33.23,11394,0.01,584284.97,4326,7068,410,20,1737,1
9,2,1,8,1,1,27,34.09,9.88,3329.22,0.11,68,0.1,184.96,24,44,17,14,29,0
3,0,1,2,1,1,2,12.09,6.3,479.73,0.03,20,0.16,26.65,7,13,5,9,2,0
1,0,0,1,1,1,2,5.33,1.5,12,0,4,0.67,0.67,1,3,1,3,2,0
1,0,0,1,1,1,2,5.33,1.5,12,0,4,0.67,0.67,1,3,1,3,2,0
1,0,0,1,1,1,2,5.33,1.5,12,0,4,0.67,0.67,1,3,1,3,2,0
1,0,0,1,1,1,2,5.33,1.5,12,0,4,0.67,0.67,1,3,1,3,2,0
1,0,0,1,1,1,2,5.33,1.5,12,0,4,0.67,0.67,1,3,1,3,2,0
1,0,0,1,1,1,2,5.33,1.5,12,0,4,0.67,0.67,1,3,1,3,2,0
1,0,0,1,1,1,2,5.33,1.5,12,0,4,0.67,0.67,1,3,1,3,2,0
1,0,0,1,1,1,2,5.33,1.5,12,0,4,0.67,0.67,1,3,1,3,2,0
1,0,0,1,1,1,2,5.33,1.5,12,0,4,0.67,0.67,1,3,1,3,2,0
1,0,0,1,1,1,2,0,0,0,0,4,0,0,0,4,0,4,2,0
1,0,0,1,1,1,1,0,0,0,0,1,0,0,0,1,0,1,1,0
1,0,0,1,1,1,2,0,0,0,0,5,0,0,0,5,0,5,2,0
11,1,4,6,1,1,21,13.86,22.5,7014.99,0.1,68,0.04,389.72,27,41,9,15,22,0
1,0,0,1,1,1,1,0,0,0,0,0,0,0,0,0,0,0,1,0
1,0,0,1,1,1,1,0,0,0,0,1,0,0,0,1,0,1,1,0
1,0,0,1,1,1,2,5.33,1.5,12,0,4,0.67,0.67,1,3,1,3,2,0
1,0,0,1,1,1,2,5.33,1.5,12,0,4,0.67,0.67,1,3,1,3,2,0
1,9,0,1,1,1,2,0,0,0,0,9,0,0,9,0,1,0,11,0
1,0,0,1,1,1,1,0,0,0,0,0,0,0,0,0,0,0,1,0
1,0,0,1,1,1,1,0,0,0,0,0,0,0,0,0,0,0,1,0
1,0,0,1,1,1,1,0,0,0,0,1,0,0,0,1,0,1,1,0
1,0,0,1,1,1,4,18.49,2.4,106.51,0.01,14,0.42,5.92,6,8,5,4,4,0
1,0,0,1,1,1,2,5.33,1.5,12,0,4,0.67,0.67,1,3,1,3,2,0
1,0,0,1,1,1,5,8.45,0.75,4.75,0,4,1.33,0.26,3,1,2,1,5,0
1,0,0,1,1,1,1,0,0,0,0,0,0,0,0,0,0,0,1,0
1,0,0,1,1,1,1,0,0,0,0,1,0,0,0,1,0,1,1,0
1,0,0,1,1,1,3,10.8,2.5,67.5,0.01,9,0.4,3.75,3,6,3,5,3,0
1,0,0,1,1,1,2,5.33,1.5,12,0,4,0.67,0.67,1,3,1,3,2,0
1,0,0,1,1,1,2,6.2,2.5,38.77,0.01,6,0.4,2.15,1,5,1,5,2,0
1,0,0,1,1,1,4,9.51,0.5,2.38,0,3,2,0.13,2,1,2,1,4,0
1,0,0,1,1,1,1,0,0,0,0,1,0,0,0,1,0,1,1,0
1,0,0,1,1,1,2,5.33,1.5,12,0,4,0.67,0.67,1,3,1,3,2,0
1,0,0,1,1,1,2,5.33,1.5,12,0,4,0.67,0.67,1,3,1,3,2,0
1,0,0,1,1,1,2,0,0,0,0,4,0,0,0,4,0,4,2,0
1,0,0,1,1,1,1,0,0,0,0,1,0,0,0,1,0,1,1,0
1,0,0,1,1,1,2,0,0,0,0,5,0,0,0,5,0,5,2,0
1,0,0,1,1,1,1,0,0,0,0,1,0,0,0,1,0,1,1,0
1,0,0,1,1,1,2,5.33,1.5,12,0,4,0.67,0.67,1,3,1,3,2,0
1,0,0,1,1,1,2,5.33,1.5,12,0,4,0.67,0.67,1,3,1,3,2,0
1,0,0,1,1,1,1,0,0,0,0,1,0,0,0,1,0,1,1,0
1,0,0,1,1,1,1,0,0,0,0,1,0,0,0,1,0,1,1,0
1,0,0,1,1,1,1,0,0,0,0,1,0,0,0,1,0,1,1,0
1,0,0,1,1,1,1,0,0,0,0,1,0,0,0,1,0,1,1,0
1,0,0,1,1,1,1,0,0,0,0,1,0,0,0,1,0,1,1,0
1,0,0,1,1,1,1,0,0,0,0,1,0,0,0,1,0,1,1,0
1,0,0,1,1,1,1,0,0,0,0,1,0,0,0,1,0,1,1,0
1,0,0,1,1,1,0,0,0,0,0,1,0,0,0,1,0,1,0,0
1,0,0,1,1,1,2,0,0,0,0,3,0,0,0,3,0,3,2,0
1,0,0,1,1,1,2,0,0,0,0,3,0,0,0,3,0,3,2,0
1,0,0,1,1,1,2,0,0,0,0,3,0,0,0,3,0,3,2,0
1,0,0,1,1,1,2,0,0,0,0,3,0,0,0,3,0,3,2,0
1,0,0,1,1,1,2,0,0,0,0,3,0,0,0,3,0,3,2,0
1,0,0,1,1,1,2,0,0,0,0,3,0,0,0,3,0,3,2,0
1,0,0,1,1,1,2,0,0,0,0,3,0,0,0,3,0,3,2,0
1,0,0,1,1,1,2,0,0,0,0,3,0,0,0,3,0,3,2,0
1,0,0,1,1,1,2,0,0,0,0,3,0,0,0,3,0,3,2,0
1,0,0,1,1,1,2,0,0,0,0,3,0,0,0,3,0,3,2,0
1,0,0,1,1,1,2,0,0,0,0,3,0,0,0,3,0,3,2,0
1,0,0,1,1,1,3,11.63,2,46.53,0.01,9,0.5,2.58,4,5,3,3,3,0
1,0,0,1,1,1,0,5.33,1.5,12,0,4,0.67,0.67,1,3,1,3,0,0
1,0,0,1,1,1,0,5.33,1.5,12,0,4,0.67,0.67,1,3,1,3,0,0
1,0,0,1,1,1,0,5.33,1.5,12,0,4,0.67,0.67,1,3,1,3,0,0
1,0,0,1,1,1,2,0,0,0,0,3,0,0,0,3,0,3,2,0
1,0,0,1,1,1,2,5.33,1.5,12,0,4,0.67,0.67,1,3,1,3,2,0
1,0,0,1,1,1,2,0,0,0,0,3,0,0,0,3,0,3,2,0
1,0,0,1,1,1,2,0,0,0,0,3,0,0,0,3,0,3,2,0
1,0,0,1,1,1,2,0,0,0,0,3,0,0,0,3,0,3,2,0
1,0,0,1,1,1,2,0,0,0,0,3,0,0,0,3,0,3,2,0
1,0,0,1,1,1,2,0,0,0,0,3,0,0,0,3,0,3,2,0
1,0,0,1,1,1,2,0,0,0,0,3,0,0,0,3,0,3,2,0
1,0,0,1,1,1,2,0,0,0,0,3,0,0,0,3,0,3,2,0
1,0,0,1,1,1,2,0,0,0,0,3,0,0,0,3,0,3,2,0
1,0,0,1,1,1,2,0,0,0,0,3,0,0,0,3,0,3,2,0
1,0,0,1,1,1,2,0,0,0,0,3,0,0,0,3,0,3,2,0
1,0,0,1,1,1,2,0,0,0,0,3,0,0,0,3,0,3,2,0
1,0,0,1,1,1,0,7.74,1.5,17.41,0,5,0.67,0.97,2,3,2,3,0,0
1,0,0,1,1,1,0,7.74,1.5,17.41,0,5,0.67,0.97,2,3,2,3,0,0
1,0,0,1,1,1,0,0,0,0,0,3,0,0,0,3,0,3,0,0
1,0,0,1,1,1,0,5.33,1.5,12,0,4,0.67,0.67,1,3,1,3,0,0
1,0,0,1,1,1,2,0,0,0,0,3,0,0,0,3,0,3,2,0
1,0,0,1,1,1,2,0,0,0,0,3,0,0,0,3,0,3,2,0
1,0,0,1,1,1,2,0,0,0,0,3,0,0,0,3,0,3,2,0
1,0,0,1,1,1,2,0,0,0,0,3,0,0,0,3,0,3,2,0
1,0,0,1,1,1,2,0,0,0,0,3,0,0,0,3,0,3,2,0
1,0,0,1,1,1,2,0,0,0,0,3,0,0,0,3,0,3,2,0
1,0,0,1,1,1,2,0,0,0,0,3,0,0,0,3,0,3,2,0
1,0,0,1,1,1,2,0,0,0,0,3,0,0,0,3,0,3,2,0
1,0,0,1,1,1,2,0,0,0,0,3,0,0,0,3,0,3,2,0
1,0,0,1,1,1,2,0,0,0,0,3,0,0,0,3,0,3,2,0
1,0,0,1,1,1,2,0,0,0,0,3,0,0,0,3,0,3,2,0
5,0,5,3,1,1,7,13.32,13.71,2505.06,0.06,43,0.07,139.17,16,27,7,12,7,0
5,0,5,3,1,1,7,13.32,13.71,2505.06,0.06,43,0.07,139.17,16,27,7,12,7,0
1,0,0,1,1,1,1,0,0,0,0,1,0,0,0,1,0,1,1,0
3,0,4,2,2,1,9,21.35,6.25,833.99,0.04,32,0.16,46.33,10,22,8,10,9,0
3,0,4,2,2,1,18,26.72,9.82,2575.96,0.09,58,0.1,143.11,18,40,11,12,18,0
1,0,0,1,1,1,3,0,0,0,0,1,0,0,0,1,0,1,3,0
1,0,2,1,1,1,8,28.46,7,1394.76,0.07,51,0.14,77.49,16,35,8,7,8,0
53,2,173,27,18,10,530,408.25,53.41,1164427.09,7.27,2901,0.02,64690.39,1043,1858,166,17,532,1
1,0,0,1,1,1,1,0,0,0,0,1,0,0,0,1,0,1,1,0
9,2,1,8,1,1,27,34.09,9.88,3329.22,0.11,68,0.1,184.96,24,44,17,14,29,0
3,0,1,2,1,1,2,12.09,6.3,479.73,0.03,20,0.16,26.65,7,13,5,9,2,0
1,0,0,1,1,1,2,5.33,1.5,12,0,4,0.67,0.67,1,3,1,3,2,0
1,0,0,1,1,1,2,5.33,1.5,12,0,4,0.67,0.67,1,3,1,3,2,0
1,0,0,1,1,1,2,5.33,1.5,12,0,4,0.67,0.67,1,3,1,3,2,0
1,0,0,1,1,1,2,5.33,1.5,12,0,4,0.67,0.67,1,3,1,3,2,0
1,0,0,1,1,1,2,5.33,1.5,12,0,4,0.67,0.67,1,3,1,3,2,0
1,0,0,1,1,1,2,5.33,1.5,12,0,4,0.67,0.67,1,3,1,3,2,0
1,0,0,1,1,1,2,5.33,1.5,12,0,4,0.67,0.67,1,3,1,3,2,0
1,0,0,1,1,1,2,5.33,1.5,12,0,4,0.67,0.67,1,3,1,3,2,0
1,0,0,1,1,1,2,5.33,1.5,12,0,4,0.67,0.67,1,3,1,3,2,0
1,0,0,1,1,1,2,0,0,0,0,4,0,0,0,4,0,4,2,0
1,0,0,1,1,1,1,0,0,0,0,1,0,0,0,1,0,1,1,0
1,0,0,1,1,1,2,0,0,0,0,5,0,0,0,5,0,5,2,0
11,1,4,6,1,1,21,13.86,22.5,7014.99,0.1,68,0.04,389.72,27,41,9,15,22,0
1,0,0,1,1,1,1,0,0,0,0,0,0,0,0,0,0,0,1,0
1,0,0,1,1,1,1,0,0,0,0,1,0,0,0,1,0,1,1,0
1,0,0,1,1,1,2,5.33,1.5,12,0,4,0.67,0.67,1,3,1,3,2,0
1,0,0,1,1,1,2,5.33,1.5,12,0,4,0.67,0.67,1,3,1,3,2,0
1,9,0,1,1,1,2,0,0,0,0,9,0,0,9,0,1,0,11,0
1,0,0,1,1,1,1,0,0,0,0,0,0,0,0,0,0,0,1,0
1,0,0,1,1,1,1,0,0,0,0,0,0,0,0,0,0,0,1,0
1,0,0,1,1,1,1,0,0,0,0,1,0,0,0,1,0,1,1,0
1,0,0,1,1,1,4,18.49,2.4,106.51,0.01,14,0.42,5.92,6,8,5,4,4,0
1,0,0,1,1,1,2,5.33,1.5,12,0,4,0.67,0.67,1,3,1,3,2,0
1,0,0,1,1,1,5,8.45,0.75,4.75,0,4,1.33,0.26,3,1,2,1,5,0
1,0,0,1,1,1,1,0,0,0,0,0,0,0,0,0,0,0,1,0
1,0,0,1,1,1,1,0,0,0,0,1,0,0,0,1,0,1,1,0
1,0,0,1,1,1,3,10.8,2.5,67.5,0.01,9,0.4,3.75,3,6,3,5,3,0
1,0,0,1,1,1,2,5.33,1.5,12,0,4,0.67,0.67,1,3,1,3,2,0
1,0,0,1,1,1,2,6.2,2.5,38.77,0.01,6,0.4,2.15,1,5,1,5,2,0
1,0,0,1,1,1,4,9.51,0.5,2.38,0,3,2,0.13,2,1,2,1,4,0
1,0,0,1,1,1,1,0,0,0,0,1,0,0,0,1,0,1,1,0
1,0,0,1,1,1,2,5.33,1.5,12,0,4,0.67,0.67,1,3,1,3,2,0
1,0,0,1,1,1,2,5.33,1.5,12,0,4,0.67,0.67,1,3,1,3,2,0
1,0,0,1,1,1,2,0,0,0,0,4,0,0,0,4,0,4,2,0
1,0,0,1,1,1,1,0,0,0,0,1,0,0,0,1,0,1,1,0
1,0,0,1,1,1,2,0,0,0,0,5,0,0,0,5,0,5,2,0
1,0,0,1,1,1,1,0,0,0,0,1,0,0,0,1,0,1,1,0
1,0,0,1,1,1,2,5.33,1.5,12,0,4,0.67,0.67,1,3,1,3,2,0
1,0,0,1,1,1,2,5.33,1.5,12,0,4,0.67,0.67,1,3,1,3,2,0
1,0,0,1,1,1,1,0,0,0,0,1,0,0,0,1,0,1,1,0
1,0,0,1,1,1,1,0,0,0,0,1,0,0,0,1,0,1,1,0
1,0,0,1,1,1,1,0,0,0,0,1,0,0,0,1,0,1,1,0
1,0,0,1,1,1,1,0,0,0,0,1,0,0,0,1,0,1,1,0
1,0,0,1,1,1,1,0,0,0,0,1,0,0,0,1,0,1,1,0
1,0,0,1,1,1,1,0,0,0,0,1,0,0,0,1,0,1,1,0
1,0,0,1,1,1,1,0,0,0,0,1,0,0,0,1,0,1,1,0
1,0,0,1,1,1,0,0,0,0,0,1,0,0,0,1,0,1,0,0
1,0,0,1,1,1,2,0,0,0,0,3,0,0,0,3,0,3,2,0
1,0,0,1,1,1,2,0,0,0,0,3,0,0,0,3,0,3,2,0
1,0,0,1,1,1,2,0,0,0,0,3,0,0,0,3,0,3,2,0
1,0,0,1,1,1,2,0,0,0,0,3,0,0,0,3,0,3,2,0
1,0,0,1,1,1,2,0,0,0,0,3,0,0,0,3,0,3,2,0
1,0,0,1,1,1,2,0,0,0,0,3,0,0,0,3,0,3,2,0
1,0,0,1,1,1,2,0,0,0,0,3,0,0,0,3,0,3,2,0
1,0,0,1,1,1,2,0,0,0,0,3,0,0,0,3,0,3,2,0
1,0,0,1,1,1,2,0,0,0,0,3,0,0,0,3,0,3,2,0
1,0,0,1,1,1,2,0,0,0,0,3,0,0,0,3,0,3,2,0
1,0,0,1,1,1,2,0,0,0,0,3,0,0,0,3,0,3,2,0
1,0,0,1,1,1,3,11.63,2,46.53,0.01,9,0.5,2.58,4,5,3,3,3,0
1,0,0,1,1,1,0,5.33,1.5,12,0,4,0.67,0.67,1,3,1,3,0,0
1,0,0,1,1,1,0,5.33,1.5,12,0,4,0.67,0.67,1,3,1,3,0,0
1,0,0,1,1,1,0,5.33,1.5,12,0,4,0.67,0.67,1,3,1,3,0,0
1,0,0,1,1,1,2,0,0,0,0,3,0,0,0,3,0,3,2,0
1,0,0,1,1,1,2,5.33,1.5,12,0,4,0.67,0.67,1,3,1,3,2,0
1,0,0,1,1,1,2,0,0,0,0,3,0,0,0,3,0,3,2,0
1,0,0,1,1,1,2,0,0,0,0,3,0,0,0,3,0,3,2,0
1,0,0,1,1,1,2,0,0,0,0,3,0,0,0,3,0,3,2,0
1,0,0,1,1,1,2,0,0,0,0,3,0,0,0,3,0,3,2,0
1,0,0,1,1,1,2,0,0,0,0,3,0,0,0,3,0,3,2,0
1,0,0,1,1,1,2,0,0,0,0,3,0,0,0,3,0,3,2,0
1,0,0,1,1,1,2,0,0,0,0,3,0,0,0,3,0,3,2,0
1,0,0,1,1,1,2,0,0,0,0,3,0,0,0,3,0,3,2,0
1,0,0,1,1,1,2,0,0,0,0,3,0,0,0,3,0,3,2,0
1,0,0,1,1,1,2,0,0,0,0,3,0,0,0,3,0,3,2,0
1,0,0,1,1,1,2,0,0,0,0,3,0,0,0,3,0,3,2,0
1,0,0,1,1,1,0,7.74,1.5,17.41,0,5,0.67,0.97,2,3,2,3,0,0
1,0,0,1,1,1,0,7.74,1.5,17.41,0,5,0.67,0.97,2,3,2,3,0,0
1,0,0,1,1,1,0,0,0,0,0,3,0,0,0,3,0,3,0,0
1,0,0,1,1,1,0,5.33,1.5,12,0,4,0.67,0.67,1,3,1,3,0,0
1,0,0,1,1,1,2,0,0,0,0,3,0,0,0,3,0,3,2,0
1,0,0,1,1,1,2,0,0,0,0,3,0,0,0,3,0,3,2,0
1,0,0,1,1,1,2,0,0,0,0,3,0,0,0,3,0,3,2,0
1,0,0,1,1,1,2,0,0,0,0,3,0,0,0,3,0,3,2,0
1,0,0,1,1,1,2,0,0,0,0,3,0,0,0,3,0,3,2,0
1,0,0,1,1,1,2,0,0,0,0,3,0,0,0,3,0,3,2,0
1,0,0,1,1,1,2,0,0,0,0,3,0,0,0,3,0,3,2,0
1,0,0,1,1,1,2,0,0,0,0,3,0,0,0,3,0,3,2,0
1,0,0,1,1,1,2,0,0,0,0,3,0,0,0,3,0,3,2,0
1,0,0,1,1,1,2,0,0,0,0,3,0,0,0,3,0,3,2,0
1,0,0,1,1,1,2,0,0,0,0,3,0,0,0,3,0,3,2,0
5,0,5,3,1,1,7,13.32,13.71,2505.06,0.06,43,0.07,139.17,16,27,7,12,7,0
5,0,5,3,1,1,7,13.32,13.71,2505.06,0.06,43,0.07,139.17,16,27,7,12,7,0
1,0,0,1,1,1,1,0,0,0,0,1,0,0,0,1,0,1,1,0
5,0,9,3,3,1,20,32.75,10.77,3799.79,0.12,78,0.09,211.1,28,50,13,10,20,0
5,0,6,3,3,1,32,31.44,14.77,6858.62,0.15,100,0.07,381.03,32,68,13,12,32,0
1,0,0,1,1,1,3,0,0,0,0,1,0,0,0,1,0,1,3,0
1,0,2,1,1,1,14,54.26,8.5,3920.14,0.15,105,0.12,217.79,34,71,14,7,14,0
67,5,190,34,22,10,594,454.21,53.23,1286957.35,8.06,3163,0.02,71497.63,1146,2017,183,17,599,0
1,0,0,1,1,1,1,0,0,0,0,1,0,0,0,1,0,1,1,0
9,2,1,8,1,1,27,34.09,9.88,3329.22,0.11,68,0.1,184.96,24,44,17,14,29,0
3,0,1,2,1,1,2,12.09,6.3,479.73,0.03,20,0.16,26.65,7,13,5,9,2,0
1,0,0,1,1,1,2,5.33,1.5,12,0,4,0.67,0.67,1,3,1,3,2,0
1,0,0,1,1,1,2,5.33,1.5,12,0,4,0.67,0.67,1,3,1,3,2,0
1,0,0,1,1,1,2,5.33,1.5,12,0,4,0.67,0.67,1,3,1,3,2,0
1,0,0,1,1,1,2,5.33,1.5,12,0,4,0.67,0.67,1,3,1,3,2,0
1,0,0,1,1,1,2,5.33,1.5,12,0,4,0.67,0.67,1,3,1,3,2,0
1,0,0,1,1,1,2,5.33,1.5,12,0,4,0.67,0.67,1,3,1,3,2,0
1,0,0,1,1,1,2,5.33,1.5,12,0,4,0.67,0.67,1,3,1,3,2,0
1,0,0,1,1,1,2,5.33,1.5,12,0,4,0.67,0.67,1,3,1,3,2,0
1,0,0,1,1,1,2,5.33,1.5,12,0,4,0.67,0.67,1,3,1,3,2,0
1,0,0,1,1,1,2,0,0,0,0,4,0,0,0,4,0,4,2,0
1,0,0,1,1,1,1,0,0,0,0,1,0,0,0,1,0,1,1,0
1,0,0,1,1,1,2,0,0,0,0,5,0,0,0,5,0,5,2,0
11,1,4,6,1,1,21,13.86,22.5,7014.99,0.1,68,0.04,389.72,27,41,9,15,22,0
1,0,0,1,1,1,1,0,0,0,0,0,0,0,0,0,0,0,1,0
1,0,0,1,1,1,1,0,0,0,0,1,0,0,0,1,0,1,1,0
1,0,0,1,1,1,2,5.33,1.5,12,0,4,0.67,0.67,1,3,1,3,2,0
1,0,0,1,1,1,2,5.33,1.5,12,0,4,0.67,0.67,1,3,1,3,2,0
1,9,0,1,1,1,2,0,0,0,0,9,0,0,9,0,1,0,11,0
1,0,0,1,1,1,1,0,0,0,0,0,0,0,0,0,0,0,1,0
1,0,0,1,1,1,1,0,0,0,0,0,0,0,0,0,0,0,1,0
1,0,0,1,1,1,1,0,0,0,0,1,0,0,0,1,0,1,1,0
1,0,0,1,1,1,4,18.49,2.4,106.51,0.01,14,0.42,5.92,6,8,5,4,4,0
1,0,0,1,1,1,2,5.33,1.5,12,0,4,0.67,0.67,1,3,1,3,2,0
1,0,0,1,1,1,5,8.45,0.75,4.75,0,4,1.33,0.26,3,1,2,1,5,0
1,0,0,1,1,1,1,0,0,0,0,0,0,0,0,0,0,0,1,0
1,0,0,1,1,1,1,0,0,0,0,1,0,0,0,1,0,1,1,0
1,0,0,1,1,1,3,10.8,2.5,67.5,0.01,9,0.4,3.75,3,6,3,5,3,0
1,0,0,1,1,1,2,5.33,1.5,12,0,4,0.67,0.67,1,3,1,3,2,0
1,0,0,1,1,1,2,6.2,2.5,38.77,0.01,6,0.4,2.15,1,5,1,5,2,0
1,0,0,1,1,1,4,9.51,0.5,2.38,0,3,2,0.13,2,1,2,1,4,0
1,0,0,1,1,1,1,0,0,0,0,1,0,0,0,1,0,1,1,0
1,0,0,1,1,1,2,5.33,1.5,12,0,4,0.67,0.67,1,3,1,3,2,0
1,0,0,1,1,1,2,5.33,1.5,12,0,4,0.67,0.67,1,3,1,3,2,0
1,0,0,1,1,1,2,0,0,0,0,4,0,0,0,4,0,4,2,0
1,0,0,1,1,1,1,0,0,0,0,1,0,0,0,1,0,1,1,0
1,0,0,1,1,1,2,0,0,0,0,5,0,0,0,5,0,5,2,0
1,0,0,1,1,1,1,0,0,0,0,1,0,0,0,1,0,1,1,0
1,0,0,1,1,1,2,5.33,1.5,12,0,4,0.67,0.67,1,3,1,3,2,0
1,0,0,1,1,1,2,5.33,1.5,12,0,4,0.67,0.67,1,3,1,3,2,0
1,0,0,1,1,1,1,0,0,0,0,1,0,0,0,1,0,1,1,0
1,0,0,1,1,1,1,0,0,0,0,1,0,0,0,1,0,1,1,0
1,0,0,1,1,1,1,0,0,0,0,1,0,0,0,1,0,1,1,0
1,0,0,1,1,1,1,0,0,0,0,1,0,0,0,1,0,1,1,0
1,0,0,1,1,1,1,0,0,0,0,1,0,0,0,1,0,1,1,0
1,0,0,1,1,1,1,0,0,0,0,1,0,0,0,1,0,1,1,0
1,0,0,1,1,1,1,0,0,0,0,1,0,0,0,1,0,1,1,0
1,0,0,1,1,1,0,0,0,0,0,1,0,0,0,1,0,1,0,0
1,0,0,1,1,1,2,0,0,0,0,3,0,0,0,3,0,3,2,0
1,0,0,1,1,1,2,0,0,0,0,3,0,0,0,3,0,3,2,0
1,0,0,1,1,1,2,0,0,0,0,3,0,0,0,3,0,3,2,0
1,0,0,1,1,1,2,0,0,0,0,3,0,0,0,3,0,3,2,0
1,0,0,1,1,1,2,0,0,0,0,3,0,0,0,3,0,3,2,0
1,0,0,1,1,1,2,0,0,0,0,3,0,0,0,3,0,3,2,0
1,0,0,1,1,1,2,0,0,0,0,3,0,0,0,3,0,3,2,0
1,0,0,1,1,1,2,0,0,0,0,3,0,0,0,3,0,3,2,0
1,0,0,1,1,1,2,0,0,0,0,3,0,0,0,3,0,3,2,0
1,0,0,1,1,1,2,0,0,0,0,3,0,0,0,3,0,3,2,0
1,0,0,1,1,1,2,0,0,0,0,3,0,0,0,3,0,3,2,0
1,0,0,1,1,1,3,11.63,2,46.53,0.01,9,0.5,2.58,4,5,3,3,3,0
1,0,0,1,1,1,0,5.33,1.5,12,0,4,0.67,0.67,1,3,1,3,0,0
1,0,0,1,1,1,0,5.33,1.5,12,0,4,0.67,0.67,1,3,1,3,0,0
1,0,0,1,1,1,0,5.33,1.5,12,0,4,0.67,0.67,1,3,1,3,0,0
1,0,0,1,1,1,2,0,0,0,0,3,0,0,0,3,0,3,2,0
1,0,0,1,1,1,2,5.33,1.5,12,0,4,0.67,0.67,1,3,1,3,2,0
1,0,0,1,1,1,2,0,0,0,0,3,0,0,0,3,0,3,2,0
1,0,0,1,1,1,2,0,0,0,0,3,0,0,0,3,0,3,2,0
1,0,0,1,1,1,2,0,0,0,0,3,0,0,0,3,0,3,2,0
1,0,0,1,1,1,2,0,0,0,0,3,0,0,0,3,0,3,2,0
1,0,0,1,1,1,2,0,0,0,0,3,0,0,0,3,0,3,2,0
1,0,0,1,1,1,2,0,0,0,0,3,0,0,0,3,0,3,2,0
1,0,0,1,1,1,2,0,0,0,0,3,0,0,0,3,0,3,2,0
1,0,0,1,1,1,2,0,0,0,0,3,0,0,0,3,0,3,2,0
1,0,0,1,1,1,2,0,0,0,0,3,0,0,0,3,0,3,2,0
1,0,0,1,1,1,2,0,0,0,0,3,0,0,0,3,0,3,2,0
1,0,0,1,1,1,2,0,0,0,0,3,0,0,0,3,0,3,2,0
1,0,0,1,1,1,0,7.74,1.5,17.41,0,5,0.67,0.97,2,3,2,3,0,0
1,0,0,1,1,1,0,7.74,1.5,17.41,0,5,0.67,0.97,2,3,2,3,0,0
1,0,0,1,1,1,0,0,0,0,0,3,0,0,0,3,0,3,0,0
1,0,0,1,1,1,0,5.33,1.5,12,0,4,0.67,0.67,1,3,1,3,0,0
1,0,0,1,1,1,2,0,0,0,0,3,0,0,0,3,0,3,2,0
1,0,0,1,1,1,2,0,0,0,0,3,0,0,0,3,0,3,2,0
1,0,0,1,1,1,2,0,0,0,0,3,0,0,0,3,0,3,2,0
1,0,0,1,1,1,2,0,0,0,0,3,0,0,0,3,0,3,2,0
1,0,0,1,1,1,2,0,0,0,0,3,0,0,0,3,0,3,2,0
1,0,0,1,1,1,2,0,0,0,0,3,0,0,0,3,0,3,2,0
1,0,0,1,1,1,2,0,0,0,0,3,0,0,0,3,0,3,2,0
1,0,0,1,1,1,2,0,0,0,0,3,0,0,0,3,0,3,2,0
1,0,0,1,1,1,2,0,0,0,0,3,0,0,0,3,0,3,2,0
1,0,0,1,1,1,2,0,0,0,0,3,0,0,0,3,0,3,2,0
1,0,0,1,1,1,2,0,0,0,0,3,0,0,0,3,0,3,2,0
5,0,5,3,1,1,7,13.32,13.71,2505.06,0.06,43,0.07,139.17,16,27,7,12,7,0
5,0,5,3,1,1,7,13.32,13.71,2505.06,0.06,43,0.07,139.17,16,27,7,12,7,0
1,0,0,1,1,1,1,0,0,0,0,1,0,0,0,1,0,1,1,0
5,0,31,3,1,1,155,46.1,64.68,192811.5,0.99,591,0.02,10711.75,199,392,20,13,155,1
19,0,40,10,4,10,203,50.98,89.09,404680.57,1.51,832,0.01,22482.25,283,549,27,17,203,1
1,0,1,1,1,1,15,2.17,6,78,0,13,0.17,4.33,12,1,1,1,15,0
17,3,6,9,9,1,45,56.82,14.87,12564.22,0.28,161,0.07,698.01,73,88,27,11,48,0
19,3,7,10,10,1,50,64.01,15.4,15181.16,0.33,184,0.06,843.4,84,100,30,11,53,0
1,0,1,1,1,1,11,40.77,8.59,3009.17,0.12,84,0.12,167.18,27,57,11,7,11,0
5,0,6,3,1,1,16,33.33,4.8,768,0.05,40,0.21,42.67,16,24,10,6,16,0
9,2,1,8,1,1,27,34.09,9.88,3329.22,0.11,68,0.1,184.96,24,44,17,14,29,0
3,0,1,2,1,1,2,12.09,6.3,479.73,0.03,20,0.16,26.65,7,13,5,9,2,0
1,0,0,1,1,1,2,5.33,1.5,12,0,4,0.67,0.67,1,3,1,3,2,0
1,0,0,1,1,1,2,5.33,1.5,12,0,4,0.67,0.67,1,3,1,3,2,0
1,0,0,1,1,1,2,5.33,1.5,12,0,4,0.67,0.67,1,3,1,3,2,0
1,0,0,1,1,1,2,5.33,1.5,12,0,4,0.67,0.67,1,3,1,3,2,0
1,0,0,1,1,1,2,5.33,1.5,12,0,4,0.67,0.67,1,3,1,3,2,0
1,0,0,1,1,1,2,5.33,1.5,12,0,4,0.67,0.67,1,3,1,3,2,0
1,0,0,1,1,1,2,5.33,1.5,12,0,4,0.67,0.67,1,3,1,3,2,0
1,0,0,1,1,1,2,5.33,1.5,12,0,4,0.67,0.67,1,3,1,3,2,0
1,0,0,1,1,1,2,5.33,1.5,12,0,4,0.67,0.67,1,3,1,3,2,0
1,0,0,1,1,1,2,0,0,0,0,4,0,0,0,4,0,4,2,0
1,0,0,1,1,1,1,0,0,0,0,1,0,0,0,1,0,1,1,0
1,0,0,1,1,1,2,0,0,0,0,5,0,0,0,5,0,5,2,0
11,1,4,6,1,1,21,13.86,22.5,7014.99,0.1,68,0.04,389.72,27,41,9,15,22,0
1,0,0,1,1,1,1,0,0,0,0,0,0,0,0,0,0,0,1,0
1,0,0,1,1,1,1,0,0,0,0,1,0,0,0,1,0,1,1,0
1,0,0,1,1,1,2,5.33,1.5,12,0,4,0.67,0.67,1,3,1,3,2,0
1,0,0,1,1,1,2,5.33,1.5,12,0,4,0.67,0.67,1,3,1,3,2,0
1,9,0,1,1,1,2,0,0,0,0,9,0,0,9,0,1,0,11,0
1,0,0,1,1,1,1,0,0,0,0,0,0,0,0,0,0,0,1,0
1,0,0,1,1,1,1,0,0,0,0,0,0,0,0,0,0,0,1,0
1,0,0,1,1,1,1,0,0,0,0,1,0,0,0,1,0,1,1,0
1,0,0,1,1,1,4,18.49,2.4,106.51,0.01,14,0.42,5.92,6,8,5,4,4,0
1,0,0,1,1,1,2,5.33,1.5,12,0,4,0.67,0.67,1,3,1,3,2,0
1,0,0,1,1,1,5,8.45,0.75,4.75,0,4,1.33,0.26,3,1,2,1,5,0
1,0,0,1,1,1,1,0,0,0,0,0,0,0,0,0,0,0,1,0
1,0,0,1,1,1,1,0,0,0,0,1,0,0,0,1,0,1,1,0
1,0,0,1,1,1,3,10.8,2.5,67.5,0.01,9,0.4,3.75,3,6,3,5,3,0
1,0,0,1,1,1,2,5.33,1.5,12,0,4,0.67,0.67,1,3,1,3,2,0
1,0,0,1,1,1,2,6.2,2.5,38.77,0.01,6,0.4,2.15,1,5,1,5,2,0
1,0,0,1,1,1,4,9.51,0.5,2.38,0,3,2,0.13,2,1,2,1,4,0
1,0,0,1,1,1,1,0,0,0,0,1,0,0,0,1,0,1,1,0
1,0,0,1,1,1,2,5.33,1.5,12,0,4,0.67,0.67,1,3,1,3,2,0
1,0,0,1,1,1,2,5.33,1.5,12,0,4,0.67,0.67,1,3,1,3,2,0
1,0,0,1,1,1,2,0,0,0,0,4,0,0,0,4,0,4,2,0
1,0,0,1,1,1,1,0,0,0,0,1,0,0,0,1,0,1,1,0
1,0,0,1,1,1,2,0,0,0,0,5,0,0,0,5,0,5,2,0
1,0,0,1,1,1,1,0,0,0,0,1,0,0,0,1,0,1,1,0
1,0,0,1,1,1,2,5.33,1.5,12,0,4,0.67,0.67,1,3,1,3,2,0
1,0,0,1,1,1,2,5.33,1.5,12,0,4,0.67,0.67,1,3,1,3,2,0
1,0,0,1,1,1,1,0,0,0,0,1,0,0,0,1,0,1,1,0
1,0,0,1,1,1,1,0,0,0,0,1,0,0,0,1,0,1,1,0
1,0,0,1,1,1,1,0,0,0,0,1,0,0,0,1,0,1,1,0
1,0,0,1,1,1,1,0,0,0,0,1,0,0,0,1,0,1,1,0
1,0,0,1,1,1,1,0,0,0,0,1,0,0,0,1,0,1,1,0
1,0,0,1,1,1,1,0,0,0,0,1,0,0,0,1,0,1,1,0
1,0,0,1,1,1,1,0,0,0,0,1,0,0,0,1,0,1,1,0
1,0,0,1,1,1,0,0,0,0,0,1,0,0,0,1,0,1,0,0
1,0,0,1,1,1,2,0,0,0,0,3,0,0,0,3,0,3,2,0
1,0,0,1,1,1,2,0,0,0,0,3,0,0,0,3,0,3,2,0
1,0,0,1,1,1,2,0,0,0,0,3,0,0,0,3,0,3,2,0
1,0,0,1,1,1,2,0,0,0,0,3,0,0,0,3,0,3,2,0
1,0,0,1,1,1,2,0,0,0,0,3,0,0,0,3,0,3,2,0
1,0,0,1,1,1,2,0,0,0,0,3,0,0,0,3,0,3,2,0
1,0,0,1,1,1,2,0,0,0,0,3,0,0,0,3,0,3,2,0
1,0,0,1,1,1,2,0,0,0,0,3,0,0,0,3,0,3,2,0
1,0,0,1,1,1,2,0,0,0,0,3,0,0,0,3,0,3,2,0
1,0,0,1,1,1,2,0,0,0,0,3,0,0,0,3,0,3,2,0
1,0,0,1,1,1,2,0,0,0,0,3,0,0,0,3,0,3,2,0
1,0,0,1,1,1,3,11.63,2,46.53,0.01,9,0.5,2.58,4,5,3,3,3,0
1,0,0,1,1,1,0,5.33,1.5,12,0,4,0.67,0.67,1,3,1,3,0,0
1,0,0,1,1,1,0,5.33,1.5,12,0,4,0.67,0.67,1,3,1,3,0,0
1,0,0,1,1,1,0,5.33,1.5,12,0,4,0.67,0.67,1,3,1,3,0,0
1,0,0,1,1,1,2,0,0,0,0,3,0,0,0,3,0,3,2,0
1,0,0,1,1,1,2,5.33,1.5,12,0,4,0.67,0.67,1,3,1,3,2,0
1,0,0,1,1,1,2,0,0,0,0,3,0,0,0,3,0,3,2,0
1,0,0,1,1,1,2,0,0,0,0,3,0,0,0,3,0,3,2,0
1,0,0,1,1,1,2,0,0,0,0,3,0,0,0,3,0,3,2,0
1,0,0,1,1,1,2,0,0,0,0,3,0,0,0,3,0,3,2,0
1,0,0,1,1,1,2,0,0,0,0,3,0,0,0,3,0,3,2,0
1,0,0,1,1,1,2,0,0,0,0,3,0,0,0,3,0,3,2,0
1,0,0,1,1,1,2,0,0,0,0,3,0,0,0,3,0,3,2,0
1,0,0,1,1,1,2,0,0,0,0,3,0,0,0,3,0,3,2,0
1,0,0,1,1,1,2,0,0,0,0,3,0,0,0,3,0,3,2,0
1,0,0,1,1,1,2,0,0,0,0,3,0,0,0,3,0,3,2,0
1,0,0,1,1,1,2,0,0,0,0,3,0,0,0,3,0,3,2,0
1,0,0,1,1,1,0,7.74,1.5,17.41,0,5,0.67,0.97,2,3,2,3,0,0
1,0,0,1,1,1,0,7.74,1.5,17.41,0,5,0.67,0.97,2,3,2,3,0,0
1,0,0,1,1,1,0,0,0,0,0,3,0,0,0,3,0,3,0,0
1,0,0,1,1,1,0,5.33,1.5,12,0,4,0.67,0.67,1,3,1,3,0,0
1,0,0,1,1,1,2,0,0,0,0,3,0,0,0,3,0,3,2,0
1,0,0,1,1,1,2,0,0,0,0,3,0,0,0,3,0,3,2,0
1,0,0,1,1,1,2,0,0,0,0,3,0,0,0,3,0,3,2,0
1,0,0,1,1,1,2,0,0,0,0,3,0,0,0,3,0,3,2,0
1,0,0,1,1,1,2,0,0,0,0,3,0,0,0,3,0,3,2,0
1,0,0,1,1,1,2,0,0,0,0,3,0,0,0,3,0,3,2,0
1,0,0,1,1,1,2,0,0,0,0,3,0,0,0,3,0,3,2,0
1,0,0,1,1,1,2,0,0,0,0,3,0,0,0,3,0,3,2,0
1,0,0,1,1,1,2,0,0,0,0,3,0,0,0,3,0,3,2,0
1,0,0,1,1,1,2,0,0,0,0,3,0,0,0,3,0,3,2,0
1,0,0,1,1,1,2,0,0,0,0,3,0,0,0,3,0,3,2,0
5,0,5,3,1,1,7,13.32,13.71,2505.06,0.06,43,0.07,139.17,16,27,7,12,7,0
5,0,5,3,1,1,7,13.32,13.71,2505.06,0.06,43,0.07,139.17,16,27,7,12,7,0
1,0,0,1,1,1,1,0,0,0,0,1,0,0,0,1,0,1,1,0
1,0,0,1,1,1,1,0,0,0,0,1,0,0,0,1,0,1,1,0
3,0,7,2,2,1,15,27.23,10,2723.24,0.09,62,0.1,151.29,22,40,11,10,15,0
3,0,4,2,2,1,18,26.72,9.82,2575.96,0.09,58,0.1,143.11,18,40,11,12,18,0
1,0,0,1,1,1,3,0,0,0,0,1,0,0,0,1,0,1,3,0
1,0,2,1,1,1,12,40.72,8.91,3232.07,0.12,87,0.11,179.56,28,59,11,7,12,0
53,3,183,27,18,10,538,424.65,52.73,1180711.79,7.46,2961,0.02,65595.1,1067,1894,172,17,541,0
9,2,1,8,1,1,27,34.09,9.88,3329.22,0.11,68,0.1,184.96,24,44,17,14,29,0
3,0,1,2,1,1,2,12.09,6.3,479.73,0.03,20,0.16,26.65,7,13,5,9,2,0
1,0,0,1,1,1,2,5.33,1.5,12,0,4,0.67,0.67,1,3,1,3,2,0
1,0,0,1,1,1,2,5.33,1.5,12,0,4,0.67,0.67,1,3,1,3,2,0
1,0,0,1,1,1,2,5.33,1.5,12,0,4,0.67,0.67,1,3,1,3,2,0
1,0,0,1,1,1,2,5.33,1.5,12,0,4,0.67,0.67,1,3,1,3,2,0
1,0,0,1,1,1,2,5.33,1.5,12,0,4,0.67,0.67,1,3,1,3,2,0
1,0,0,1,1,1,2,5.33,1.5,12,0,4,0.67,0.67,1,3,1,3,2,0
1,0,0,1,1,1,2,5.33,1.5,12,0,4,0.67,0.67,1,3,1,3,2,0
1,0,0,1,1,1,2,5.33,1.5,12,0,4,0.67,0.67,1,3,1,3,2,0
1,0,0,1,1,1,2,5.33,1.5,12,0,4,0.67,0.67,1,3,1,3,2,0
1,0,0,1,1,1,2,0,0,0,0,4,0,0,0,4,0,4,2,0
1,0,0,1,1,1,1,0,0,0,0,1,0,0,0,1,0,1,1,0
1,0,0,1,1,1,2,0,0,0,0,5,0,0,0,5,0,5,2,0
11,1,4,6,1,1,21,13.86,22.5,7014.99,0.1,68,0.04,389.72,27,41,9,15,22,0
1,0,0,1,1,1,1,0,0,0,0,0,0,0,0,0,0,0,1,0
1,0,0,1,1,1,1,0,0,0,0,1,0,0,0,1,0,1,1,0
1,0,0,1,1,1,2,5.33,1.5,12,0,4,0.67,0.67,1,3,1,3,2,0
1,0,0,1,1,1,2,5.33,1.5,12,0,4,0.67,0.67,1,3,1,3,2,0
1,9,0,1,1,1,2,0,0,0,0,9,0,0,9,0,1,0,11,0
1,0,0,1,1,1,1,0,0,0,0,0,0,0,0,0,0,0,1,0
1,0,0,1,1,1,1,0,0,0,0,0,0,0,0,0,0,0,1,0
1,0,0,1,1,1,1,0,0,0,0,1,0,0,0,1,0,1,1,0
1,0,0,1,1,1,4,18.49,2.4,106.51,0.01,14,0.42,5.92,6,8,5,4,4,0
1,0,0,1,1,1,2,5.33,1.5,12,0,4,0.67,0.67,1,3,1,3,2,0
1,0,0,1,1,1,5,8.45,0.75,4.75,0,4,1.33,0.26,3,1,2,1,5,0
1,0,0,1,1,1,1,0,0,0,0,0,0,0,0,0,0,0,1,0
1,0,0,1,1,1,1,0,0,0,0,1,0,0,0,1,0,1,1,0
1,0,0,1,1,1,3,10.8,2.5,67.5,0.01,9,0.4,3.75,3,6,3,5,3,0
1,0,0,1,1,1,2,5.33,1.5,12,0,4,0.67,0.67,1,3,1,3,2,0
1,0,0,1,1,1,2,6.2,2.5,38.77,0.01,6,0.4,2.15,1,5,1,5,2,0
1,0,0,1,1,1,4,9.51,0.5,2.38,0,3,2,0.13,2,1,2,1,4,0
1,0,0,1,1,1,1,0,0,0,0,1,0,0,0,1,0,1,1,0
1,0,0,1,1,1,2,5.33,1.5,12,0,4,0.67,0.67,1,3,1,3,2,0
1,0,0,1,1,1,2,5.33,1.5,12,0,4,0.67,0.67,1,3,1,3,2,0
1,0,0,1,1,1,2,0,0,0,0,4,0,0,0,4,0,4,2,0
1,0,0,1,1,1,1,0,0,0,0,1,0,0,0,1,0,1,1,0
1,0,0,1,1,1,2,0,0,0,0,5,0,0,0,5,0,5,2,0
1,0,0,1,1,1,1,0,0,0,0,1,0,0,0,1,0,1,1,0
1,0,0,1,1,1,2,5.33,1.5,12,0,4,0.67,0.67,1,3,1,3,2,0
1,0,0,1,1,1,2,5.33,1.5,12,0,4,0.67,0.67,1,3,1,3,2,0
1,0,0,1,1,1,1,0,0,0,0,1,0,0,0,1,0,1,1,0
1,0,0,1,1,1,1,0,0,0,0,1,0,0,0,1,0,1,1,0
1,0,0,1,1,1,1,0,0,0,0,1,0,0,0,1,0,1,1,0
1,0,0,1,1,1,1,0,0,0,0,1,0,0,0,1,0,1,1,0
1,0,0,1,1,1,1,0,0,0,0,1,0,0,0,1,0,1,1,0
1,0,0,1,1,1,1,0,0,0,0,1,0,0,0,1,0,1,1,0
1,0,0,1,1,1,1,0,0,0,0,1,0,0,0,1,0,1,1,0
1,0,0,1,1,1,0,0,0,0,0,1,0,0,0,1,0,1,0,0
1,0,0,1,1,1,2,0,0,0,0,3,0,0,0,3,0,3,2,0
1,0,0,1,1,1,2,0,0,0,0,3,0,0,0,3,0,3,2,0
1,0,0,1,1,1,2,0,0,0,0,3,0,0,0,3,0,3,2,0
1,0,0,1,1,1,2,0,0,0,0,3,0,0,0,3,0,3,2,0
1,0,0,1,1,1,2,0,0,0,0,3,0,0,0,3,0,3,2,0
1,0,0,1,1,1,2,0,0,0,0,3,0,0,0,3,0,3,2,0
1,0,0,1,1,1,2,0,0,0,0,3,0,0,0,3,0,3,2,0
1,0,0,1,1,1,2,0,0,0,0,3,0,0,0,3,0,3,2,0
1,0,0,1,1,1,2,0,0,0,0,3,0,0,0,3,0,3,2,0
1,0,0,1,1,1,2,0,0,0,0,3,0,0,0,3,0,3,2,0
1,0,0,1,1,1,2,0,0,0,0,3,0,0,0,3,0,3,2,0
1,0,0,1,1,1,3,11.63,2,46.53,0.01,9,0.5,2.58,4,5,3,3,3,0
1,0,0,1,1,1,0,5.33,1.5,12,0,4,0.67,0.67,1,3,1,3,0,0
1,0,0,1,1,1,0,5.33,1.5,12,0,4,0.67,0.67,1,3,1,3,0,0
1,0,0,1,1,1,0,5.33,1.5,12,0,4,0.67,0.67,1,3,1,3,0,0
1,0,0,1,1,1,2,0,0,0,0,3,0,0,0,3,0,3,2,0
1,0,0,1,1,1,2,5.33,1.5,12,0,4,0.67,0.67,1,3,1,3,2,0
1,0,0,1,1,1,2,0,0,0,0,3,0,0,0,3,0,3,2,0
1,0,0,1,1,1,2,0,0,0,0,3,0,0,0,3,0,3,2,0
1,0,0,1,1,1,2,0,0,0,0,3,0,0,0,3,0,3,2,0
1,0,0,1,1,1,2,0,0,0,0,3,0,0,0,3,0,3,2,0
1,0,0,1,1,1,2,0,0,0,0,3,0,0,0,3,0,3,2,0
1,0,0,1,1,1,2,0,0,0,0,3,0,0,0,3,0,3,2,0
1,0,0,1,1,1,2,0,0,0,0,3,0,0,0,3,0,3,2,0
1,0,0,1,1,1,2,0,0,0,0,3,0,0,0,3,0,3,2,0
1,0,0,1,1,1,2,0,0,0,0,3,0,0,0,3,0,3,2,0
1,0,0,1,1,1,2,0,0,0,0,3,0,0,0,3,0,3,2,0
1,0,0,1,1,1,2,0,0,0,0,3,0,0,0,3,0,3,2,0
1,0,0,1,1,1,0,7.74,1.5,17.41,0,5,0.67,0.97,2,3,2,3,0,0
1,0,0,1,1,1,0,7.74,1.5,17.41,0,5,0.67,0.97,2,3,2,3,0,0
1,0,0,1,1,1,0,0,0,0,0,3,0,0,0,3,0,3,0,0
1,0,0,1,1,1,0,5.33,1.5,12,0,4,0.67,0.67,1,3,1,3,0,0
1,0,0,1,1,1,2,0,0,0,0,3,0,0,0,3,0,3,2,0
1,0,0,1,1,1,2,0,0,0,0,3,0,0,0,3,0,3,2,0
1,0,0,1,1,1,2,0,0,0,0,3,0,0,0,3,0,3,2,0
1,0,0,1,1,1,2,0,0,0,0,3,0,0,0,3,0,3,2,0
1,0,0,1,1,1,2,0,0,0,0,3,0,0,0,3,0,3,2,0
1,0,0,1,1,1,2,0,0,0,0,3,0,0,0,3,0,3,2,0
1,0,0,1,1,1,2,0,0,0,0,3,0,0,0,3,0,3,2,0
1,0,0,1,1,1,2,0,0,0,0,3,0,0,0,3,0,3,2,0
1,0,0,1,1,1,2,0,0,0,0,3,0,0,0,3,0,3,2,0
1,0,0,1,1,1,2,0,0,0,0,3,0,0,0,3,0,3,2,0
1,0,0,1,1,1,2,0,0,0,0,3,0,0,0,3,0,3,2,0
5,0,5,3,1,1,7,13.32,13.71,2505.06,0.06,43,0.07,139.17,16,27,7,12,7,0
5,0,5,3,1,1,7,13.32,13.71,2505.06,0.06,43,0.07,139.17,16,27,7,12,7,0
1,0,0,1,1,1,0,0,0,0,0,1,0,0,0,1,0,1,0,0
7,3,5,3,1,1,13,26.9,5.06,687.56,0.05,34,0.2,38.2,13,21,9,7,16,0
9,4,6,5,1,1,31,41.1,7,2014.07,0.1,69,0.14,111.89,28,41,12,6,35,0
5,11,4,3,1,1,11,40.18,5.5,1215.53,0.07,53,0.18,67.53,22,31,12,6,22,0
13,3,5,7,1,1,35,43.62,6.5,1843.11,0.09,68,0.15,102.39,26,42,12,6,38,0
9,11,7,5,1,1,18,30.19,11.08,3704.76,0.11,75,0.09,205.82,32,43,13,9,29,0
9,11,7,5,1,1,18,30.19,11.08,3704.76,0.11,75,0.09,205.82,32,43,13,9,29,0
11,2,5,3,1,1,14,27.04,6.65,1195.99,0.06,44,0.15,66.44,19,25,10,7,16,0
5,1,4,3,1,1,15,22.08,5,552.07,0.04,29,0.2,30.67,10,19,7,7,16,0
21,4,12,11,5,8,56,59.02,17.79,18684.19,0.35,196,0.06,1038.01,86,110,29,12,60,0
7,3,223,4,4,1,472,104.6,169.58,3008099.39,5.91,3143,0.01,167116.66,1074,2069,38,12,475,0
1,0,114,1,1,1,97,43.01,86.57,322359.57,1.24,835,0.01,17908.87,303,532,14,8,97,0
1,0,0,1,1,1,12,2.2,5,55,0,11,0.2,3.06,10,1,1,1,12,0
19,2,14,10,10,1,47,68.8,14,13485.77,0.32,181,0.07,749.21,84,97,30,10,49,0
19,2,14,10,10,1,47,68.8,14,13485.77,0.32,181,0.07,749.21,84,97,30,10,49,0
1,0,1,1,1,1,15,50.84,10.29,5378.95,0.17,121,0.1,298.83,48,73,14,6,15,0
41,19,399,21,21,1,1655,1448,52.12,3934078.79,25.16,8859,0.02,218559.92,3084,5775,355,12,1674,0
9,2,1,8,1,1,27,34.09,9.88,3329.22,0.11,68,0.1,184.96,24,44,17,14,29,0
3,0,1,2,1,1,2,12.09,6.3,479.73,0.03,20,0.16,26.65,7,13,5,9,2,0
1,0,0,1,1,1,2,5.33,1.5,12,0,4,0.67,0.67,1,3,1,3,2,0
1,0,0,1,1,1,2,5.33,1.5,12,0,4,0.67,0.67,1,3,1,3,2,0
1,0,0,1,1,1,2,5.33,1.5,12,0,4,0.67,0.67,1,3,1,3,2,0
1,0,0,1,1,1,2,5.33,1.5,12,0,4,0.67,0.67,1,3,1,3,2,0
1,0,0,1,1,1,2,5.33,1.5,12,0,4,0.67,0.67,1,3,1,3,2,0
1,0,0,1,1,1,2,5.33,1.5,12,0,4,0.67,0.67,1,3,1,3,2,0
1,0,0,1,1,1,2,5.33,1.5,12,0,4,0.67,0.67,1,3,1,3,2,0
1,0,0,1,1,1,2,5.33,1.5,12,0,4,0.67,0.67,1,3,1,3,2,0
1,0,0,1,1,1,2,5.33,1.5,12,0,4,0.67,0.67,1,3,1,3,2,0
1,0,0,1,1,1,2,0,0,0,0,4,0,0,0,4,0,4,2,0
1,0,0,1,1,1,1,0,0,0,0,1,0,0,0,1,0,1,1,0
1,0,0,1,1,1,2,0,0,0,0,5,0,0,0,5,0,5,2,0
11,1,4,6,1,1,21,13.86,22.5,7014.99,0.1,68,0.04,389.72,27,41,9,15,22,0
1,0,0,1,1,1,1,0,0,0,0,0,0,0,0,0,0,0,1,0
1,0,0,1,1,1,1,0,0,0,0,1,0,0,0,1,0,1,1,0
1,0,0,1,1,1,2,5.33,1.5,12,0,4,0.67,0.67,1,3,1,3,2,0
1,0,0,1,1,1,2,5.33,1.5,12,0,4,0.67,0.67,1,3,1,3,2,0
1,9,0,1,1,1,2,0,0,0,0,9,0,0,9,0,1,0,11,0
1,0,0,1,1,1,1,0,0,0,0,0,0,0,0,0,0,0,1,0
1,0,0,1,1,1,1,0,0,0,0,0,0,0,0,0,0,0,1,0
1,0,0,1,1,1,1,0,0,0,0,1,0,0,0,1,0,1,1,0
1,0,0,1,1,1,4,18.49,2.4,106.51,0.01,14,0.42,5.92,6,8,5,4,4,0
1,0,0,1,1,1,2,5.33,1.5,12,0,4,0.67,0.67,1,3,1,3,2,0
1,0,0,1,1,1,5,8.45,0.75,4.75,0,4,1.33,0.26,3,1,2,1,5,0
1,0,0,1,1,1,1,0,0,0,0,0,0,0,0,0,0,0,1,0
1,0,0,1,1,1,1,0,0,0,0,1,0,0,0,1,0,1,1,0
1,0,0,1,1,1,3,10.8,2.5,67.5,0.01,9,0.4,3.75,3,6,3,5,3,0
1,0,0,1,1,1,2,5.33,1.5,12,0,4,0.67,0.67,1,3,1,3,2,0
1,0,0,1,1,1,2,6.2,2.5,38.77,0.01,6,0.4,2.15,1,5,1,5,2,0
1,0,0,1,1,1,4,9.51,0.5,2.38,0,3,2,0.13,2,1,2,1,4,0
1,0,0,1,1,1,1,0,0,0,0,1,0,0,0,1,0,1,1,0
1,0,0,1,1,1,2,5.33,1.5,12,0,4,0.67,0.67,1,3,1,3,2,0
1,0,0,1,1,1,2,5.33,1.5,12,0,4,0.67,0.67,1,3,1,3,2,0
1,0,0,1,1,1,2,0,0,0,0,4,0,0,0,4,0,4,2,0
1,0,0,1,1,1,1,0,0,0,0,1,0,0,0,1,0,1,1,0
1,0,0,1,1,1,2,0,0,0,0,5,0,0,0,5,0,5,2,0
1,0,0,1,1,1,1,0,0,0,0,1,0,0,0,1,0,1,1,0
1,0,0,1,1,1,2,5.33,1.5,12,0,4,0.67,0.67,1,3,1,3,2,0
1,0,0,1,1,1,2,5.33,1.5,12,0,4,0.67,0.67,1,3,1,3,2,0
1,0,0,1,1,1,1,0,0,0,0,1,0,0,0,1,0,1,1,0
1,0,0,1,1,1,1,0,0,0,0,1,0,0,0,1,0,1,1,0
1,0,0,1,1,1,1,0,0,0,0,1,0,0,0,1,0,1,1,0
1,0,0,1,1,1,1,0,0,0,0,1,0,0,0,1,0,1,1,0
1,0,0,1,1,1,1,0,0,0,0,1,0,0,0,1,0,1,1,0
1,0,0,1,1,1,0,0,0,0,0,1,0,0,0,1,0,1,0,0
1,0,1,1,1,1,3,15,2,60,0.01,10,0.5,3.33,4,6,4,4,3,1
1,0,2,1,1,1,8,24.89,8.77,1913.98,0.07,47,0.11,106.33,19,28,13,12,8,1
11,1,4,7,4,1,37,37.4,30.74,35345.7,0.38,207,0.03,1963.65,83,124,27,20,38,1
1,0,0,1,1,1,2,5.33,1.5,12,0,4,0.67,0.67,1,3,1,3,2,0
1,0,0,1,1,1,2,5.33,1.5,12,0,4,0.67,0.67,1,3,1,3,2,0
1,0,0,1,1,1,2,5.33,1.5,12,0,4,0.67,0.67,1,3,1,3,2,0
1,0,0,1,1,1,2,5.33,1.5,12,0,4,0.67,0.67,1,3,1,3,2,0
1,0,0,1,1,1,2,5.33,1.5,12,0,4,0.67,0.67,1,3,1,3,2,0
1,0,0,1,1,1,2,5.33,1.5,12,0,4,0.67,0.67,1,3,1,3,2,0
1,0,0,1,1,1,2,5.33,1.5,12,0,4,0.67,0.67,1,3,1,3,2,0
1,0,0,1,1,1,1,0,0,0,0,0,0,0,0,0,0,0,1,0
1,0,0,1,1,1,2,8,3,72,0.01,8,0.33,4,2,6,2,6,2,0
1,0,0,1,1,1,2,8,3,72,0.01,8,0.33,4,2,6,2,6,2,0
1,0,0,1,1,1,2,8,3,72,0.01,8,0.33,4,2,6,2,6,2,0
1,0,0,1,1,1,2,8,3,72,0.01,8,0.33,4,2,6,2,6,2,0
1,0,0,1,1,1,2,8,3,72,0.01,8,0.33,4,2,6,2,6,2,0
1,0,0,1,1,1,2,8,3,72,0.01,8,0.33,4,2,6,2,6,2,0
1,0,0,1,1,1,2,8,3,72,0.01,8,0.33,4,2,6,2,6,2,0
1,0,0,1,1,1,2,8,3,72,0.01,8,0.33,4,2,6,2,6,2,0
1,0,0,1,1,1,2,8,3,72,0.01,8,0.33,4,2,6,2,6,2,0
1,0,0,1,1,1,2,8,3,72,0.01,8,0.33,4,2,6,2,6,2,0
1,0,0,1,1,1,1,0,0,0,0,1,0,0,0,1,0,1,1,0
1,0,0,1,1,1,2,5.33,1.5,12,0,4,0.67,0.67,1,3,1,3,2,0
1,0,0,1,1,1,2,5.33,1.5,12,0,4,0.67,0.67,1,3,1,3,2,0
1,9,0,1,1,1,2,0,0,0,0,9,0,0,9,0,1,0,11,0
1,0,0,1,1,1,2,8,3,72,0.01,8,0.33,4,2,6,2,6,2,0
1,0,0,1,1,1,2,8,3,72,0.01,8,0.33,4,2,6,2,6,2,0
1,0,0,1,1,1,3,21.46,5.5,649.15,0.04,31,0.18,36.06,11,20,7,7,3,0
1,0,0,1,1,1,3,21.46,5.5,649.15,0.04,31,0.18,36.06,11,20,7,7,3,0
1,0,0,1,1,1,3,21.46,5.5,649.15,0.04,31,0.18,36.06,11,20,7,7,3,0
1,0,0,1,1,1,3,21.46,5.5,649.15,0.04,31,0.18,36.06,11,20,7,7,3,0
1,0,0,1,1,1,3,21.46,5.5,649.15,0.04,31,0.18,36.06,11,20,7,7,3,0
1,0,0,1,1,1,3,21.46,5.5,649.15,0.04,31,0.18,36.06,11,20,7,7,3,0
1,0,0,1,1,1,2,8,3,72,0.01,8,0.33,4,2,6,2,6,2,0
1,0,0,1,1,1,2,8,3,72,0.01,8,0.33,4,2,6,2,6,2,0
1,0,0,1,1,1,1,0,0,0,0,0,0,0,0,0,0,0,1,0
1,0,0,1,1,1,1,0,0,0,0,0,0,0,0,0,0,0,1,0
1,0,0,1,1,1,1,0,0,0,0,1,0,0,0,1,0,1,1,0
1,0,0,1,1,1,4,18.49,2.4,106.51,0.01,14,0.42,5.92,6,8,5,4,4,0
1,0,0,1,1,1,2,5.33,1.5,12,0,4,0.67,0.67,1,3,1,3,2,0
1,0,0,1,1,1,5,8.45,0.75,4.75,0,4,1.33,0.26,3,1,2,1,5,0
1,0,0,1,1,1,1,0,0,0,0,0,0,0,0,0,0,0,1,0
1,0,0,1,1,1,1,0,0,0,0,1,0,0,0,1,0,1,1,0
1,0,0,1,1,1,3,10.8,2.5,67.5,0.01,9,0.4,3.75,3,6,3,5,3,0
1,0,0,1,1,1,2,5.33,1.5,12,0,4,0.67,0.67,1,3,1,3,2,0
1,0,0,1,1,1,2,6.2,2.5,38.77,0.01,6,0.4,2.15,1,5,1,5,2,0
1,0,0,1,1,1,4,9.51,0.5,2.38,0,3,2,0.13,2,1,2,1,4,0
1,0,0,1,1,1,1,0,0,0,0,1,0,0,0,1,0,1,1,0
1,0,0,1,1,1,1,0,0,0,0,1,0,0,0,1,0,1,1,0
1,0,0,1,1,1,1,0,0,0,0,1,0,0,0,1,0,1,1,0
1,0,0,1,1,1,1,0,0,0,0,1,0,0,0,1,0,1,1,0
1,0,0,1,1,1,1,0,0,0,0,1,0,0,0,1,0,1,1,0
1,0,0,1,1,1,0,0,0,0,0,1,0,0,0,1,0,1,0,0
1,0,0,1,1,1,2,0,0,0,0,3,0,0,0,3,0,3,2,0
1,0,0,1,1,1,2,0,0,0,0,3,0,0,0,3,0,3,2,0
1,0,0,1,1,1,2,0,0,0,0,3,0,0,0,3,0,3,2,0
1,0,0,1,1,1,2,0,0,0,0,3,0,0,0,3,0,3,2,0
1,0,0,1,1,1,2,0,0,0,0,3,0,0,0,3,0,3,2,0
1,0,0,1,1,1,2,0,0,0,0,3,0,0,0,3,0,3,2,0
1,0,0,1,1,1,2,0,0,0,0,3,0,0,0,3,0,3,2,0
1,0,0,1,1,1,2,0,0,0,0,3,0,0,0,3,0,3,2,0
1,0,0,1,1,1,2,0,0,0,0,3,0,0,0,3,0,3,2,0
1,0,0,1,1,1,2,0,0,0,0,3,0,0,0,3,0,3,2,0
1,0,0,1,1,1,2,0,0,0,0,3,0,0,0,3,0,3,2,0
1,0,0,1,1,1,3,11.63,2,46.53,0.01,9,0.5,2.58,4,5,3,3,3,0
1,0,0,1,1,1,0,5.33,1.5,12,0,4,0.67,0.67,1,3,1,3,0,0
1,0,0,1,1,1,0,5.33,1.5,12,0,4,0.67,0.67,1,3,1,3,0,0
1,0,0,1,1,1,0,5.33,1.5,12,0,4,0.67,0.67,1,3,1,3,0,0
1,0,0,1,1,1,2,0,0,0,0,3,0,0,0,3,0,3,2,0
1,0,0,1,1,1,2,5.33,1.5,12,0,4,0.67,0.67,1,3,1,3,2,0
1,0,0,1,1,1,2,0,0,0,0,3,0,0,0,3,0,3,2,0
1,0,0,1,1,1,2,0,0,0,0,3,0,0,0,3,0,3,2,0
1,0,0,1,1,1,2,0,0,0,0,3,0,0,0,3,0,3,2,0
1,0,0,1,1,1,2,0,0,0,0,3,0,0,0,3,0,3,2,0
1,0,0,1,1,1,2,0,0,0,0,3,0,0,0,3,0,3,2,0
1,0,0,1,1,1,2,0,0,0,0,3,0,0,0,3,0,3,2,0
1,0,0,1,1,1,2,0,0,0,0,3,0,0,0,3,0,3,2,0
1,0,0,1,1,1,2,0,0,0,0,3,0,0,0,3,0,3,2,0
1,0,0,1,1,1,2,0,0,0,0,3,0,0,0,3,0,3,2,0
1,0,0,1,1,1,2,0,0,0,0,3,0,0,0,3,0,3,2,0
1,0,0,1,1,1,2,0,0,0,0,3,0,0,0,3,0,3,2,0
1,0,1,1,1,1,3,18.82,4,301.14,0.03,21,0.25,16.73,8,13,6,6,3,0
1,0,0,1,1,1,0,7.74,1.5,17.41,0,5,0.67,0.97,2,3,2,3,0,0
1,0,0,1,1,1,0,7.74,1.5,17.41,0,5,0.67,0.97,2,3,2,3,0,0
5,1,59,3,3,1,263,246.14,28.65,202038.95,2.35,1081,0.03,11224.39,382,699,80,12,264,0
1,0,0,1,1,1,0,0,0,0,0,3,0,0,0,3,0,3,0,0
1,0,0,1,1,1,0,5.33,1.5,12,0,4,0.67,0.67,1,3,1,3,0,0
1,0,0,1,1,1,2,0,0,0,0,3,0,0,0,3,0,3,2,0
1,0,0,1,1,1,2,0,0,0,0,3,0,0,0,3,0,3,2,0
1,0,0,1,1,1,2,0,0,0,0,3,0,0,0,3,0,3,2,0
1,0,0,1,1,1,2,0,0,0,0,3,0,0,0,3,0,3,2,0
1,0,0,1,1,1,2,0,0,0,0,3,0,0,0,3,0,3,2,0
1,0,0,1,1,1,2,0,0,0,0,3,0,0,0,3,0,3,2,0
1,0,0,1,1,1,2,0,0,0,0,3,0,0,0,3,0,3,2,0
1,0,0,1,1,1,2,0,0,0,0,3,0,0,0,3,0,3,2,0
1,0,0,1,1,1,2,0,0,0,0,3,0,0,0,3,0,3,2,0
1,0,0,1,1,1,2,0,0,0,0,3,0,0,0,3,0,3,2,0
1,0,0,1,1,1,2,0,0,0,0,3,0,0,0,3,0,3,2,0
5,0,5,3,1,1,7,13.32,13.71,2505.06,0.06,43,0.07,139.17,16,27,7,12,7,0
5,0,5,3,1,1,7,13.32,13.71,2505.06,0.06,43,0.07,139.17,16,27,7,12,7,0
1,0,0,1,1,1,0,0,0,0,0,1,0,0,0,1,0,1,0,0
1,0,0,1,1,1,3,4,0.5,1,0,2,2,0.06,1,1,1,1,3,0
9,2,1,8,1,1,27,34.09,9.88,3329.22,0.11,68,0.1,184.96,24,44,17,14,29,0
3,0,1,2,1,1,2,12.09,6.3,479.73,0.03,20,0.16,26.65,7,13,5,9,2,0
1,0,0,1,1,1,2,5.33,1.5,12,0,4,0.67,0.67,1,3,1,3,2,0
1,0,0,1,1,1,2,5.33,1.5,12,0,4,0.67,0.67,1,3,1,3,2,0
1,0,0,1,1,1,2,5.33,1.5,12,0,4,0.67,0.67,1,3,1,3,2,0
1,0,0,1,1,1,2,5.33,1.5,12,0,4,0.67,0.67,1,3,1,3,2,0
1,0,0,1,1,1,2,5.33,1.5,12,0,4,0.67,0.67,1,3,1,3,2,0
1,0,0,1,1,1,2,5.33,1.5,12,0,4,0.67,0.67,1,3,1,3,2,0
1,0,0,1,1,1,2,5.33,1.5,12,0,4,0.67,0.67,1,3,1,3,2,0
5,0,3,3,3,1,15,27.6,10.33,2947.55,0.1,66,0.1,163.75,31,35,12,8,15,0
11,1,4,6,1,1,21,13.86,22.5,7014.99,0.1,68,0.04,389.72,27,41,9,15,22,0
1,0,0,1,1,1,2,20.97,3,188.72,0.02,17,0.33,10.48,7,10,7,6,2,0
1,0,0,1,1,1,2,20.97,3,188.72,0.02,17,0.33,10.48,7,10,7,6,2,0
1,0,0,1,1,1,2,27.35,3,246.13,0.03,21,0.33,13.67,9,12,9,6,2,0
1,0,0,1,1,1,3,30.67,3,276,0.03,23,0.33,15.33,10,13,10,6,3,0
1,0,0,1,1,1,3,30.67,3,276,0.03,23,0.33,15.33,10,13,10,6,3,0
1,0,0,1,1,1,3,30.67,3,276,0.03,23,0.33,15.33,10,13,10,6,3,0
1,0,0,1,1,1,2,27.35,3,246.13,0.03,21,0.33,13.67,9,12,9,6,2,0
1,0,0,1,1,1,3,27.35,3,246.13,0.03,21,0.33,13.67,9,12,9,6,3,0
1,0,0,1,1,1,2,20.97,3,188.72,0.02,17,0.33,10.48,7,10,7,6,2,0
1,0,0,1,1,1,2,20.97,3,188.72,0.02,17,0.33,10.48,7,10,7,6,2,0
1,0,0,1,1,1,2,20.97,3,188.72,0.02,17,0.33,10.48,7,10,7,6,2,0
1,0,0,1,1,1,2,17.92,3,161.32,0.02,15,0.33,8.96,6,9,6,6,2,0
1,0,0,1,1,1,2,17.92,3,161.32,0.02,15,0.33,8.96,6,9,6,6,2,0
1,0,0,1,1,1,2,14.99,3,134.92,0.01,13,0.33,7.5,5,8,5,6,2,0
1,0,0,1,1,1,2,14.99,3,134.92,0.01,13,0.33,7.5,5,8,5,6,2,0
1,0,0,1,1,1,2,14.99,3,134.92,0.01,13,0.33,7.5,5,8,5,6,2,0
1,0,0,1,1,1,2,14.99,3,134.92,0.01,13,0.33,7.5,5,8,5,6,2,0
1,0,0,1,1,1,2,14.99,3,134.92,0.01,13,0.33,7.5,5,8,5,6,2,0
1,0,0,1,1,1,2,17.92,3,161.32,0.02,15,0.33,8.96,6,9,6,6,2,0
1,0,0,1,1,1,2,17.92,3,161.32,0.02,15,0.33,8.96,6,9,6,6,2,0
1,0,0,1,1,1,2,20.97,3,188.72,0.02,17,0.33,10.48,7,10,7,6,2,0
1,0,0,1,1,1,2,20.97,3,188.72,0.02,17,0.33,10.48,7,10,7,6,2,0
1,0,0,1,1,1,1,0,0,0,0,0,0,0,0,0,0,0,1,0
1,0,0,1,1,1,1,0,0,0,0,1,0,0,0,1,0,1,1,0
1,0,0,1,1,1,2,5.33,1.5,12,0,4,0.67,0.67,1,3,1,3,2,0
1,0,0,1,1,1,2,5.33,1.5,12,0,4,0.67,0.67,1,3,1,3,2,0
1,9,0,1,1,1,2,0,0,0,0,9,0,0,9,0,1,0,11,0
1,0,0,1,1,1,1,0,0,0,0,0,0,0,0,0,0,0,1,0
1,0,0,1,1,1,1,0,0,0,0,0,0,0,0,0,0,0,1,0
1,0,0,1,1,1,1,0,0,0,0,1,0,0,0,1,0,1,1,0
1,0,0,1,1,1,4,18.49,2.4,106.51,0.01,14,0.42,5.92,6,8,5,4,4,0
1,0,0,1,1,1,2,5.33,1.5,12,0,4,0.67,0.67,1,3,1,3,2,0
1,0,0,1,1,1,5,8.45,0.75,4.75,0,4,1.33,0.26,3,1,2,1,5,0
1,0,0,1,1,1,1,0,0,0,0,0,0,0,0,0,0,0,1,0
1,0,0,1,1,1,1,0,0,0,0,1,0,0,0,1,0,1,1,0
1,0,0,1,1,1,3,10.8,2.5,67.5,0.01,9,0.4,3.75,3,6,3,5,3,0
1,0,0,1,1,1,2,5.33,1.5,12,0,4,0.67,0.67,1,3,1,3,2,0
1,0,0,1,1,1,2,6.2,2.5,38.77,0.01,6,0.4,2.15,1,5,1,5,2,0
1,0,0,1,1,1,4,9.51,0.5,2.38,0,3,2,0.13,2,1,2,1,4,0
1,0,0,1,1,1,1,0,0,0,0,1,0,0,0,1,0,1,1,0
1,0,0,1,1,1,1,0,0,0,0,1,0,0,0,1,0,1,1,0
1,0,0,1,1,1,1,0,0,0,0,1,0,0,0,1,0,1,1,0
1,0,0,1,1,1,1,0,0,0,0,1,0,0,0,1,0,1,1,0
1,0,0,1,1,1,1,0,0,0,0,1,0,0,0,1,0,1,1,0
1,0,0,1,1,1,0,0,0,0,0,1,0,0,0,1,0,1,0,0
1,0,0,1,1,1,0,0,0,0,0,1,0,0,0,1,0,1,0,0
1,0,0,1,1,1,2,0,0,0,0,3,0,0,0,3,0,3,2,0
1,0,0,1,1,1,2,0,0,0,0,3,0,0,0,3,0,3,2,0
1,0,0,1,1,1,2,0,0,0,0,3,0,0,0,3,0,3,2,0
1,0,0,1,1,1,2,0,0,0,0,3,0,0,0,3,0,3,2,0
1,0,0,1,1,1,2,0,0,0,0,3,0,0,0,3,0,3,2,0
1,0,0,1,1,1,2,0,0,0,0,3,0,0,0,3,0,3,2,0
1,0,0,1,1,1,2,0,0,0,0,3,0,0,0,3,0,3,2,0
1,0,0,1,1,1,2,0,0,0,0,3,0,0,0,3,0,3,2,0
1,0,0,1,1,1,2,0,0,0,0,3,0,0,0,3,0,3,2,0
1,0,0,1,1,1,2,0,0,0,0,3,0,0,0,3,0,3,2,0
1,0,0,1,1,1,2,0,0,0,0,3,0,0,0,3,0,3,2,0
1,0,0,1,1,1,3,11.63,2,46.53,0.01,9,0.5,2.58,4,5,3,3,3,0
1,0,0,1,1,1,0,5.33,1.5,12,0,4,0.67,0.67,1,3,1,3,0,0
1,0,0,1,1,1,0,5.33,1.5,12,0,4,0.67,0.67,1,3,1,3,0,0
1,0,0,1,1,1,0,5.33,1.5,12,0,4,0.67,0.67,1,3,1,3,0,0
1,0,0,1,1,1,2,0,0,0,0,3,0,0,0,3,0,3,2,0
1,0,0,1,1,1,2,5.33,1.5,12,0,4,0.67,0.67,1,3,1,3,2,0
1,0,0,1,1,1,2,0,0,0,0,3,0,0,0,3,0,3,2,0
1,0,0,1,1,1,2,0,0,0,0,3,0,0,0,3,0,3,2,0
1,0,0,1,1,1,2,0,0,0,0,3,0,0,0,3,0,3,2,0
1,0,0,1,1,1,2,0,0,0,0,3,0,0,0,3,0,3,2,0
1,0,0,1,1,1,2,0,0,0,0,3,0,0,0,3,0,3,2,0
1,0,0,1,1,1,2,0,0,0,0,3,0,0,0,3,0,3,2,0
1,0,0,1,1,1,2,0,0,0,0,3,0,0,0,3,0,3,2,0
1,0,0,1,1,1,2,0,0,0,0,3,0,0,0,3,0,3,2,0
1,0,0,1,1,1,2,0,0,0,0,3,0,0,0,3,0,3,2,0
1,0,0,1,1,1,2,0,0,0,0,3,0,0,0,3,0,3,2,0
1,0,0,1,1,1,2,0,0,0,0,3,0,0,0,3,0,3,2,0
1,0,3,1,1,1,5,12.49,8,799.29,0.03,27,0.13,44.41,10,17,5,8,5,0
1,0,0,1,1,1,0,7.74,1.5,17.41,0,5,0.67,0.97,2,3,2,3,0,0
1,0,0,1,1,1,0,7.74,1.5,17.41,0,5,0.67,0.97,2,3,2,3,0,0
3,0,1,2,2,1,13,34.2,7.33,1838.97,0.08,54,0.14,102.16,22,32,15,10,13,0
1,0,0,1,1,1,0,0,0,0,0,3,0,0,0,3,0,3,0,0
1,0,0,1,1,1,0,5.33,1.5,12,0,4,0.67,0.67,1,3,1,3,0,0
1,0,0,1,1,1,2,0,0,0,0,3,0,0,0,3,0,3,2,0
1,0,0,1,1,1,2,0,0,0,0,3,0,0,0,3,0,3,2,0
1,0,0,1,1,1,2,0,0,0,0,3,0,0,0,3,0,3,2,0
1,0,0,1,1,1,2,0,0,0,0,3,0,0,0,3,0,3,2,0
1,0,0,1,1,1,2,0,0,0,0,3,0,0,0,3,0,3,2,0
1,0,0,1,1,1,2,0,0,0,0,3,0,0,0,3,0,3,2,0
1,0,0,1,1,1,2,0,0,0,0,3,0,0,0,3,0,3,2,0
1,0,0,1,1,1,2,0,0,0,0,3,0,0,0,3,0,3,2,0
1,0,0,1,1,1,2,0,0,0,0,3,0,0,0,3,0,3,2,0
1,0,0,1,1,1,2,0,0,0,0,3,0,0,0,3,0,3,2,0
1,0,0,1,1,1,2,0,0,0,0,3,0,0,0,3,0,3,2,0
1,0,0,1,1,1,0,0,0,0,0,1,0,0,0,1,0,1,0,0
1,0,1,1,1,1,3,5.33,1.5,12,0,4,0.67,0.67,1,3,1,3,3,0
1,0,0,1,1,1,2,5.33,1.5,12,0,4,0.67,0.67,1,3,1,3,2,0
1,0,0,1,1,1,2,5.33,1.5,12,0,4,0.67,0.67,1,3,1,3,2,0
1,0,0,1,1,1,2,5.33,1.5,12,0,4,0.67,0.67,1,3,1,3,2,0
1,0,0,1,1,1,2,5.33,1.5,12,0,4,0.67,0.67,1,3,1,3,2,0
1,0,0,1,1,1,2,5.33,1.5,12,0,4,0.67,0.67,1,3,1,3,2,0
1,0,0,1,1,1,2,5.33,1.5,12,0,4,0.67,0.67,1,3,1,3,2,0
1,0,0,1,1,1,2,5.33,1.5,12,0,4,0.67,0.67,1,3,1,3,2,0
1,0,0,1,1,1,0,0,0,0,0,5,0,0,0,5,0,5,0,0
1,0,0,1,1,1,0,0,0,0,0,5,0,0,0,5,0,5,0,0
1,0,0,1,1,1,2,20.97,3,188.72,0.02,17,0.33,10.48,7,10,7,6,2,0
1,0,0,1,1,1,2,20.97,3,188.72,0.02,17,0.33,10.48,7,10,7,6,2,0
1,0,0,1,1,1,2,27.35,3,246.13,0.03,21,0.33,13.67,9,12,9,6,2,0
1,0,0,1,1,1,3,30.67,3,276,0.03,23,0.33,15.33,10,13,10,6,3,0
1,0,0,1,1,1,3,30.67,3,276,0.03,23,0.33,15.33,10,13,10,6,3,0
1,0,0,1,1,1,3,30.67,3,276,0.03,23,0.33,15.33,10,13,10,6,3,0
1,0,0,1,1,1,2,27.35,3,246.13,0.03,21,0.33,13.67,9,12,9,6,2,0
1,0,0,1,1,1,3,27.35,3,246.13,0.03,21,0.33,13.67,9,12,9,6,3,0
1,0,0,1,1,1,2,20.97,3,188.72,0.02,17,0.33,10.48,7,10,7,6,2,0
1,0,0,1,1,1,2,20.97,3,188.72,0.02,17,0.33,10.48,7,10,7,6,2,0
1,0,0,1,1,1,2,20.97,3,188.72,0.02,17,0.33,10.48,7,10,7,6,2,0
1,0,0,1,1,1,2,17.92,3,161.32,0.02,15,0.33,8.96,6,9,6,6,2,0
1,0,0,1,1,1,2,17.92,3,161.32,0.02,15,0.33,8.96,6,9,6,6,2,0
1,0,0,1,1,1,2,14.99,3,134.92,0.01,13,0.33,7.5,5,8,5,6,2,0
1,0,0,1,1,1,2,14.99,3,134.92,0.01,13,0.33,7.5,5,8,5,6,2,0
1,0,0,1,1,1,2,14.99,3,134.92,0.01,13,0.33,7.5,5,8,5,6,2,0
1,0,0,1,1,1,2,14.99,3,134.92,0.01,13,0.33,7.5,5,8,5,6,2,0
1,0,0,1,1,1,2,14.99,3,134.92,0.01,13,0.33,7.5,5,8,5,6,2,0
1,0,0,1,1,1,2,17.92,3,161.32,0.02,15,0.33,8.96,6,9,6,6,2,0
1,0,0,1,1,1,2,17.92,3,161.32,0.02,15,0.33,8.96,6,9,6,6,2,0
1,0,0,1,1,1,2,20.97,3,188.72,0.02,17,0.33,10.48,7,10,7,6,2,0
1,0,0,1,1,1,2,20.97,3,188.72,0.02,17,0.33,10.48,7,10,7,6,2,0
1,0,0,1,1,1,1,0,0,0,0,0,0,0,0,0,0,0,1,0
1,0,0,1,1,1,1,0,0,0,0,1,0,0,0,1,0,1,1,0
1,0,0,1,1,1,2,5.33,1.5,12,0,4,0.67,0.67,1,3,1,3,2,0
1,0,0,1,1,1,2,5.33,1.5,12,0,4,0.67,0.67,1,3,1,3,2,0
1,9,0,1,1,1,2,0,0,0,0,9,0,0,9,0,1,0,11,0
1,0,0,1,1,1,1,0,0,0,0,0,0,0,0,0,0,0,1,0
1,0,0,1,1,1,1,0,0,0,0,0,0,0,0,0,0,0,1,0
1,0,0,1,1,1,1,0,0,0,0,1,0,0,0,1,0,1,1,0
1,0,0,1,1,1,4,18.49,2.4,106.51,0.01,14,0.42,5.92,6,8,5,4,4,0
1,0,0,1,1,1,2,5.33,1.5,12,0,4,0.67,0.67,1,3,1,3,2,0
1,0,0,1,1,1,5,8.45,0.75,4.75,0,4,1.33,0.26,3,1,2,1,5,0
1,0,0,1,1,1,1,0,0,0,0,0,0,0,0,0,0,0,1,0
1,0,0,1,1,1,1,0,0,0,0,1,0,0,0,1,0,1,1,0
1,0,0,1,1,1,3,10.8,2.5,67.5,0.01,9,0.4,3.75,3,6,3,5,3,0
1,0,0,1,1,1,2,5.33,1.5,12,0,4,0.67,0.67,1,3,1,3,2,0
1,0,0,1,1,1,2,6.2,2.5,38.77,0.01,6,0.4,2.15,1,5,1,5,2,0
1,0,0,1,1,1,4,9.51,0.5,2.38,0,3,2,0.13,2,1,2,1,4,0
1,0,0,1,1,1,1,0,0,0,0,1,0,0,0,1,0,1,1,0
1,0,0,1,1,1,6,16.68,7.5,938.23,0.04,30,0.13,52.12,12,18,8,10,6,0
1,0,0,1,1,1,2,5.33,1.5,12,0,4,0.67,0.67,1,3,1,3,2,0
1,0,0,1,1,1,2,10.44,3.5,127.89,0.01,11,0.29,7.11,3,8,3,7,2,0
1,0,0,1,1,1,1,0,0,0,0,1,0,0,0,1,0,1,1,0
1,0,0,1,1,1,1,0,0,0,0,1,0,0,0,1,0,1,1,0
1,0,0,1,1,1,1,0,0,0,0,1,0,0,0,1,0,1,1,0
1,0,0,1,1,1,1,0,0,0,0,1,0,0,0,1,0,1,1,0
1,0,0,1,1,1,0,0,0,0,0,1,0,0,0,1,0,1,0,0
1,0,0,1,1,1,2,0,0,0,0,3,0,0,0,3,0,3,2,0
1,0,0,1,1,1,2,0,0,0,0,3,0,0,0,3,0,3,2,0
1,0,0,1,1,1,2,0,0,0,0,3,0,0,0,3,0,3,2,0
1,0,0,1,1,1,2,0,0,0,0,3,0,0,0,3,0,3,2,0
1,0,0,1,1,1,2,0,0,0,0,3,0,0,0,3,0,3,2,0
1,0,0,1,1,1,2,0,0,0,0,3,0,0,0,3,0,3,2,0
1,0,0,1,1,1,2,0,0,0,0,3,0,0,0,3,0,3,2,0
1,0,0,1,1,1,2,0,0,0,0,3,0,0,0,3,0,3,2,0
1,0,0,1,1,1,2,0,0,0,0,3,0,0,0,3,0,3,2,0
1,0,0,1,1,1,2,0,0,0,0,3,0,0,0,3,0,3,2,0
1,0,0,1,1,1,2,0,0,0,0,3,0,0,0,3,0,3,2,0
1,0,0,1,1,1,3,11.63,2,46.53,0.01,9,0.5,2.58,4,5,3,3,3,0
1,0,0,1,1,1,0,5.33,1.5,12,0,4,0.67,0.67,1,3,1,3,0,0
1,0,0,1,1,1,0,5.33,1.5,12,0,4,0.67,0.67,1,3,1,3,0,0
1,0,0,1,1,1,0,5.33,1.5,12,0,4,0.67,0.67,1,3,1,3,0,0
1,0,0,1,1,1,2,0,0,0,0,3,0,0,0,3,0,3,2,0
1,0,0,1,1,1,2,5.33,1.5,12,0,4,0.67,0.67,1,3,1,3,2,0
1,0,0,1,1,1,2,0,0,0,0,3,0,0,0,3,0,3,2,0
1,0,0,1,1,1,2,0,0,0,0,3,0,0,0,3,0,3,2,0
1,0,0,1,1,1,2,0,0,0,0,3,0,0,0,3,0,3,2,0
1,0,0,1,1,1,2,0,0,0,0,3,0,0,0,3,0,3,2,0
1,0,0,1,1,1,2,0,0,0,0,3,0,0,0,3,0,3,2,0
1,0,0,1,1,1,2,0,0,0,0,3,0,0,0,3,0,3,2,0
1,0,0,1,1,1,2,0,0,0,0,3,0,0,0,3,0,3,2,0
1,0,0,1,1,1,2,0,0,0,0,3,0,0,0,3,0,3,2,0
1,0,0,1,1,1,2,0,0,0,0,3,0,0,0,3,0,3,2,0
1,0,0,1,1,1,2,0,0,0,0,3,0,0,0,3,0,3,2,0
1,0,0,1,1,1,2,0,0,0,0,3,0,0,0,3,0,3,2,0
1,0,1,1,1,1,5,12.49,8,799.29,0.03,27,0.13,44.41,10,17,5,8,5,0
1,0,0,1,1,1,0,7.74,1.5,17.41,0,5,0.67,0.97,2,3,2,3,0,0
1,0,0,1,1,1,0,7.74,1.5,17.41,0,5,0.67,0.97,2,3,2,3,0,0
3,0,1,2,2,1,13,34.2,7.33,1838.97,0.08,54,0.14,102.16,22,32,15,10,13,0
1,0,0,1,1,1,0,0,0,0,0,3,0,0,0,3,0,3,0,0
1,0,0,1,1,1,0,5.33,1.5,12,0,4,0.67,0.67,1,3,1,3,0,0
1,0,0,1,1,1,2,0,0,0,0,3,0,0,0,3,0,3,2,0
1,0,0,1,1,1,2,0,0,0,0,3,0,0,0,3,0,3,2,0
1,0,0,1,1,1,2,0,0,0,0,3,0,0,0,3,0,3,2,0
1,0,0,1,1,1,2,0,0,0,0,3,0,0,0,3,0,3,2,0
1,0,0,1,1,1,2,0,0,0,0,3,0,0,0,3,0,3,2,0
1,0,0,1,1,1,2,0,0,0,0,3,0,0,0,3,0,3,2,0
1,0,0,1,1,1,2,0,0,0,0,3,0,0,0,3,0,3,2,0
1,0,0,1,1,1,2,0,0,0,0,3,0,0,0,3,0,3,2,0
1,0,0,1,1,1,2,0,0,0,0,3,0,0,0,3,0,3,2,0
1,0,0,1,1,1,2,0,0,0,0,3,0,0,0,3,0,3,2,0
1,0,0,1,1,1,2,0,0,0,0,3,0,0,0,3,0,3,2,0
1,0,0,1,1,1,0,0,0,0,0,1,0,0,0,1,0,1,0,0
1,0,1,1,1,1,3,5.33,1.5,12,0,4,0.67,0.67,1,3,1,3,3,0
1,0,0,1,1,1,2,5.33,1.5,12,0,4,0.67,0.67,1,3,1,3,2,0
1,0,0,1,1,1,2,5.33,1.5,12,0,4,0.67,0.67,1,3,1,3,2,0
1,0,0,1,1,1,2,5.33,1.5,12,0,4,0.67,0.67,1,3,1,3,2,0
1,0,0,1,1,1,2,5.33,1.5,12,0,4,0.67,0.67,1,3,1,3,2,0
1,0,0,1,1,1,2,5.33,1.5,12,0,4,0.67,0.67,1,3,1,3,2,0
1,0,0,1,1,1,2,5.33,1.5,12,0,4,0.67,0.67,1,3,1,3,2,0
1,0,0,1,1,1,2,5.33,1.5,12,0,4,0.67,0.67,1,3,1,3,2,0
1,0,0,1,1,1,1,0,0,0,0,0,0,0,0,0,0,0,1,0
1,0,0,1,1,1,1,0,0,0,0,1,0,0,0,1,0,1,1,0
1,0,0,1,1,1,2,5.33,1.5,12,0,4,0.67,0.67,1,3,1,3,2,0
1,0,0,1,1,1,2,5.33,1.5,12,0,4,0.67,0.67,1,3,1,3,2,0
1,9,0,1,1,1,2,0,0,0,0,9,0,0,9,0,1,0,11,0
1,0,0,1,1,1,1,0,0,0,0,0,0,0,0,0,0,0,1,0
1,0,0,1,1,1,1,0,0,0,0,0,0,0,0,0,0,0,1,0
1,0,0,1,1,1,1,0,0,0,0,1,0,0,0,1,0,1,1,0
1,0,0,1,1,1,4,18.49,2.4,106.51,0.01,14,0.42,5.92,6,8,5,4,4,0
1,0,0,1,1,1,2,5.33,1.5,12,0,4,0.67,0.67,1,3,1,3,2,0
1,0,0,1,1,1,5,8.45,0.75,4.75,0,4,1.33,0.26,3,1,2,1,5,0
1,0,0,1,1,1,1,0,0,0,0,0,0,0,0,0,0,0,1,0
1,0,0,1,1,1,1,0,0,0,0,1,0,0,0,1,0,1,1,0
1,0,0,1,1,1,3,10.8,2.5,67.5,0.01,9,0.4,3.75,3,6,3,5,3,0
1,0,0,1,1,1,2,5.33,1.5,12,0,4,0.67,0.67,1,3,1,3,2,0
1,0,0,1,1,1,2,6.2,2.5,38.77,0.01,6,0.4,2.15,1,5,1,5,2,0
1,0,0,1,1,1,4,9.51,0.5,2.38,0,3,2,0.13,2,1,2,1,4,0
1,0,0,1,1,1,1,0,0,0,0,1,0,0,0,1,0,1,1,0
1,0,0,1,1,1,1,0,0,0,0,1,0,0,0,1,0,1,1,0
1,0,0,1,1,1,1,0,0,0,0,1,0,0,0,1,0,1,1,0
1,0,0,1,1,1,1,0,0,0,0,1,0,0,0,1,0,1,1,0
1,0,0,1,1,1,1,0,0,0,0,1,0,0,0,1,0,1,1,0
1,0,0,1,1,1,0,0,0,0,0,1,0,0,0,1,0,1,0,0
1,0,0,1,1,1,2,0,0,0,0,3,0,0,0,3,0,3,2,0
1,0,0,1,1,1,2,0,0,0,0,3,0,0,0,3,0,3,2,0
1,0,0,1,1,1,2,0,0,0,0,3,0,0,0,3,0,3,2,0
1,0,0,1,1,1,2,0,0,0,0,3,0,0,0,3,0,3,2,0
1,0,0,1,1,1,2,0,0,0,0,3,0,0,0,3,0,3,2,0
1,0,0,1,1,1,2,0,0,0,0,3,0,0,0,3,0,3,2,0
1,0,0,1,1,1,2,0,0,0,0,3,0,0,0,3,0,3,2,0
1,0,0,1,1,1,2,0,0,0,0,3,0,0,0,3,0,3,2,0
1,0,0,1,1,1,2,0,0,0,0,3,0,0,0,3,0,3,2,0
1,0,0,1,1,1,2,0,0,0,0,3,0,0,0,3,0,3,2,0
1,0,0,1,1,1,2,0,0,0,0,3,0,0,0,3,0,3,2,0
1,0,0,1,1,1,3,11.63,2,46.53,0.01,9,0.5,2.58,4,5,3,3,3,0
1,0,0,1,1,1,0,5.33,1.5,12,0,4,0.67,0.67,1,3,1,3,0,0
1,0,0,1,1,1,0,5.33,1.5,12,0,4,0.67,0.67,1,3,1,3,0,0
1,0,0,1,1,1,0,5.33,1.5,12,0,4,0.67,0.67,1,3,1,3,0,0
1,0,0,1,1,1,2,0,0,0,0,3,0,0,0,3,0,3,2,0
1,0,0,1,1,1,2,5.33,1.5,12,0,4,0.67,0.67,1,3,1,3,2,0
1,0,0,1,1,1,2,0,0,0,0,3,0,0,0,3,0,3,2,0
1,0,0,1,1,1,2,0,0,0,0,3,0,0,0,3,0,3,2,0
1,0,0,1,1,1,2,0,0,0,0,3,0,0,0,3,0,3,2,0
1,0,0,1,1,1,2,0,0,0,0,3,0,0,0,3,0,3,2,0
1,0,0,1,1,1,2,0,0,0,0,3,0,0,0,3,0,3,2,0
1,0,0,1,1,1,2,0,0,0,0,3,0,0,0,3,0,3,2,0
1,0,0,1,1,1,2,0,0,0,0,3,0,0,0,3,0,3,2,0
1,0,0,1,1,1,2,0,0,0,0,3,0,0,0,3,0,3,2,0
1,0,0,1,1,1,2,0,0,0,0,3,0,0,0,3,0,3,2,0
1,0,0,1,1,1,2,0,0,0,0,3,0,0,0,3,0,3,2,0
1,0,0,1,1,1,2,0,0,0,0,3,0,0,0,3,0,3,2,0
1,0,2,1,1,1,5,12.49,8,799.29,0.03,27,0.13,44.41,10,17,5,8,5,0
1,0,0,1,1,1,0,7.74,1.5,17.41,0,5,0.67,0.97,2,3,2,3,0,0
1,0,0,1,1,1,0,7.74,1.5,17.41,0,5,0.67,0.97,2,3,2,3,0,0
3,0,1,2,2,1,13,34.2,7.33,1838.97,0.08,54,0.14,102.16,22,32,15,10,13,0
1,0,0,1,1,1,0,0,0,0,0,3,0,0,0,3,0,3,0,0
1,0,0,1,1,1,0,5.33,1.5,12,0,4,0.67,0.67,1,3,1,3,0,0
1,0,0,1,1,1,2,0,0,0,0,3,0,0,0,3,0,3,2,0
1,0,0,1,1,1,2,0,0,0,0,3,0,0,0,3,0,3,2,0
1,0,0,1,1,1,2,0,0,0,0,3,0,0,0,3,0,3,2,0
1,0,0,1,1,1,2,0,0,0,0,3,0,0,0,3,0,3,2,0
1,0,0,1,1,1,2,0,0,0,0,3,0,0,0,3,0,3,2,0
1,0,0,1,1,1,2,0,0,0,0,3,0,0,0,3,0,3,2,0
1,0,0,1,1,1,2,0,0,0,0,3,0,0,0,3,0,3,2,0
1,0,0,1,1,1,2,0,0,0,0,3,0,0,0,3,0,3,2,0
1,0,0,1,1,1,2,0,0,0,0,3,0,0,0,3,0,3,2,0
1,0,0,1,1,1,2,0,0,0,0,3,0,0,0,3,0,3,2,0
1,0,0,1,1,1,2,0,0,0,0,3,0,0,0,3,0,3,2,0
1,0,0,1,1,1,0,0,0,0,0,1,0,0,0,1,0,1,0,0
1,0,1,1,1,1,3,5.33,1.5,12,0,4,0.67,0.67,1,3,1,3,3,0
1,0,0,1,1,1,2,5.33,1.5,12,0,4,0.67,0.67,1,3,1,3,2,0
1,0,0,1,1,1,2,5.33,1.5,12,0,4,0.67,0.67,1,3,1,3,2,0
1,0,0,1,1,1,2,5.33,1.5,12,0,4,0.67,0.67,1,3,1,3,2,0
1,0,0,1,1,1,2,5.33,1.5,12,0,4,0.67,0.67,1,3,1,3,2,0
1,0,0,1,1,1,2,5.33,1.5,12,0,4,0.67,0.67,1,3,1,3,2,0
1,0,0,1,1,1,2,5.33,1.5,12,0,4,0.67,0.67,1,3,1,3,2,0
1,0,0,1,1,1,2,5.33,1.5,12,0,4,0.67,0.67,1,3,1,3,2,0
1,0,0,1,1,1,1,0,0,0,0,0,0,0,0,0,0,0,1,0
1,0,0,1,1,1,1,0,0,0,0,1,0,0,0,1,0,1,1,0
1,0,0,1,1,1,2,5.33,1.5,12,0,4,0.67,0.67,1,3,1,3,2,0
1,0,0,1,1,1,2,5.33,1.5,12,0,4,0.67,0.67,1,3,1,3,2,0
1,9,0,1,1,1,2,0,0,0,0,9,0,0,9,0,1,0,11,0
1,0,0,1,1,1,1,0,0,0,0,0,0,0,0,0,0,0,1,0
1,0,0,1,1,1,1,0,0,0,0,0,0,0,0,0,0,0,1,0
1,0,0,1,1,1,1,0,0,0,0,1,0,0,0,1,0,1,1,0
1,0,0,1,1,1,4,18.49,2.4,106.51,0.01,14,0.42,5.92,6,8,5,4,4,0
1,0,0,1,1,1,2,5.33,1.5,12,0,4,0.67,0.67,1,3,1,3,2,0
1,0,0,1,1,1,5,8.45,0.75,4.75,0,4,1.33,0.26,3,1,2,1,5,0
1,0,0,1,1,1,1,0,0,0,0,0,0,0,0,0,0,0,1,0
1,0,0,1,1,1,1,0,0,0,0,1,0,0,0,1,0,1,1,0
1,0,0,1,1,1,3,10.8,2.5,67.5,0.01,9,0.4,3.75,3,6,3,5,3,0
1,0,0,1,1,1,2,5.33,1.5,12,0,4,0.67,0.67,1,3,1,3,2,0
1,0,0,1,1,1,2,6.2,2.5,38.77,0.01,6,0.4,2.15,1,5,1,5,2,0
1,0,0,1,1,1,4,9.51,0.5,2.38,0,3,2,0.13,2,1,2,1,4,0
1,0,0,1,1,1,1,0,0,0,0,1,0,0,0,1,0,1,1,0
1,0,0,1,1,1,1,0,0,0,0,1,0,0,0,1,0,1,1,0
1,0,0,1,1,1,1,0,0,0,0,1,0,0,0,1,0,1,1,0
1,0,0,1,1,1,1,0,0,0,0,1,0,0,0,1,0,1,1,0
1,0,0,1,1,1,1,0,0,0,0,1,0,0,0,1,0,1,1,0
1,0,0,1,1,1,1,0,0,0,0,1,0,0,0,1,0,1,1,0
1,0,0,1,1,1,1,0,0,0,0,1,0,0,0,1,0,1,1,0
5,0,0,3,1,1,2,13.29,4.5,269.08,0.02,18,0.22,14.95,6,12,4,6,2,0
1,0,1,1,1,1,2,16.92,3.5,207.22,0.02,16,0.29,11.51,6,10,6,7,2,0
1,0,0,1,1,1,0,0,0,0,0,1,0,0,0,1,0,1,0,0
1,0,0,1,1,1,2,0,0,0,0,3,0,0,0,3,0,3,2,0
1,0,0,1,1,1,2,0,0,0,0,3,0,0,0,3,0,3,2,0
1,0,0,1,1,1,2,0,0,0,0,3,0,0,0,3,0,3,2,0
1,0,0,1,1,1,2,0,0,0,0,3,0,0,0,3,0,3,2,0
1,0,0,1,1,1,2,0,0,0,0,3,0,0,0,3,0,3,2,0
1,0,0,1,1,1,2,0,0,0,0,3,0,0,0,3,0,3,2,0
1,0,0,1,1,1,2,0,0,0,0,3,0,0,0,3,0,3,2,0
1,0,0,1,1,1,2,0,0,0,0,3,0,0,0,3,0,3,2,0
1,0,0,1,1,1,2,0,0,0,0,3,0,0,0,3,0,3,2,0
1,0,0,1,1,1,2,0,0,0,0,3,0,0,0,3,0,3,2,0
1,0,0,1,1,1,2,0,0,0,0,3,0,0,0,3,0,3,2,0
1,0,0,1,1,1,3,11.63,2,46.53,0.01,9,0.5,2.58,4,5,3,3,3,0
1,0,0,1,1,1,0,5.33,1.5,12,0,4,0.67,0.67,1,3,1,3,0,0
1,0,0,1,1,1,0,5.33,1.5,12,0,4,0.67,0.67,1,3,1,3,0,0
1,0,0,1,1,1,0,5.33,1.5,12,0,4,0.67,0.67,1,3,1,3,0,0
1,0,0,1,1,1,2,0,0,0,0,3,0,0,0,3,0,3,2,0
1,0,0,1,1,1,2,5.33,1.5,12,0,4,0.67,0.67,1,3,1,3,2,0
1,0,0,1,1,1,2,0,0,0,0,3,0,0,0,3,0,3,2,0
1,0,0,1,1,1,2,0,0,0,0,3,0,0,0,3,0,3,2,0
1,0,0,1,1,1,2,0,0,0,0,3,0,0,0,3,0,3,2,0
1,0,0,1,1,1,2,0,0,0,0,3,0,0,0,3,0,3,2,0
1,0,0,1,1,1,2,0,0,0,0,3,0,0,0,3,0,3,2,0
1,0,0,1,1,1,2,0,0,0,0,3,0,0,0,3,0,3,2,0
1,0,0,1,1,1,2,0,0,0,0,3,0,0,0,3,0,3,2,0
1,0,0,1,1,1,2,0,0,0,0,3,0,0,0,3,0,3,2,0
1,0,0,1,1,1,2,0,0,0,0,3,0,0,0,3,0,3,2,0
1,0,0,1,1,1,2,0,0,0,0,3,0,0,0,3,0,3,2,0
1,0,0,1,1,1,2,0,0,0,0,3,0,0,0,3,0,3,2,0
1,0,0,1,1,1,0,7.74,1.5,17.41,0,5,0.67,0.97,2,3,2,3,0,0
1,0,0,1,1,1,0,7.74,1.5,17.41,0,5,0.67,0.97,2,3,2,3,0,0
1,0,0,1,1,1,0,0,0,0,0,3,0,0,0,3,0,3,0,0
1,0,0,1,1,1,0,5.33,1.5,12,0,4,0.67,0.67,1,3,1,3,0,0
1,0,0,1,1,1,2,0,0,0,0,3,0,0,0,3,0,3,2,0
1,0,0,1,1,1,2,0,0,0,0,3,0,0,0,3,0,3,2,0
1,0,0,1,1,1,2,0,0,0,0,3,0,0,0,3,0,3,2,0
1,0,0,1,1,1,2,0,0,0,0,3,0,0,0,3,0,3,2,0
1,0,0,1,1,1,2,0,0,0,0,3,0,0,0,3,0,3,2,0
1,0,0,1,1,1,2,0,0,0,0,3,0,0,0,3,0,3,2,0
1,0,0,1,1,1,2,0,0,0,0,3,0,0,0,3,0,3,2,0
1,0,0,1,1,1,2,0,0,0,0,3,0,0,0,3,0,3,2,0
1,0,0,1,1,1,2,0,0,0,0,3,0,0,0,3,0,3,2,0
1,0,0,1,1,1,2,0,0,0,0,3,0,0,0,3,0,3,2,0
1,0,0,1,1,1,2,0,0,0,0,3,0,0,0,3,0,3,2,0
3,0,0,2,2,1,11,19.29,8,1234.3,0.05,37,0.13,68.57,16,21,9,9,11,0
1,0,0,1,1,1,0,0,0,0,0,1,0,0,0,1,0,1,0,0
5,0,0,3,1,3,9,9.87,7.88,611.96,0.03,21,0.13,34,7,14,4,9,9,0
5,0,0,3,1,3,9,10.85,9,879.05,0.03,25,0.11,48.84,9,16,5,10,9,0
1,0,0,1,1,1,0,5.33,1.5,12,0,4,0.67,0.67,1,3,1,3,0,0
3,0,0,2,2,1,12,28.99,6.92,1389.28,0.07,45,0.14,77.18,20,25,13,9,12,0
3,0,0,2,2,1,12,26.51,7.13,1345.7,0.06,43,0.14,74.76,19,24,12,9,12,0
1,0,0,1,1,1,2,5.33,1.5,12,0,4,0.67,0.67,1,3,1,3,2,0
1,0,0,1,1,1,2,5.33,1.5,12,0,4,0.67,0.67,1,3,1,3,2,0
1,0,0,1,1,1,2,5.33,1.5,12,0,4,0.67,0.67,1,3,1,3,2,0
1,0,0,1,1,1,2,5.33,1.5,12,0,4,0.67,0.67,1,3,1,3,2,0
1,0,0,1,1,1,2,5.33,1.5,12,0,4,0.67,0.67,1,3,1,3,2,0
1,0,0,1,1,1,2,5.33,1.5,12,0,4,0.67,0.67,1,3,1,3,2,0
1,0,0,1,1,1,2,5.33,1.5,12,0,4,0.67,0.67,1,3,1,3,2,0
1,0,0,1,1,1,2,5.33,1.5,12,0,4,0.67,0.67,1,3,1,3,2,0
1,0,0,1,1,1,2,5.33,1.5,12,0,4,0.67,0.67,1,3,1,3,2,0
1,0,0,1,1,1,2,13.88,4,222.03,0.02,15,0.25,12.33,5,10,5,8,2,0
1,0,0,1,1,1,2,0,0,0,0,4,0,0,0,4,0,4,2,0
1,0,0,1,1,1,1,0,0,0,0,1,0,0,0,1,0,1,1,0
1,0,0,1,1,1,0,0,0,0,0,1,0,0,0,1,0,1,0,0
1,0,0,1,1,1,2,0,0,0,0.01,6,0,0,0,6,0,6,2,0
1,0,0,1,1,1,2,0,0,0,0,5,0,0,0,5,0,5,2,0
1,0,0,1,1,1,0,0,0,0,0,1,0,0,0,1,0,1,0,0
1,1,0,1,1,1,1,6.2,2.5,38.77,0.01,6,0.4,2.15,1,5,1,5,2,0
1,0,0,1,1,1,2,5.33,1.5,12,0,4,0.67,0.67,1,3,1,3,2,0
1,0,1,1,1,1,2,5.33,1.5,12,0,4,0.67,0.67,1,3,1,3,2,0
1,0,0,1,1,1,1,0,0,0,0,0,0,0,0,0,0,0,1,0
1,0,0,1,1,1,1,0,0,0,0,1,0,0,0,1,0,1,1,0
1,0,0,1,1,1,2,5.33,1.5,12,0,4,0.67,0.67,1,3,1,3,2,0
1,0,0,1,1,1,2,5.33,1.5,12,0,4,0.67,0.67,1,3,1,3,2,0
1,9,0,1,1,1,2,0,0,0,0,9,0,0,9,0,1,0,11,0
1,0,0,1,1,1,1,0,0,0,0,0,0,0,0,0,0,0,1,0
1,0,0,1,1,1,1,0,0,0,0,0,0,0,0,0,0,0,1,0
1,0,0,1,1,1,1,0,0,0,0,1,0,0,0,1,0,1,1,0
1,0,0,1,1,1,4,18.49,2.4,106.51,0.01,14,0.42,5.92,6,8,5,4,4,0
1,0,0,1,1,1,2,5.33,1.5,12,0,4,0.67,0.67,1,3,1,3,2,0
1,0,0,1,1,1,5,8.45,0.75,4.75,0,4,1.33,0.26,3,1,2,1,5,0
1,0,0,1,1,1,1,0,0,0,0,0,0,0,0,0,0,0,1,0
1,0,0,1,1,1,1,0,0,0,0,1,0,0,0,1,0,1,1,0
1,0,0,1,1,1,3,10.8,2.5,67.5,0.01,9,0.4,3.75,3,6,3,5,3,0
1,0,0,1,1,1,2,5.33,1.5,12,0,4,0.67,0.67,1,3,1,3,2,0
1,0,0,1,1,1,2,6.2,2.5,38.77,0.01,6,0.4,2.15,1,5,1,5,2,0
1,0,0,1,1,1,4,9.51,0.5,2.38,0,3,2,0.13,2,1,2,1,4,0
1,0,0,1,1,1,1,0,0,0,0,1,0,0,0,1,0,1,1,0
1,0,0,1,1,1,2,5.33,1.5,12,0,4,0.67,0.67,1,3,1,3,2,0
1,0,0,1,1,1,2,5.33,1.5,12,0,4,0.67,0.67,1,3,1,3,2,0
1,0,0,1,1,1,2,0,0,0,0,4,0,0,0,4,0,4,2,0
1,0,0,1,1,1,1,0,0,0,0,1,0,0,0,1,0,1,1,0
1,0,0,1,1,1,2,0,0,0,0,5,0,0,0,5,0,5,2,0
1,0,0,1,1,1,1,0,0,0,0,1,0,0,0,1,0,1,1,0
1,0,0,1,1,1,2,5.33,1.5,12,0,4,0.67,0.67,1,3,1,3,2,0
1,0,0,1,1,1,2,5.33,1.5,12,0,4,0.67,0.67,1,3,1,3,2,0
1,0,0,1,1,1,1,0,0,0,0,1,0,0,0,1,0,1,1,0
1,0,0,1,1,1,0,0,0,0,0,1,0,0,0,1,0,1,0,0
1,0,0,1,1,1,0,0,0,0,0,1,0,0,0,1,0,1,0,0
1,0,0,1,1,1,0,0,0,0,0,1,0,0,0,1,0,1,0,0
1,0,0,1,1,1,0,0,0,0,0,1,0,0,0,1,0,1,0,0
9,3,0,5,5,4,4,6.95,27.62,5307.06,0.06,47,0.04,294.84,17,30,4,13,7,0
9,3,0,5,5,4,4,6.95,27.62,5307.06,0.06,47,0.04,294.84,17,30,4,13,7,0
1,0,0,1,1,1,2,13.18,5.25,363.24,0.02,20,0.19,20.18,6,14,4,7,2,0
1,0,0,1,1,1,2,13.18,5.25,363.24,0.02,20,0.19,20.18,6,14,4,7,2,0
1,0,0,1,1,1,2,5.33,1.5,12,0,4,0.67,0.67,1,3,1,3,2,0
1,0,0,1,1,1,2,5.33,1.5,12,0,4,0.67,0.67,1,3,1,3,2,0
1,0,0,1,1,1,2,5.33,1.5,12,0,4,0.67,0.67,1,3,1,3,2,0
1,0,0,1,1,1,2,5.33,1.5,12,0,4,0.67,0.67,1,3,1,3,2,0
1,0,0,1,1,1,2,5.33,1.5,12,0,4,0.67,0.67,1,3,1,3,2,0
1,0,0,1,1,1,2,5.33,1.5,12,0,4,0.67,0.67,1,3,1,3,2,0
1,0,0,1,1,1,2,11.3,6.13,423.78,0.02,20,0.16,23.54,7,13,4,7,2,0
1,0,0,1,1,1,2,11.3,6.13,423.78,0.02,20,0.16,23.54,7,13,4,7,2,0
1,0,0,1,1,1,0,0,0,0,0,1,0,0,0,1,0,1,0,0
1,0,0,1,1,1,0,0,0,0,0,1,0,0,0,1,0,1,0,0
17,1,8,9,1,9,17,31.41,9.43,2792.06,0.1,63,0.11,155.11,22,41,14,12,18,0
17,1,8,9,1,9,17,31.41,9.43,2792.06,0.1,63,0.11,155.11,22,41,14,12,18,0
5,0,4,3,2,1,23,28.31,9,2292.79,0.08,58,0.11,127.38,24,34,12,9,23,0
5,0,4,3,2,1,23,28.31,9,2292.79,0.08,58,0.11,127.38,24,34,12,9,23,0
9,0,2,5,1,1,22,24.26,11.05,2959.73,0.09,62,0.09,164.43,27,35,11,9,22,0
9,0,2,5,1,1,22,24.26,11.05,2959.73,0.09,62,0.09,164.43,27,35,11,9,22,0
11,0,7,6,2,5,15,25.38,10.68,2894.2,0.09,57,0.09,160.79,23,34,14,13,15,0
11,0,7,6,2,5,15,25.38,10.68,2894.2,0.09,57,0.09,160.79,23,34,14,13,15,0
5,2,13,3,1,1,19,25.01,10.71,2870.63,0.09,57,0.09,159.48,25,32,14,12,21,0
5,2,13,3,1,1,19,25.01,10.71,2870.63,0.09,57,0.09,159.48,25,32,14,12,21,0
1,0,0,1,1,1,6,10.8,2.5,67.5,0.01,9,0.4,3.75,5,4,4,4,6,0
1,0,0,1,1,1,6,10.8,2.5,67.5,0.01,9,0.4,3.75,5,4,4,4,6,0
1,0,0,1,1,1,2,7.74,1.5,17.41,0,5,0.67,0.97,2,3,2,3,2,0
1,0,0,1,1,1,2,7.74,1.5,17.41,0,5,0.67,0.97,2,3,2,3,2,0
1,0,0,1,1,1,2,7.74,1.5,17.41,0,5,0.67,0.97,2,3,2,3,2,0
1,0,0,1,1,1,2,7.74,1.5,17.41,0,5,0.67,0.97,2,3,2,3,2,0
1,0,0,1,1,1,2,7.74,1.5,17.41,0,5,0.67,0.97,2,3,2,3,2,0
1,0,0,1,1,1,2,7.74,1.5,17.41,0,5,0.67,0.97,2,3,2,3,2,0
1,0,0,1,1,1,0,0,0,0,0,1,0,0,0,1,0,1,0,0
1,0,0,1,1,1,0,0,0,0,0,1,0,0,0,1,0,1,0,0
1,0,0,1,1,1,2,5.33,1.5,12,0,4,0.67,0.67,1,3,1,3,2,0
1,0,0,1,1,1,2,5.33,1.5,12,0,4,0.67,0.67,1,3,1,3,2,0
1,0,0,1,1,1,0,0,0,0,0,1,0,0,0,1,0,1,0,0
1,0,0,1,1,1,0,0,0,0,0,1,0,0,0,1,0,1,0,0
1,0,0,1,1,1,2,5.33,1.5,12,0,4,0.67,0.67,1,3,1,3,2,0
1,0,0,1,1,1,2,5.33,1.5,12,0,4,0.67,0.67,1,3,1,3,2,0
1,0,0,1,1,1,0,0,0,0,0,1,0,0,0,1,0,1,0,0
1,0,0,1,1,1,0,0,0,0,0,1,0,0,0,1,0,1,0,0
1,0,0,1,1,1,0,0,0,0,0,1,0,0,0,1,0,1,0,0
1,0,0,1,1,1,0,0,0,0,0,1,0,0,0,1,0,1,0,0
1,0,0,1,1,1,0,0,0,0,0,1,0,0,0,1,0,1,0,0
1,0,0,1,1,1,0,0,0,0,0,1,0,0,0,1,0,1,0,0
1,0,0,1,1,1,2,5.33,1.5,12,0,4,0.67,0.67,1,3,1,3,2,0
1,0,0,1,1,1,2,5.33,1.5,12,0,4,0.67,0.67,1,3,1,3,2,0
1,0,0,1,1,1,2,5.33,1.5,12,0,4,0.67,0.67,1,3,1,3,2,0
1,0,0,1,1,1,2,5.33,1.5,12,0,4,0.67,0.67,1,3,1,3,2,0
1,0,0,1,1,1,2,5.33,1.5,12,0,4,0.67,0.67,1,3,1,3,2,0
1,0,0,1,1,1,2,5.33,1.5,12,0,4,0.67,0.67,1,3,1,3,2,0
1,0,0,1,1,1,2,5.33,1.5,12,0,4,0.67,0.67,1,3,1,3,2,0
1,0,0,1,1,1,2,5.33,1.5,12,0,4,0.67,0.67,1,3,1,3,2,0
1,0,0,1,1,1,2,5.33,1.5,12,0,4,0.67,0.67,1,3,1,3,2,0
1,0,0,1,1,1,2,5.33,1.5,12,0,4,0.67,0.67,1,3,1,3,2,0
1,0,0,1,1,1,2,5.33,1.5,12,0,4,0.67,0.67,1,3,1,3,2,0
1,0,0,1,1,1,2,5.33,1.5,12,0,4,0.67,0.67,1,3,1,3,2,0
1,0,0,1,1,1,2,5.33,1.5,12,0,4,0.67,0.67,1,3,1,3,2,0
1,0,0,1,1,1,2,5.33,1.5,12,0,4,0.67,0.67,1,3,1,3,2,0
1,0,0,1,1,1,2,5.33,1.5,12,0,4,0.67,0.67,1,3,1,3,2,0
1,0,0,1,1,1,2,5.33,1.5,12,0,4,0.67,0.67,1,3,1,3,2,0
1,0,0,1,1,1,2,5.33,1.5,12,0,4,0.67,0.67,1,3,1,3,2,0
1,0,0,1,1,1,2,5.33,1.5,12,0,4,0.67,0.67,1,3,1,3,2,0
1,0,0,1,1,1,2,5.33,1.5,12,0,4,0.67,0.67,1,3,1,3,2,0
1,0,0,1,1,1,2,5.33,1.5,12,0,4,0.67,0.67,1,3,1,3,2,0
1,0,0,1,1,1,2,5.33,1.5,12,0,4,0.67,0.67,1,3,1,3,2,0
1,0,0,1,1,1,2,5.33,1.5,12,0,4,0.67,0.67,1,3,1,3,2,0
1,0,0,1,1,1,2,5.33,1.5,12,0,4,0.67,0.67,1,3,1,3,2,0
1,0,0,1,1,1,2,5.33,1.5,12,0,4,0.67,0.67,1,3,1,3,2,0
1,0,0,1,1,1,2,7.74,1.5,17.41,0,5,0.67,0.97,2,3,2,3,2,0
1,0,0,1,1,1,2,7.74,1.5,17.41,0,5,0.67,0.97,2,3,2,3,2,0
1,0,0,1,1,1,2,7.74,1.5,17.41,0,5,0.67,0.97,2,3,2,3,2,0
1,0,0,1,1,1,2,7.74,1.5,17.41,0,5,0.67,0.97,2,3,2,3,2,0
1,0,0,1,1,1,2,7.74,1.5,17.41,0,5,0.67,0.97,2,3,2,3,2,0
1,0,0,1,1,1,2,7.74,1.5,17.41,0,5,0.67,0.97,2,3,2,3,2,0
1,0,0,1,1,1,2,7.74,1.5,17.41,0,5,0.67,0.97,2,3,2,3,2,0
1,0,0,1,1,1,2,7.74,1.5,17.41,0,5,0.67,0.97,2,3,2,3,2,0
1,0,0,1,1,1,2,7.74,1.5,17.41,0,5,0.67,0.97,2,3,2,3,2,0
1,0,0,1,1,1,2,7.74,1.5,17.41,0,5,0.67,0.97,2,3,2,3,2,0
1,0,0,1,1,1,2,7.74,1.5,17.41,0,5,0.67,0.97,2,3,2,3,2,0
1,0,0,1,1,1,2,7.74,1.5,17.41,0,5,0.67,0.97,2,3,2,3,2,0
1,0,0,1,1,1,2,7.74,1.5,17.41,0,5,0.67,0.97,2,3,2,3,2,0
1,0,0,1,1,1,2,7.74,1.5,17.41,0,5,0.67,0.97,2,3,2,3,2,0
1,0,0,1,1,1,0,0,0,0,0,0,0,0,0,0,0,0,0,0
1,0,0,1,1,1,0,0,0,0,0,0,0,0,0,0,0,0,0,0
1,0,0,1,1,1,2,7.74,1.5,17.41,0,5,0.67,0.97,2,3,2,3,2,0
1,0,0,1,1,1,2,7.74,1.5,17.41,0,5,0.67,0.97,2,3,2,3,2,0
1,0,0,1,1,1,0,0,0,0,0,0,0,0,0,0,0,0,0,0
1,0,0,1,1,1,0,0,0,0,0,0,0,0,0,0,0,0,0,0
1,0,0,1,1,1,0,0,0,0,0,1,0,0,0,1,0,1,0,0
1,0,0,1,1,1,0,0,0,0,0,1,0,0,0,1,0,1,0,0
1,0,0,1,1,1,2,5.33,1.5,12,0,4,0.67,0.67,1,3,1,3,2,0
1,0,0,1,1,1,2,5.33,1.5,12,0,4,0.67,0.67,1,3,1,3,2,0
1,0,0,1,1,1,2,5.33,1.5,12,0,4,0.67,0.67,1,3,1,3,2,0
1,0,0,1,1,1,2,5.33,1.5,12,0,4,0.67,0.67,1,3,1,3,2,0
1,0,0,1,1,1,2,5.33,1.5,12,0,4,0.67,0.67,1,3,1,3,2,0
1,0,0,1,1,1,2,5.33,1.5,12,0,4,0.67,0.67,1,3,1,3,2,0
1,0,0,1,1,1,2,7.74,1.5,17.41,0,5,0.67,0.97,2,3,2,3,2,0
1,0,0,1,1,1,2,7.74,1.5,17.41,0,5,0.67,0.97,2,3,2,3,2,0
1,0,0,1,1,1,2,7.74,1.5,17.41,0,5,0.67,0.97,2,3,2,3,2,0
1,0,0,1,1,1,2,7.74,1.5,17.41,0,5,0.67,0.97,2,3,2,3,2,0
1,0,0,1,1,1,2,7.74,1.5,17.41,0,5,0.67,0.97,2,3,2,3,2,0
1,0,0,1,1,1,2,7.74,1.5,17.41,0,5,0.67,0.97,2,3,2,3,2,0
1,0,0,1,1,1,0,0,0,0,0,1,0,0,0,1,0,1,0,0
1,0,0,1,1,1,0,0,0,0,0,1,0,0,0,1,0,1,0,0
1,0,0,1,1,1,2,5.33,1.5,12,0,4,0.67,0.67,1,3,1,3,2,0
1,0,0,1,1,1,2,5.33,1.5,12,0,4,0.67,0.67,1,3,1,3,2,0
1,0,0,1,1,1,2,5.33,1.5,12,0,4,0.67,0.67,1,3,1,3,2,0
1,0,0,1,1,1,2,5.33,1.5,12,0,4,0.67,0.67,1,3,1,3,2,0
1,0,0,1,1,1,2,5.33,1.5,12,0,4,0.67,0.67,1,3,1,3,2,0
1,0,0,1,1,1,2,5.33,1.5,12,0,4,0.67,0.67,1,3,1,3,2,0
1,0,0,1,1,1,2,5.33,1.5,12,0,4,0.67,0.67,1,3,1,3,2,0
1,0,0,1,1,1,2,5.33,1.5,12,0,4,0.67,0.67,1,3,1,3,2,0
1,0,0,1,1,1,2,5.33,1.5,12,0,4,0.67,0.67,1,3,1,3,2,0
1,0,0,1,1,1,2,5.33,1.5,12,0,4,0.67,0.67,1,3,1,3,2,0
1,0,0,1,1,1,2,5.33,1.5,12,0,4,0.67,0.67,1,3,1,3,2,0
1,0,0,1,1,1,2,5.33,1.5,12,0,4,0.67,0.67,1,3,1,3,2,0
1,0,0,1,1,1,14,43.7,5.14,1155.81,0.07,52,0.19,64.2,24,28,14,6,14,1
1,0,0,1,1,1,2,5.33,1.5,12,0,4,0.67,0.67,1,3,1,3,2,0
1,1,0,1,1,1,12,55.45,3.54,694.24,0.07,48,0.28,38.57,23,25,13,4,13,0
1,0,0,1,1,1,0,0,0,0,0,0,0,0,0,0,0,0,0,0
1,0,0,1,1,1,0,0,0,0,0,1,0,0,0,1,0,1,0,0
1,0,0,1,1,1,0,0,0,0,0,1,0,0,0,1,0,1,0,0
9,3,0,5,5,4,4,6.95,27.62,5307.06,0.06,47,0.04,294.84,17,30,4,13,7,0
1,0,0,1,1,1,2,13.18,5.25,363.24,0.02,20,0.19,20.18,6,14,4,7,2,0
1,0,0,1,1,1,2,5.33,1.5,12,0,4,0.67,0.67,1,3,1,3,2,0
1,0,0,1,1,1,2,5.33,1.5,12,0,4,0.67,0.67,1,3,1,3,2,0
1,0,0,1,1,1,2,5.33,1.5,12,0,4,0.67,0.67,1,3,1,3,2,0
1,0,0,1,1,1,4,27.47,1.5,61.81,0.01,13,0.67,3.43,6,7,6,3,4,0
1,0,0,1,1,1,2,11.3,6.13,423.78,0.02,20,0.16,23.54,7,13,4,7,2,0
1,0,0,1,1,1,0,0,0,0,0,1,0,0,0,1,0,1,0,0
1,0,0,1,1,1,2,7.74,1.5,17.41,0,5,0.67,0.97,2,3,2,3,2,0
1,0,0,1,1,1,2,7.74,1.5,17.41,0,5,0.67,0.97,2,3,2,3,2,0
1,0,0,1,1,1,0,0,0,0,0,1,0,0,0,1,0,1,0,0
1,0,0,1,1,1,2,5.33,1.5,12,0,4,0.67,0.67,1,3,1,3,2,0
1,0,0,1,1,1,2,5.33,1.5,12,0,4,0.67,0.67,1,3,1,3,2,0
1,0,0,1,1,1,2,5.33,1.5,12,0,4,0.67,0.67,1,3,1,3,2,0
1,0,0,1,1,1,2,5.33,1.5,12,0,4,0.67,0.67,1,3,1,3,2,0
1,0,0,1,1,1,2,5.33,1.5,12,0,4,0.67,0.67,1,3,1,3,2,0
1,0,0,1,1,1,2,5.33,1.5,12,0,4,0.67,0.67,1,3,1,3,2,0
1,0,0,1,1,1,2,5.33,1.5,12,0,4,0.67,0.67,1,3,1,3,2,0
1,0,0,1,1,1,2,5.33,1.5,12,0,4,0.67,0.67,1,3,1,3,2,0
1,0,0,1,1,1,2,5.33,1.5,12,0,4,0.67,0.67,1,3,1,3,2,0
1,0,0,1,1,1,2,5.33,1.5,12,0,4,0.67,0.67,1,3,1,3,2,0
1,0,0,1,1,1,2,5.33,1.5,12,0,4,0.67,0.67,1,3,1,3,2,0
1,0,0,1,1,1,2,5.33,1.5,12,0,4,0.67,0.67,1,3,1,3,2,0
1,0,0,1,1,1,2,5.33,1.5,12,0,4,0.67,0.67,1,3,1,3,2,0
1,1,0,1,1,1,12,55.45,3.54,694.24,0.07,48,0.28,38.57,23,25,13,4,13,0
1,0,0,1,1,1,0,0,0,0,0,1,0,0,0,1,0,1,0,0
13,1,11,7,4,6,14,22.81,10.96,2740.19,0.08,52,0.09,152.23,19,33,13,15,15,0
1,0,0,1,1,1,2,6.2,2.5,38.77,0.01,6,0.4,2.15,1,5,1,5,2,0
13,1,7,7,3,7,14,20.82,11.88,2936.14,0.08,52,0.08,163.12,19,33,12,15,15,0
15,1,10,8,4,6,18,22.46,13.27,3954.97,0.1,62,0.08,219.72,23,39,13,15,19,0
3,2,1,2,2,1,9,15.71,5.33,446.73,0.03,22,0.19,24.82,8,14,6,8,11,0
1,0,0,1,1,1,2,5.33,1.5,12,0,4,0.67,0.67,1,3,1,3,2,0
5,0,3,3,1,1,11,9.88,8.75,756.75,0.03,25,0.11,42.04,10,15,4,7,11,0
39,4,12,20,1,19,43,57.81,14.27,11770.67,0.27,155,0.07,653.93,53,102,26,14,47,0
61,9,45,31,15,25,164,101.2,27.68,77541.6,0.93,447,0.04,4307.87,169,278,58,19,173,0
9,0,1,5,1,1,23,19.58,11.5,2589.52,0.08,54,0.09,143.86,23,31,9,9,23,0
5,0,2,3,1,1,16,15.07,9.33,1312.42,0.05,38,0.11,72.91,16,22,6,7,16,0
9,3,35,5,4,1,36,34.2,13.54,6269.41,0.15,101,0.07,348.3,32,69,13,11,39,0
1,0,0,1,1,1,0,0,0,0,0,1,0,0,0,1,0,1,0,0
1,0,0,1,1,1,2,5.33,1.5,12,0,4,0.67,0.67,1,3,1,3,2,0
1,0,0,1,1,1,2,5.33,1.5,12,0,4,0.67,0.67,1,3,1,3,2,0
1,0,0,1,1,1,2,5.33,1.5,12,0,4,0.67,0.67,1,3,1,3,2,0
1,0,0,1,1,1,2,5.33,1.5,12,0,4,0.67,0.67,1,3,1,3,2,0
1,0,0,1,1,1,2,5.33,1.5,12,0,4,0.67,0.67,1,3,1,3,2,0
1,0,0,1,1,1,2,5.33,1.5,12,0,4,0.67,0.67,1,3,1,3,2,0
1,0,0,1,1,1,2,5.33,1.5,12,0,4,0.67,0.67,1,3,1,3,2,0
1,0,0,1,1,1,2,5.33,1.5,12,0,4,0.67,0.67,1,3,1,3,2,0
1,0,0,1,1,1,2,5.33,1.5,12,0,4,0.67,0.67,1,3,1,3,2,0
1,0,0,1,1,1,2,5.33,1.5,12,0,4,0.67,0.67,1,3,1,3,2,0
1,0,0,1,1,1,2,5.33,1.5,12,0,4,0.67,0.67,1,3,1,3,2,0
1,0,0,1,1,1,2,5.33,1.5,12,0,4,0.67,0.67,1,3,1,3,2,0
1,0,0,1,1,1,2,5.33,1.5,12,0,4,0.67,0.67,1,3,1,3,2,0
1,0,0,1,1,1,2,5.33,1.5,12,0,4,0.67,0.67,1,3,1,3,2,0
1,0,0,1,1,1,2,5.33,1.5,12,0,4,0.67,0.67,1,3,1,3,2,0
1,0,0,1,1,1,2,5.33,1.5,12,0,4,0.67,0.67,1,3,1,3,2,0
1,0,0,1,1,1,2,5.33,1.5,12,0,4,0.67,0.67,1,3,1,3,2,0
1,0,0,1,1,1,2,5.33,1.5,12,0,4,0.67,0.67,1,3,1,3,2,0
1,0,0,1,1,1,2,7.74,1.5,17.41,0,5,0.67,0.97,2,3,2,3,2,0
1,0,0,1,1,1,2,7.74,1.5,17.41,0,5,0.67,0.97,2,3,2,3,2,0
1,0,0,1,1,1,0,0,0,0,0,1,0,0,0,1,0,1,0,0
1,0,0,1,1,1,2,5.33,1.5,12,0,4,0.67,0.67,1,3,1,3,2,0
1,0,0,1,1,1,2,5.33,1.5,12,0,4,0.67,0.67,1,3,1,3,2,0
1,0,0,1,1,1,2,5.33,1.5,12,0,4,0.67,0.67,1,3,1,3,2,0
1,0,0,1,1,1,2,5.33,1.5,12,0,4,0.67,0.67,1,3,1,3,2,0
1,0,0,1,1,1,2,5.33,1.5,12,0,4,0.67,0.67,1,3,1,3,2,0
1,0,0,1,1,1,2,5.33,1.5,12,0,4,0.67,0.67,1,3,1,3,2,0
1,0,0,1,1,1,2,5.33,1.5,12,0,4,0.67,0.67,1,3,1,3,2,0
1,0,0,1,1,1,2,5.33,1.5,12,0,4,0.67,0.67,1,3,1,3,2,0
1,0,0,1,1,1,2,5.33,1.5,12,0,4,0.67,0.67,1,3,1,3,2,0
1,0,0,1,1,1,2,5.33,1.5,12,0,4,0.67,0.67,1,3,1,3,2,0
1,0,0,1,1,1,2,5.33,1.5,12,0,4,0.67,0.67,1,3,1,3,2,0
1,0,0,1,1,1,2,5.33,1.5,12,0,4,0.67,0.67,1,3,1,3,2,0
1,0,0,1,1,1,2,7.74,1.5,17.41,0,5,0.67,0.97,2,3,2,3,2,0
1,0,0,1,1,1,2,7.74,1.5,17.41,0,5,0.67,0.97,2,3,2,3,2,0
1,0,0,1,1,1,2,7.74,1.5,17.41,0,5,0.67,0.97,2,3,2,3,2,0
1,0,0,1,1,1,2,7.74,1.5,17.41,0,5,0.67,0.97,2,3,2,3,2,0
1,0,0,1,1,1,2,7.74,1.5,17.41,0,5,0.67,0.97,2,3,2,3,2,0
1,0,0,1,1,1,2,7.74,1.5,17.41,0,5,0.67,0.97,2,3,2,3,2,0
1,0,0,1,1,1,2,7.74,1.5,17.41,0,5,0.67,0.97,2,3,2,3,2,0
1,0,0,1,1,1,0,0,0,0,0,0,0,0,0,0,0,0,0,0
1,0,0,1,1,1,0,0,0,0,0,1,0,0,0,1,0,1,0,0
1,0,0,1,1,1,2,5.33,1.5,12,0,4,0.67,0.67,1,3,1,3,2,0
1,0,0,1,1,1,2,5.33,1.5,12,0,4,0.67,0.67,1,3,1,3,2,0
1,0,0,1,1,1,2,5.33,1.5,12,0,4,0.67,0.67,1,3,1,3,2,0
1,0,0,1,1,1,2,5.33,1.5,12,0,4,0.67,0.67,1,3,1,3,2,0
1,0,0,1,1,1,2,5.33,1.5,12,0,4,0.67,0.67,1,3,1,3,2,0
1,0,0,1,1,1,2,5.33,1.5,12,0,4,0.67,0.67,1,3,1,3,2,0
1,0,0,1,1,1,3,11.63,2,46.53,0.01,9,0.5,2.58,4,5,3,3,3,0
1,0,0,1,1,1,2,7.75,2,31.02,0.01,6,0.5,1.72,2,4,2,4,2,0
1,0,0,1,1,1,2,7.74,1.5,17.41,0,5,0.67,0.97,2,3,2,3,2,0
1,0,0,1,1,1,0,0,0,0,0,0,0,0,0,0,0,0,0,0
1,0,0,1,1,1,2,5.33,1.5,12,0,4,0.67,0.67,1,3,1,3,2,0
1,0,0,1,1,1,2,5.33,1.5,12,0,4,0.67,0.67,1,3,1,3,2,0
1,0,0,1,1,1,2,5.33,1.5,12,0,4,0.67,0.67,1,3,1,3,2,0
1,0,0,1,1,1,2,5.33,1.5,12,0,4,0.67,0.67,1,3,1,3,2,0
1,0,0,1,1,1,2,5.33,1.5,12,0,4,0.67,0.67,1,3,1,3,2,0
1,0,0,1,1,1,2,5.33,1.5,12,0,4,0.67,0.67,1,3,1,3,2,0
1,0,0,1,1,1,2,5.33,1.5,12,0,4,0.67,0.67,1,3,1,3,2,0
1,0,0,1,1,1,2,5.33,1.5,12,0,4,0.67,0.67,1,3,1,3,2,0
1,0,0,1,1,1,2,5.33,1.5,12,0,4,0.67,0.67,1,3,1,3,2,0
1,0,0,1,1,1,2,5.33,1.5,12,0,4,0.67,0.67,1,3,1,3,2,0
1,0,0,1,1,1,2,5.33,1.5,12,0,4,0.67,0.67,1,3,1,3,2,0
1,0,0,1,1,1,2,5.33,1.5,12,0,4,0.67,0.67,1,3,1,3,2,0
1,0,0,1,1,1,2,5.33,1.5,12,0,4,0.67,0.67,1,3,1,3,2,0
1,0,0,1,1,1,2,5.33,1.5,12,0,4,0.67,0.67,1,3,1,3,2,0
1,0,0,1,1,1,2,5.33,1.5,12,0,4,0.67,0.67,1,3,1,3,2,0
1,0,0,1,1,1,2,5.33,1.5,12,0,4,0.67,0.67,1,3,1,3,2,0
1,0,0,1,1,1,2,5.33,1.5,12,0,4,0.67,0.67,1,3,1,3,2,0
1,0,0,1,1,1,2,7.74,1.5,17.41,0,5,0.67,0.97,2,3,2,3,2,0
1,0,0,1,1,1,2,7.74,1.5,17.41,0,5,0.67,0.97,2,3,2,3,2,0
1,0,0,1,1,1,2,7.74,1.5,17.41,0,5,0.67,0.97,2,3,2,3,2,0
1,0,0,1,1,1,2,5.33,1.5,12,0,4,0.67,0.67,1,3,1,3,2,0
1,0,0,1,1,1,2,5.33,1.5,12,0,4,0.67,0.67,1,3,1,3,2,0
1,0,0,1,1,1,2,5.33,1.5,12,0,4,0.67,0.67,1,3,1,3,2,0
1,0,0,1,1,1,2,5.33,1.5,12,0,4,0.67,0.67,1,3,1,3,2,0
1,0,0,1,1,1,2,5.33,1.5,12,0,4,0.67,0.67,1,3,1,3,2,0
1,0,0,1,1,1,2,5.33,1.5,12,0,4,0.67,0.67,1,3,1,3,2,0
1,0,0,1,1,1,2,5.33,1.5,12,0,4,0.67,0.67,1,3,1,3,2,0
1,0,0,1,1,1,2,5.33,1.5,12,0,4,0.67,0.67,1,3,1,3,2,0
1,0,0,1,1,1,2,5.33,1.5,12,0,4,0.67,0.67,1,3,1,3,2,0
1,0,0,1,1,1,2,5.33,1.5,12,0,4,0.67,0.67,1,3,1,3,2,0
1,0,0,1,1,1,2,5.33,1.5,12,0,4,0.67,0.67,1,3,1,3,2,0
1,0,0,1,1,1,2,5.33,1.5,12,0,4,0.67,0.67,1,3,1,3,2,0
1,0,0,1,1,1,2,5.33,1.5,12,0,4,0.67,0.67,1,3,1,3,2,0
1,0,0,1,1,1,2,5.33,1.5,12,0,4,0.67,0.67,1,3,1,3,2,0
1,0,0,1,1,1,2,5.33,1.5,12,0,4,0.67,0.67,1,3,1,3,2,0
1,0,0,1,1,1,2,5.33,1.5,12,0,4,0.67,0.67,1,3,1,3,2,0
1,0,0,1,1,1,2,5.33,1.5,12,0,4,0.67,0.67,1,3,1,3,2,0
1,0,0,1,1,1,2,5.33,1.5,12,0,4,0.67,0.67,1,3,1,3,2,0
1,0,0,1,1,1,2,5.33,1.5,12,0,4,0.67,0.67,1,3,1,3,2,0
1,0,0,1,1,1,2,5.33,1.5,12,0,4,0.67,0.67,1,3,1,3,2,0
1,0,0,1,1,1,2,5.33,1.5,12,0,4,0.67,0.67,1,3,1,3,2,0
1,0,0,1,1,1,2,5.33,1.5,12,0,4,0.67,0.67,1,3,1,3,2,0
1,0,0,1,1,1,2,5.33,1.5,12,0,4,0.67,0.67,1,3,1,3,2,0
1,0,0,1,1,1,2,5.33,1.5,12,0,4,0.67,0.67,1,3,1,3,2,0
1,0,0,1,1,1,2,5.33,1.5,12,0,4,0.67,0.67,1,3,1,3,2,0
1,0,0,1,1,1,2,5.33,1.5,12,0,4,0.67,0.67,1,3,1,3,2,0
1,0,0,1,1,1,2,5.33,1.5,12,0,4,0.67,0.67,1,3,1,3,2,0
1,0,0,1,1,1,2,5.33,1.5,12,0,4,0.67,0.67,1,3,1,3,2,0
1,0,0,1,1,1,2,5.33,1.5,12,0,4,0.67,0.67,1,3,1,3,2,0
1,0,0,1,1,1,2,5.33,1.5,12,0,4,0.67,0.67,1,3,1,3,2,0
1,0,0,1,1,1,2,5.33,1.5,12,0,4,0.67,0.67,1,3,1,3,2,0
1,0,0,1,1,1,2,5.33,1.5,12,0,4,0.67,0.67,1,3,1,3,2,0
1,0,0,1,1,1,2,5.33,1.5,12,0,4,0.67,0.67,1,3,1,3,2,0
1,0,0,1,1,1,2,5.33,1.5,12,0,4,0.67,0.67,1,3,1,3,2,0
1,0,0,1,1,1,2,5.33,1.5,12,0,4,0.67,0.67,1,3,1,3,2,0
1,0,0,1,1,1,2,5.33,1.5,12,0,4,0.67,0.67,1,3,1,3,2,0
1,0,0,1,1,1,2,5.33,1.5,12,0,4,0.67,0.67,1,3,1,3,2,0
1,0,0,1,1,1,2,5.33,1.5,12,0,4,0.67,0.67,1,3,1,3,2,0
1,0,0,1,1,1,2,5.33,1.5,12,0,4,0.67,0.67,1,3,1,3,2,0
1,0,0,1,1,1,2,5.33,1.5,12,0,4,0.67,0.67,1,3,1,3,2,0
1,0,0,1,1,1,2,5.33,1.5,12,0,4,0.67,0.67,1,3,1,3,2,0
1,0,0,1,1,1,2,5.33,1.5,12,0,4,0.67,0.67,1,3,1,3,2,0
1,0,0,1,1,1,2,5.33,1.5,12,0,4,0.67,0.67,1,3,1,3,2,0
1,0,0,1,1,1,2,7.74,1.5,17.41,0,5,0.67,0.97,2,3,2,3,2,0
1,0,0,1,1,1,2,7.74,1.5,17.41,0,5,0.67,0.97,2,3,2,3,2,0
1,0,0,1,1,1,2,7.74,1.5,17.41,0,5,0.67,0.97,2,3,2,3,2,0
1,0,0,1,1,1,2,7.74,1.5,17.41,0,5,0.67,0.97,2,3,2,3,2,0
1,0,0,1,1,1,2,7.74,1.5,17.41,0,5,0.67,0.97,2,3,2,3,2,0
1,0,0,1,1,1,2,7.74,1.5,17.41,0,5,0.67,0.97,2,3,2,3,2,0
1,0,0,1,1,1,2,7.74,1.5,17.41,0,5,0.67,0.97,2,3,2,3,2,0
1,0,0,1,1,1,2,7.74,1.5,17.41,0,5,0.67,0.97,2,3,2,3,2,0
1,0,0,1,1,1,2,7.74,1.5,17.41,0,5,0.67,0.97,2,3,2,3,2,0
1,0,0,1,1,1,2,7.74,1.5,17.41,0,5,0.67,0.97,2,3,2,3,2,0
1,0,0,1,1,1,2,7.74,1.5,17.41,0,5,0.67,0.97,2,3,2,3,2,0
1,0,0,1,1,1,2,7.74,1.5,17.41,0,5,0.67,0.97,2,3,2,3,2,0
1,0,0,1,1,1,2,7.74,1.5,17.41,0,5,0.67,0.97,2,3,2,3,2,0
1,0,0,1,1,1,2,7.74,1.5,17.41,0,5,0.67,0.97,2,3,2,3,2,0
1,0,0,1,1,1,2,7.74,1.5,17.41,0,5,0.67,0.97,2,3,2,3,2,0
1,0,0,1,1,1,2,7.74,1.5,17.41,0,5,0.67,0.97,2,3,2,3,2,0
1,0,0,1,1,1,2,7.74,1.5,17.41,0,5,0.67,0.97,2,3,2,3,2,0
1,0,0,1,1,1,2,7.74,1.5,17.41,0,5,0.67,0.97,2,3,2,3,2,0
1,0,0,1,1,1,2,7.74,1.5,17.41,0,5,0.67,0.97,2,3,2,3,2,0
1,0,0,1,1,1,2,7.74,1.5,17.41,0,5,0.67,0.97,2,3,2,3,2,0
1,0,0,1,1,1,2,7.74,1.5,17.41,0,5,0.67,0.97,2,3,2,3,2,0
1,0,0,1,1,1,2,7.74,1.5,17.41,0,5,0.67,0.97,2,3,2,3,2,0
1,0,0,1,1,1,2,7.74,1.5,17.41,0,5,0.67,0.97,2,3,2,3,2,0
1,0,0,1,1,1,2,7.74,1.5,17.41,0,5,0.67,0.97,2,3,2,3,2,0
1,0,0,1,1,1,2,7.74,1.5,17.41,0,5,0.67,0.97,2,3,2,3,2,0
1,0,0,1,1,1,2,7.74,1.5,17.41,0,5,0.67,0.97,2,3,2,3,2,0
1,0,0,1,1,1,0,0,0,0,0,1,0,0,0,1,0,1,0,0
1,0,0,1,1,1,2,5.33,1.5,12,0,4,0.67,0.67,1,3,1,3,2,0
1,0,0,1,1,1,2,5.33,1.5,12,0,4,0.67,0.67,1,3,1,3,2,0
1,0,0,1,1,1,2,5.33,1.5,12,0,4,0.67,0.67,1,3,1,3,2,0
1,0,0,1,1,1,0,0,0,0,0,1,0,0,0,1,0,1,0,0
1,0,0,1,1,1,2,5.33,1.5,12,0,4,0.67,0.67,1,3,1,3,2,0
1,0,0,1,1,1,2,5.33,1.5,12,0,4,0.67,0.67,1,3,1,3,2,0
1,0,0,1,1,1,2,5.33,1.5,12,0,4,0.67,0.67,1,3,1,3,2,0
1,0,0,1,1,1,2,5.33,1.5,12,0,4,0.67,0.67,1,3,1,3,2,0
1,0,0,1,1,1,2,5.33,1.5,12,0,4,0.67,0.67,1,3,1,3,2,0
1,0,0,1,1,1,2,5.33,1.5,12,0,4,0.67,0.67,1,3,1,3,2,0
1,0,0,1,1,1,2,7.74,1.5,17.41,0,5,0.67,0.97,2,3,2,3,2,0
1,0,0,1,1,1,0,0,0,0,0,1,0,0,0,1,0,1,0,0
1,0,0,1,1,1,2,5.33,1.5,12,0,4,0.67,0.67,1,3,1,3,2,0
1,0,0,1,1,1,2,5.33,1.5,12,0,4,0.67,0.67,1,3,1,3,2,0
1,0,0,1,1,1,2,5.33,1.5,12,0,4,0.67,0.67,1,3,1,3,2,0
1,0,0,1,1,1,2,5.33,1.5,12,0,4,0.67,0.67,1,3,1,3,2,0
1,0,0,1,1,1,2,5.33,1.5,12,0,4,0.67,0.67,1,3,1,3,2,0
1,0,0,1,1,1,2,7.74,1.5,17.41,0,5,0.67,0.97,2,3,2,3,2,0
1,0,0,1,1,1,2,7.74,1.5,17.41,0,5,0.67,0.97,2,3,2,3,2,0
1,0,0,1,1,1,2,7.74,1.5,17.41,0,5,0.67,0.97,2,3,2,3,2,0
1,0,0,1,1,1,2,7.74,1.5,17.41,0,5,0.67,0.97,2,3,2,3,2,0
1,0,0,1,1,1,2,7.74,1.5,17.41,0,5,0.67,0.97,2,3,2,3,2,0
1,0,0,1,1,1,2,7.74,1.5,17.41,0,5,0.67,0.97,2,3,2,3,2,0
1,0,0,1,1,1,0,0,0,0,0,0,0,0,0,0,0,0,0,0
1,0,0,1,1,1,2,7.74,1.5,17.41,0,5,0.67,0.97,2,3,2,3,2,0
1,0,0,1,1,1,2,7.74,1.5,17.41,0,5,0.67,0.97,2,3,2,3,2,0
1,0,0,1,1,1,2,7.74,1.5,17.41,0,5,0.67,0.97,2,3,2,3,2,0
9,0,4,5,5,1,26,19.04,13,3217.21,0.08,65,0.08,178.73,26,39,7,7,26,0
1,0,0,1,1,1,1,0,0,0,0,1,0,0,0,1,0,1,1,0
1,0,0,1,1,1,1,0,0,0,0,1,0,0,0,1,0,1,1,0
1,0,0,1,1,1,1,0,0,0,0,1,0,0,0,1,0,1,1,0
1,0,0,1,1,1,1,0,0,0,0,1,0,0,0,1,0,1,1,0
3,1,0,2,1,1,7,12.44,4.9,298.63,0.02,17,0.2,16.59,7,10,5,7,8,0
27,7,17,14,9,9,46,41.52,15.43,9884.13,0.21,127,0.06,549.12,54,73,21,12,53,0
27,5,15,14,9,9,46,56.16,9,4548.69,0.17,103,0.11,252.7,42,61,21,9,51,0
3,0,0,2,1,1,6,5.89,7,288.46,0.01,13,0.14,16.03,4,9,2,7,6,0
1,0,0,1,1,1,2,5.33,1.5,12,0,4,0.67,0.67,1,3,1,3,2,0
1,0,0,1,1,1,2,5.33,1.5,12,0,4,0.67,0.67,1,3,1,3,2,0
1,0,0,1,1,1,2,5.33,1.5,12,0,4,0.67,0.67,1,3,1,3,2,0
1,0,0,1,1,1,2,5.33,1.5,12,0,4,0.67,0.67,1,3,1,3,2,0
1,0,0,1,1,1,2,5.33,1.5,12,0,4,0.67,0.67,1,3,1,3,2,0
1,0,0,1,1,1,2,5.33,1.5,12,0,4,0.67,0.67,1,3,1,3,2,0
27,6,10,14,6,1,62,60.58,10.57,6761.74,0.21,128,0.09,375.65,54,74,23,9,68,0
1,0,0,1,1,1,2,5.33,1.5,12,0,4,0.67,0.67,1,3,1,3,2,0
1,0,0,1,1,1,12,13.2,1.67,36.67,0.01,11,0.6,2.04,10,1,3,1,12,0
1,0,0,1,1,1,2,7.74,1.5,17.41,0,5,0.67,0.97,2,3,2,3,2,0
1,0,0,1,1,1,0,0,0,0,0,0,0,0,0,0,0,0,0,0
1,0,0,1,1,1,2,7.74,1.5,17.41,0,5,0.67,0.97,2,3,2,3,2,0
1,0,0,1,1,1,0,0,0,0,0,0,0,0,0,0,0,0,0,0
1,0,0,1,1,1,2,5.33,1.5,12,0,4,0.67,0.67,1,3,1,3,2,0
1,0,0,1,1,1,2,5.33,1.5,12,0,4,0.67,0.67,1,3,1,3,2,0
1,0,0,1,1,1,0,0,0,0,0,1,0,0,0,1,0,1,0,0
1,0,0,1,1,1,0,0,0,0,0,0,0,0,0,0,0,0,0,0
1,0,0,1,1,1,2,7.74,1.5,17.41,0,5,0.67,0.97,2,3,2,3,2,0
1,0,0,1,1,1,1,0,0,0,0,0,0,0,0,0,0,0,1,0
1,0,0,1,1,1,1,0,0,0,0,1,0,0,0,1,0,1,1,0
1,0,0,1,1,1,2,5.33,1.5,12,0,4,0.67,0.67,1,3,1,3,2,0
1,0,0,1,1,1,2,5.33,1.5,12,0,4,0.67,0.67,1,3,1,3,2,0
1,9,0,1,1,1,2,0,0,0,0,9,0,0,9,0,1,0,11,0
1,0,0,1,1,1,1,0,0,0,0,0,0,0,0,0,0,0,1,0
1,0,0,1,1,1,1,0,0,0,0,0,0,0,0,0,0,0,1,0
1,0,0,1,1,1,1,0,0,0,0,1,0,0,0,1,0,1,1,0
1,0,0,1,1,1,4,18.49,2.4,106.51,0.01,14,0.42,5.92,6,8,5,4,4,0
1,0,0,1,1,1,2,5.33,1.5,12,0,4,0.67,0.67,1,3,1,3,2,0
1,0,0,1,1,1,5,8.45,0.75,4.75,0,4,1.33,0.26,3,1,2,1,5,0
1,0,0,1,1,1,1,0,0,0,0,0,0,0,0,0,0,0,1,0
1,0,0,1,1,1,1,0,0,0,0,1,0,0,0,1,0,1,1,0
1,0,0,1,1,1,3,10.8,2.5,67.5,0.01,9,0.4,3.75,3,6,3,5,3,0
1,0,0,1,1,1,2,5.33,1.5,12,0,4,0.67,0.67,1,3,1,3,2,0
1,0,0,1,1,1,2,6.2,2.5,38.77,0.01,6,0.4,2.15,1,5,1,5,2,0
1,0,0,1,1,1,4,9.51,0.5,2.38,0,3,2,0.13,2,1,2,1,4,0
1,0,0,1,1,1,1,0,0,0,0,1,0,0,0,1,0,1,1,0
1,0,0,1,1,1,1,0,0,0,0,1,0,0,0,1,0,1,1,0
1,0,0,1,1,1,1,0,0,0,0,1,0,0,0,1,0,1,1,0
1,0,0,1,1,1,1,0,0,0,0,1,0,0,0,1,0,1,1,0
1,0,0,1,1,1,1,0,0,0,0,1,0,0,0,1,0,1,1,0
1,0,0,1,1,1,1,0,0,0,0,1,0,0,0,1,0,1,1,0
1,0,0,1,1,1,1,0,0,0,0,1,0,0,0,1,0,1,1,0
1,0,0,1,1,1,2,5.33,1.5,12,0,4,0.67,0.67,1,3,1,3,2,0
1,0,0,1,1,1,2,5.33,1.5,12,0,4,0.67,0.67,1,3,1,3,2,0
1,0,0,1,1,1,2,5.33,1.5,12,0,4,0.67,0.67,1,3,1,3,2,0
1,0,0,1,1,1,2,5.33,1.5,12,0,4,0.67,0.67,1,3,1,3,2,0
1,0,0,1,1,1,2,5.33,1.5,12,0,4,0.67,0.67,1,3,1,3,2,0
1,0,0,1,1,1,2,5.33,1.5,12,0,4,0.67,0.67,1,3,1,3,2,0
1,0,0,1,1,1,2,5.33,1.5,12,0,4,0.67,0.67,1,3,1,3,2,0
1,0,0,1,1,1,2,5.33,1.5,12,0,4,0.67,0.67,1,3,1,3,2,0
1,0,0,1,1,1,2,5.33,1.5,12,0,4,0.67,0.67,1,3,1,3,2,0
1,0,0,1,1,1,2,0,0,0,0,4,0,0,0,4,0,4,2,0
1,0,0,1,1,1,1,0,0,0,0,1,0,0,0,1,0,1,1,0
1,0,0,1,1,1,2,0,0,0,0,5,0,0,0,5,0,5,2,0
5,2,3,3,3,1,14,18.82,7.22,981.74,0.05,32,0.14,54.54,13,19,9,10,16,0
1,0,0,1,1,1,2,7.74,1.5,17.41,0,5,0.67,0.97,2,3,2,3,2,0
1,0,0,1,1,1,0,0,0,0,0,0,0,0,0,0,0,0,0,0
1,0,0,1,1,1,2,5.33,1.5,12,0,4,0.67,0.67,1,3,1,3,2,0
1,0,0,1,1,1,2,5.33,1.5,12,0,4,0.67,0.67,1,3,1,3,2,0
7,0,5,4,4,1,17,30.59,6.68,1364.63,0.07,44,0.15,75.81,17,27,14,11,17,0
7,1,2,4,3,3,18,23.39,8.64,1744.95,0.07,46,0.12,96.94,19,27,11,10,19,0
25,6,8,13,7,9,47,36.14,19.59,13863.97,0.24,133,0.05,770.22,53,80,23,17,53,0
5,1,1,3,2,1,14,18.17,6.75,827.71,0.04,30,0.15,45.98,12,18,8,9,15,0
1,0,0,1,1,1,2,7.74,1.5,17.41,0,5,0.67,0.97,2,3,2,3,2,0
1,0,0,1,1,1,1,0,0,0,0,0,0,0,0,0,0,0,1,0
1,0,0,1,1,1,1,0,0,0,0,1,0,0,0,1,0,1,1,0
1,0,0,1,1,1,2,5.33,1.5,12,0,4,0.67,0.67,1,3,1,3,2,0
1,0,0,1,1,1,2,5.33,1.5,12,0,4,0.67,0.67,1,3,1,3,2,0
1,9,0,1,1,1,2,0,0,0,0,9,0,0,9,0,1,0,11,0
1,0,0,1,1,1,1,0,0,0,0,0,0,0,0,0,0,0,1,0
1,0,0,1,1,1,1,0,0,0,0,0,0,0,0,0,0,0,1,0
1,0,0,1,1,1,1,0,0,0,0,1,0,0,0,1,0,1,1,0
1,0,0,1,1,1,4,18.49,2.4,106.51,0.01,14,0.42,5.92,6,8,5,4,4,0
1,0,0,1,1,1,2,5.33,1.5,12,0,4,0.67,0.67,1,3,1,3,2,0
1,0,0,1,1,1,5,8.45,0.75,4.75,0,4,1.33,0.26,3,1,2,1,5,0
1,0,0,1,1,1,1,0,0,0,0,0,0,0,0,0,0,0,1,0
1,0,0,1,1,1,1,0,0,0,0,1,0,0,0,1,0,1,1,0
1,0,0,1,1,1,3,10.8,2.5,67.5,0.01,9,0.4,3.75,3,6,3,5,3,0
1,0,0,1,1,1,2,5.33,1.5,12,0,4,0.67,0.67,1,3,1,3,2,0
1,0,0,1,1,1,2,6.2,2.5,38.77,0.01,6,0.4,2.15,1,5,1,5,2,0
1,0,0,1,1,1,4,9.51,0.5,2.38,0,3,2,0.13,2,1,2,1,4,0
1,0,0,1,1,1,1,0,0,0,0,1,0,0,0,1,0,1,1,0
1,0,0,1,1,1,2,5.33,1.5,12,0,4,0.67,0.67,1,3,1,3,2,0
1,0,0,1,1,1,2,5.33,1.5,12,0,4,0.67,0.67,1,3,1,3,2,0
1,0,0,1,1,1,2,0,0,0,0,4,0,0,0,4,0,4,2,0
1,0,0,1,1,1,1,0,0,0,0,1,0,0,0,1,0,1,1,0
1,0,0,1,1,1,2,0,0,0,0,5,0,0,0,5,0,5,2,0
1,0,0,1,1,1,1,0,0,0,0,1,0,0,0,1,0,1,1,0
1,0,0,1,1,1,2,5.33,1.5,12,0,4,0.67,0.67,1,3,1,3,2,0
1,0,0,1,1,1,2,5.33,1.5,12,0,4,0.67,0.67,1,3,1,3,2,0
1,0,0,1,1,1,1,0,0,0,0,1,0,0,0,1,0,1,1,0
1,0,0,1,1,1,2,7.86,2.5,49.13,0.01,7,0.4,2.73,2,5,2,5,2,0
1,0,0,1,1,1,2,7.49,3,67.38,0.01,8,0.33,3.74,1,7,1,6,2,0
1,0,0,1,1,1,2,7.49,3,67.38,0.01,8,0.33,3.74,1,7,1,6,2,0
1,0,0,1,1,1,2,7.49,3,67.38,0.01,8,0.33,3.74,1,7,1,6,2,0
1,0,0,1,1,1,2,7.49,3,67.38,0.01,8,0.33,3.74,1,7,1,6,2,0
1,0,0,1,1,1,2,7.49,3,67.38,0.01,8,0.33,3.74,1,7,1,6,2,0
1,0,0,1,1,1,2,7.49,3,67.38,0.01,8,0.33,3.74,1,7,1,6,2,0
1,0,0,1,1,1,2,7.49,3,67.38,0.01,8,0.33,3.74,1,7,1,6,2,0
1,0,0,1,1,1,2,10.57,3,95.1,0.01,10,0.33,5.28,3,7,3,6,2,0
1,0,0,1,1,1,0,0,0,0,0,1,0,0,0,1,0,1,0,0
1,0,0,1,1,1,2,5.33,1.5,12,0,4,0.67,0.67,1,3,1,3,2,0
1,0,0,1,1,1,2,5.33,1.5,12,0,4,0.67,0.67,1,3,1,3,2,0
1,0,0,1,1,1,2,5.33,1.5,12,0,4,0.67,0.67,1,3,1,3,2,0
1,0,0,1,1,1,2,5.33,1.5,12,0,4,0.67,0.67,1,3,1,3,2,0
1,0,0,1,1,1,2,5.33,1.5,12,0,4,0.67,0.67,1,3,1,3,2,0
1,0,0,1,1,1,2,5.33,1.5,12,0,4,0.67,0.67,1,3,1,3,2,0
1,0,0,1,1,1,2,5.33,1.5,12,0,4,0.67,0.67,1,3,1,3,2,0
1,0,0,1,1,1,2,13.95,2.5,87.17,0.01,11,0.4,4.84,4,7,4,5,2,0
1,0,0,1,1,1,0,0,0,0,0,1,0,0,0,1,0,1,0,0
1,0,0,1,1,1,0,0,0,0,0,1,0,0,0,1,0,1,0,0
9,3,0,5,5,4,4,6.95,27.62,5307.06,0.06,47,0.04,294.84,17,30,4,13,7,0
1,0,0,1,1,1,2,13.18,5.25,363.24,0.02,20,0.19,20.18,6,14,4,7,2,0
1,0,0,1,1,1,2,5.33,1.5,12,0,4,0.67,0.67,1,3,1,3,2,0
1,0,0,1,1,1,2,5.33,1.5,12,0,4,0.67,0.67,1,3,1,3,2,0
1,0,0,1,1,1,2,5.33,1.5,12,0,4,0.67,0.67,1,3,1,3,2,0
1,0,0,1,1,1,4,27.47,1.5,61.81,0.01,13,0.67,3.43,6,7,6,3,4,0
1,0,0,1,1,1,2,11.3,6.13,423.78,0.02,20,0.16,23.54,7,13,4,7,2,0
1,0,0,1,1,1,0,0,0,0,0,1,0,0,0,1,0,1,0,0
1,0,0,1,1,1,2,5.33,1.5,12,0,4,0.67,0.67,1,3,1,3,2,0
1,0,0,1,1,1,2,5.33,1.5,12,0,4,0.67,0.67,1,3,1,3,2,0
1,0,0,1,1,1,2,5.33,1.5,12,0,4,0.67,0.67,1,3,1,3,2,0
1,0,0,1,1,1,2,5.33,1.5,12,0,4,0.67,0.67,1,3,1,3,2,0
1,0,0,1,1,1,2,5.33,1.5,12,0,4,0.67,0.67,1,3,1,3,2,0
1,0,0,1,1,1,2,5.33,1.5,12,0,4,0.67,0.67,1,3,1,3,2,0
1,0,0,1,1,1,2,5.33,1.5,12,0,4,0.67,0.67,1,3,1,3,2,0
1,0,0,1,1,1,2,5.33,1.5,12,0,4,0.67,0.67,1,3,1,3,2,0
1,0,0,1,1,1,2,5.33,1.5,12,0,4,0.67,0.67,1,3,1,3,2,0
1,0,0,1,1,1,2,5.33,1.5,12,0,4,0.67,0.67,1,3,1,3,2,0
1,0,0,1,1,1,2,5.33,1.5,12,0,4,0.67,0.67,1,3,1,3,2,0
1,0,0,1,1,1,2,5.33,1.5,12,0,4,0.67,0.67,1,3,1,3,2,0
1,0,0,1,1,1,2,5.33,1.5,12,0,4,0.67,0.67,1,3,1,3,2,0
1,1,0,1,1,1,12,55.45,3.54,694.24,0.07,48,0.28,38.57,23,25,13,4,13,0
1,0,0,1,1,1,0,0,0,0,0,1,0,0,0,1,0,1,0,0
1,0,0,1,1,1,2,5.33,1.5,12,0,4,0.67,0.67,1,3,1,3,2,0
1,0,0,1,1,1,2,5.33,1.5,12,0,4,0.67,0.67,1,3,1,3,2,0
1,0,0,1,1,1,2,5.33,1.5,12,0,4,0.67,0.67,1,3,1,3,2,0
1,0,0,1,1,1,2,5.33,1.5,12,0,4,0.67,0.67,1,3,1,3,2,0
1,0,0,1,1,1,2,5.33,1.5,12,0,4,0.67,0.67,1,3,1,3,2,0
1,0,0,1,1,1,2,5.33,1.5,12,0,4,0.67,0.67,1,3,1,3,2,0
1,0,0,1,1,1,2,5.33,1.5,12,0,4,0.67,0.67,1,3,1,3,2,0
1,0,0,1,1,1,2,5.33,1.5,12,0,4,0.67,0.67,1,3,1,3,2,0
1,0,0,1,1,1,2,5.33,1.5,12,0,4,0.67,0.67,1,3,1,3,2,0
1,0,0,1,1,1,2,5.33,1.5,12,0,4,0.67,0.67,1,3,1,3,2,0
1,0,0,1,1,1,2,5.33,1.5,12,0,4,0.67,0.67,1,3,1,3,2,0
1,0,0,1,1,1,2,5.33,1.5,12,0,4,0.67,0.67,1,3,1,3,2,0
1,0,0,1,1,1,2,5.33,1.5,12,0,4,0.67,0.67,1,3,1,3,2,0
1,0,0,1,1,1,2,5.33,1.5,12,0,4,0.67,0.67,1,3,1,3,2,0
1,0,0,1,1,1,2,5.33,1.5,12,0,4,0.67,0.67,1,3,1,3,2,0
1,0,0,1,1,1,2,5.33,1.5,12,0,4,0.67,0.67,1,3,1,3,2,0
1,0,0,1,1,1,2,5.33,1.5,12,0,4,0.67,0.67,1,3,1,3,2,0
1,0,0,1,1,1,2,5.33,1.5,12,0,4,0.67,0.67,1,3,1,3,2,0
1,0,2,1,1,1,96,521.19,4.97,12891.45,0.86,391,0.2,716.19,187,204,94,5,96,1
1,0,0,1,1,1,2,7.74,1.5,17.41,0,5,0.67,0.97,2,3,2,3,2,0
1,0,0,1,1,1,0,0,0,0,0,0,0,0,0,0,0,0,0,0
1,0,0,1,1,1,0,0,0,0,0,1,0,0,0,1,0,1,0,0
1,0,0,1,1,1,2,5.33,1.5,12,0,4,0.67,0.67,1,3,1,3,2,0
1,0,0,1,1,1,2,5.33,1.5,12,0,4,0.67,0.67,1,3,1,3,2,0
1,0,0,1,1,1,2,5.33,1.5,12,0,4,0.67,0.67,1,3,1,3,2,0
1,0,0,1,1,1,2,5.33,1.5,12,0,4,0.67,0.67,1,3,1,3,2,0
1,0,0,1,1,1,2,5.33,1.5,12,0,4,0.67,0.67,1,3,1,3,2,0
1,0,0,1,1,1,2,5.33,1.5,12,0,4,0.67,0.67,1,3,1,3,2,0
1,0,0,1,1,1,3,11.63,2,46.53,0.01,9,0.5,2.58,4,5,3,3,3,0
1,0,0,1,1,1,2,7.75,2,31.02,0.01,6,0.5,1.72,2,4,2,4,2,0
1,0,0,1,1,1,2,5.33,1.5,12,0,4,0.67,0.67,1,3,1,3,2,0
1,0,0,1,1,1,2,5.33,1.5,12,0,4,0.67,0.67,1,3,1,3,2,0
1,0,0,1,1,1,2,5.33,1.5,12,0,4,0.67,0.67,1,3,1,3,2,0
1,0,0,1,1,1,2,5.33,1.5,12,0,4,0.67,0.67,1,3,1,3,2,0
1,0,0,1,1,1,2,5.33,1.5,12,0,4,0.67,0.67,1,3,1,3,2,0
1,0,0,1,1,1,2,5.33,1.5,12,0,4,0.67,0.67,1,3,1,3,2,0
1,0,0,1,1,1,2,5.33,1.5,12,0,4,0.67,0.67,1,3,1,3,2,0
1,0,0,1,1,1,2,5.33,1.5,12,0,4,0.67,0.67,1,3,1,3,2,0
1,0,0,1,1,1,2,5.33,1.5,12,0,4,0.67,0.67,1,3,1,3,2,0
1,0,0,1,1,1,2,5.33,1.5,12,0,4,0.67,0.67,1,3,1,3,2,0
1,0,0,1,1,1,2,5.33,1.5,12,0,4,0.67,0.67,1,3,1,3,2,0
1,0,0,1,1,1,2,5.33,1.5,12,0,4,0.67,0.67,1,3,1,3,2,0
1,0,0,1,1,1,2,5.33,1.5,12,0,4,0.67,0.67,1,3,1,3,2,0
1,0,0,1,1,1,2,5.33,1.5,12,0,4,0.67,0.67,1,3,1,3,2,0
1,0,0,1,1,1,2,5.33,1.5,12,0,4,0.67,0.67,1,3,1,3,2,0
1,0,0,1,1,1,2,5.33,1.5,12,0,4,0.67,0.67,1,3,1,3,2,0
1,0,0,1,1,1,2,5.33,1.5,12,0,4,0.67,0.67,1,3,1,3,2,0
1,0,0,1,1,1,2,7.74,1.5,17.41,0,5,0.67,0.97,2,3,2,3,2,0
1,0,0,1,1,1,2,7.74,1.5,17.41,0,5,0.67,0.97,2,3,2,3,2,0
1,0,0,1,1,1,2,7.74,1.5,17.41,0,5,0.67,0.97,2,3,2,3,2,0
1,0,0,1,1,1,2,5.33,1.5,12,0,4,0.67,0.67,1,3,1,3,2,0
1,0,0,1,1,1,2,5.33,1.5,12,0,4,0.67,0.67,1,3,1,3,2,0
1,0,0,1,1,1,2,5.33,1.5,12,0,4,0.67,0.67,1,3,1,3,2,0
1,0,0,1,1,1,2,5.33,1.5,12,0,4,0.67,0.67,1,3,1,3,2,0
1,0,0,1,1,1,2,5.33,1.5,12,0,4,0.67,0.67,1,3,1,3,2,0
1,0,0,1,1,1,2,5.33,1.5,12,0,4,0.67,0.67,1,3,1,3,2,0
1,0,0,1,1,1,2,5.33,1.5,12,0,4,0.67,0.67,1,3,1,3,2,0
1,0,0,1,1,1,2,5.33,1.5,12,0,4,0.67,0.67,1,3,1,3,2,0
1,0,0,1,1,1,2,5.33,1.5,12,0,4,0.67,0.67,1,3,1,3,2,0
1,0,0,1,1,1,2,5.33,1.5,12,0,4,0.67,0.67,1,3,1,3,2,0
1,0,0,1,1,1,2,5.33,1.5,12,0,4,0.67,0.67,1,3,1,3,2,0
1,0,0,1,1,1,2,5.33,1.5,12,0,4,0.67,0.67,1,3,1,3,2,0
1,0,0,1,1,1,2,5.33,1.5,12,0,4,0.67,0.67,1,3,1,3,2,0
1,0,0,1,1,1,2,5.33,1.5,12,0,4,0.67,0.67,1,3,1,3,2,0
1,0,0,1,1,1,2,5.33,1.5,12,0,4,0.67,0.67,1,3,1,3,2,0
1,0,0,1,1,1,2,5.33,1.5,12,0,4,0.67,0.67,1,3,1,3,2,0
1,0,0,1,1,1,2,5.33,1.5,12,0,4,0.67,0.67,1,3,1,3,2,0
1,0,0,1,1,1,2,5.33,1.5,12,0,4,0.67,0.67,1,3,1,3,2,0
1,0,0,1,1,1,2,5.33,1.5,12,0,4,0.67,0.67,1,3,1,3,2,0
1,0,0,1,1,1,2,5.33,1.5,12,0,4,0.67,0.67,1,3,1,3,2,0
1,0,0,1,1,1,2,5.33,1.5,12,0,4,0.67,0.67,1,3,1,3,2,0
1,0,0,1,1,1,2,5.33,1.5,12,0,4,0.67,0.67,1,3,1,3,2,0
1,0,0,1,1,1,2,5.33,1.5,12,0,4,0.67,0.67,1,3,1,3,2,0
1,0,0,1,1,1,2,5.33,1.5,12,0,4,0.67,0.67,1,3,1,3,2,0
1,0,0,1,1,1,2,5.33,1.5,12,0,4,0.67,0.67,1,3,1,3,2,0
1,0,0,1,1,1,2,5.33,1.5,12,0,4,0.67,0.67,1,3,1,3,2,0
1,0,0,1,1,1,2,5.33,1.5,12,0,4,0.67,0.67,1,3,1,3,2,0
1,0,0,1,1,1,2,5.33,1.5,12,0,4,0.67,0.67,1,3,1,3,2,0
1,0,0,1,1,1,2,5.33,1.5,12,0,4,0.67,0.67,1,3,1,3,2,0
1,0,0,1,1,1,2,5.33,1.5,12,0,4,0.67,0.67,1,3,1,3,2,0
1,0,0,1,1,1,2,5.33,1.5,12,0,4,0.67,0.67,1,3,1,3,2,0
1,0,0,1,1,1,2,5.33,1.5,12,0,4,0.67,0.67,1,3,1,3,2,0
1,0,0,1,1,1,2,5.33,1.5,12,0,4,0.67,0.67,1,3,1,3,2,0
1,0,0,1,1,1,2,5.33,1.5,12,0,4,0.67,0.67,1,3,1,3,2,0
1,0,0,1,1,1,2,5.33,1.5,12,0,4,0.67,0.67,1,3,1,3,2,0
1,0,0,1,1,1,2,5.33,1.5,12,0,4,0.67,0.67,1,3,1,3,2,0
1,0,0,1,1,1,2,5.33,1.5,12,0,4,0.67,0.67,1,3,1,3,2,0
1,0,0,1,1,1,2,5.33,1.5,12,0,4,0.67,0.67,1,3,1,3,2,0
1,0,0,1,1,1,2,5.33,1.5,12,0,4,0.67,0.67,1,3,1,3,2,0
1,0,0,1,1,1,2,5.33,1.5,12,0,4,0.67,0.67,1,3,1,3,2,0
1,0,0,1,1,1,2,5.33,1.5,12,0,4,0.67,0.67,1,3,1,3,2,0
1,0,0,1,1,1,2,5.33,1.5,12,0,4,0.67,0.67,1,3,1,3,2,0
1,0,0,1,1,1,2,5.33,1.5,12,0,4,0.67,0.67,1,3,1,3,2,0
1,0,0,1,1,1,2,7.74,1.5,17.41,0,5,0.67,0.97,2,3,2,3,2,0
1,0,0,1,1,1,2,7.74,1.5,17.41,0,5,0.67,0.97,2,3,2,3,2,0
1,0,0,1,1,1,2,7.74,1.5,17.41,0,5,0.67,0.97,2,3,2,3,2,0
1,0,0,1,1,1,2,7.74,1.5,17.41,0,5,0.67,0.97,2,3,2,3,2,0
1,0,0,1,1,1,2,7.74,1.5,17.41,0,5,0.67,0.97,2,3,2,3,2,0
1,0,0,1,1,1,2,7.74,1.5,17.41,0,5,0.67,0.97,2,3,2,3,2,0
1,0,0,1,1,1,2,7.74,1.5,17.41,0,5,0.67,0.97,2,3,2,3,2,0
1,0,0,1,1,1,2,7.74,1.5,17.41,0,5,0.67,0.97,2,3,2,3,2,0
1,0,0,1,1,1,2,7.74,1.5,17.41,0,5,0.67,0.97,2,3,2,3,2,0
1,0,0,1,1,1,2,7.74,1.5,17.41,0,5,0.67,0.97,2,3,2,3,2,0
1,0,0,1,1,1,2,7.74,1.5,17.41,0,5,0.67,0.97,2,3,2,3,2,0
1,0,0,1,1,1,2,7.74,1.5,17.41,0,5,0.67,0.97,2,3,2,3,2,0
1,0,0,1,1,1,2,7.74,1.5,17.41,0,5,0.67,0.97,2,3,2,3,2,0
1,0,0,1,1,1,2,7.74,1.5,17.41,0,5,0.67,0.97,2,3,2,3,2,0
1,0,0,1,1,1,2,7.74,1.5,17.41,0,5,0.67,0.97,2,3,2,3,2,0
1,0,0,1,1,1,2,7.74,1.5,17.41,0,5,0.67,0.97,2,3,2,3,2,0
1,0,0,1,1,1,2,7.74,1.5,17.41,0,5,0.67,0.97,2,3,2,3,2,0
1,0,0,1,1,1,2,7.74,1.5,17.41,0,5,0.67,0.97,2,3,2,3,2,0
1,0,0,1,1,1,2,7.74,1.5,17.41,0,5,0.67,0.97,2,3,2,3,2,0
1,0,0,1,1,1,2,7.74,1.5,17.41,0,5,0.67,0.97,2,3,2,3,2,0
1,0,0,1,1,1,2,7.74,1.5,17.41,0,5,0.67,0.97,2,3,2,3,2,0
1,0,0,1,1,1,2,7.74,1.5,17.41,0,5,0.67,0.97,2,3,2,3,2,0
1,0,0,1,1,1,2,7.74,1.5,17.41,0,5,0.67,0.97,2,3,2,3,2,0
1,0,0,1,1,1,2,7.74,1.5,17.41,0,5,0.67,0.97,2,3,2,3,2,0
1,0,0,1,1,1,2,7.74,1.5,17.41,0,5,0.67,0.97,2,3,2,3,2,0
1,0,0,1,1,1,2,7.74,1.5,17.41,0,5,0.67,0.97,2,3,2,3,2,0
1,0,0,1,1,1,0,0,0,0,0,1,0,0,0,1,0,1,0,0
1,0,0,1,1,1,2,5.33,1.5,12,0,4,0.67,0.67,1,3,1,3,2,0
1,0,0,1,1,1,2,5.33,1.5,12,0,4,0.67,0.67,1,3,1,3,2,0
1,0,0,1,1,1,2,5.33,1.5,12,0,4,0.67,0.67,1,3,1,3,2,0
1,0,0,1,1,1,0,0,0,0,0,1,0,0,0,1,0,1,0,0
1,0,0,1,1,1,2,5.33,1.5,12,0,4,0.67,0.67,1,3,1,3,2,0
1,0,0,1,1,1,2,5.33,1.5,12,0,4,0.67,0.67,1,3,1,3,2,0
1,0,0,1,1,1,2,5.33,1.5,12,0,4,0.67,0.67,1,3,1,3,2,0
1,0,0,1,1,1,2,5.33,1.5,12,0,4,0.67,0.67,1,3,1,3,2,0
1,0,0,1,1,1,2,5.33,1.5,12,0,4,0.67,0.67,1,3,1,3,2,0
1,0,0,1,1,1,2,5.33,1.5,12,0,4,0.67,0.67,1,3,1,3,2,0
1,0,0,1,1,1,2,7.74,1.5,17.41,0,5,0.67,0.97,2,3,2,3,2,0
1,0,0,1,1,1,2,7.74,1.5,17.41,0,5,0.67,0.97,2,3,2,3,2,0
1,0,0,1,1,1,2,7.74,1.5,17.41,0,5,0.67,0.97,2,3,2,3,2,0
1,0,0,1,1,1,2,7.74,1.5,17.41,0,5,0.67,0.97,2,3,2,3,2,0
1,0,0,1,1,1,0,0,0,0,0,1,0,0,0,1,0,1,0,0
1,0,0,1,1,1,0,0,0,0,0,1,0,0,0,1,0,1,0,0
1,0,0,1,1,1,0,0,0,0,0,1,0,0,0,1,0,1,0,0
9,3,0,5,5,4,4,6.95,27.62,5307.06,0.06,47,0.04,294.84,17,30,4,13,7,0
1,0,0,1,1,1,2,13.18,5.25,363.24,0.02,20,0.19,20.18,6,14,4,7,2,0
1,0,0,1,1,1,2,5.8,2,23.22,0,5,0.5,1.29,1,4,1,4,2,0
1,0,0,1,1,1,2,5.8,2,23.22,0,5,0.5,1.29,1,4,1,4,2,0
1,0,0,1,1,1,2,5.8,2,23.22,0,5,0.5,1.29,1,4,1,4,2,0
1,0,0,1,1,1,2,5.8,2,23.22,0,5,0.5,1.29,1,4,1,4,2,0
1,0,0,1,1,1,2,5.33,1.5,12,0,4,0.67,0.67,1,3,1,3,2,0
1,0,0,1,1,1,2,5.33,1.5,12,0,4,0.67,0.67,1,3,1,3,2,0
1,0,0,1,1,1,2,5.33,1.5,12,0,4,0.67,0.67,1,3,1,3,2,0
1,0,0,1,1,1,2,5.33,1.5,12,0,4,0.67,0.67,1,3,1,3,2,0
1,0,0,1,1,1,2,5.33,1.5,12,0,4,0.67,0.67,1,3,1,3,2,0
1,0,0,1,1,1,2,5.33,1.5,12,0,4,0.67,0.67,1,3,1,3,2,0
1,0,0,1,1,1,2,5.33,1.5,12,0,4,0.67,0.67,1,3,1,3,2,0
1,0,0,1,1,1,2,5.33,1.5,12,0,4,0.67,0.67,1,3,1,3,2,0
1,0,0,1,1,1,2,5.33,1.5,12,0,4,0.67,0.67,1,3,1,3,2,0
1,0,0,1,1,1,2,5.33,1.5,12,0,4,0.67,0.67,1,3,1,3,2,0
1,0,0,1,1,1,2,5.33,1.5,12,0,4,0.67,0.67,1,3,1,3,2,0
1,0,0,1,1,1,2,5.8,2,23.22,0,5,0.5,1.29,1,4,1,4,2,0
1,0,0,1,1,1,2,5.33,1.5,12,0,4,0.67,0.67,1,3,1,3,2,0
1,0,0,1,1,1,2,5.33,1.5,12,0,4,0.67,0.67,1,3,1,3,2,0
1,0,0,1,1,1,2,5.33,1.5,12,0,4,0.67,0.67,1,3,1,3,2,0
1,0,0,1,1,1,2,5.33,1.5,12,0,4,0.67,0.67,1,3,1,3,2,0
1,0,0,1,1,1,2,5.33,1.5,12,0,4,0.67,0.67,1,3,1,3,2,0
1,0,0,1,1,1,2,11.3,6.13,423.78,0.02,20,0.16,23.54,7,13,4,7,2,0
1,0,0,1,1,1,2,7.74,1.5,17.41,0,5,0.67,0.97,2,3,2,3,2,0
1,0,0,1,1,1,2,7.74,1.5,17.41,0,5,0.67,0.97,2,3,2,3,2,0
21,1,30,11,2,1,73,53.19,34.59,63638.79,0.61,326,0.03,3535.49,147,179,34,16,74,0
5,1,6,3,1,3,9,14.13,13.3,2500.18,0.06,41,0.08,138.9,19,22,10,14,10,0
3,0,4,2,1,1,11,24.32,6,875.68,0.05,35,0.17,48.65,15,20,10,8,11,0
9,1,51,5,1,3,49,26.48,46.67,57674.24,0.41,245,0.02,3204.12,112,133,18,15,50,0
25,2,49,13,3,10,56,28.51,30.36,26281.72,0.29,155,0.03,1460.1,66,89,25,23,58,0
3,0,0,2,2,1,6,5.89,7,288.46,0.01,13,0.14,16.03,4,9,2,7,6,0
1,0,0,1,1,1,2,5.33,1.5,12,0,4,0.67,0.67,1,3,1,3,2,0
381,1,1,191,2,1,950,798.52,47.16,1775590.04,12.55,4755,0.02,98643.89,2188,2567,232,10,951,0
13,1,0,7,1,1,65,218.46,7.77,13181.63,0.57,285,0.13,732.31,145,140,56,6,66,0
41,6,26,23,1,1,128,73.7,38.72,110478.23,0.95,464,0.03,6137.68,228,236,53,18,134,0
1,0,0,1,1,1,0,0,0,0,0,1,0,0,0,1,0,1,0,0
1,0,0,1,1,1,2,5.33,1.5,12,0,4,0.67,0.67,1,3,1,3,2,0
1,0,0,1,1,1,2,5.33,1.5,12,0,4,0.67,0.67,1,3,1,3,2,0
1,0,0,1,1,1,2,5.33,1.5,12,0,4,0.67,0.67,1,3,1,3,2,0
1,0,0,1,1,1,2,5.33,1.5,12,0,4,0.67,0.67,1,3,1,3,2,0
1,0,0,1,1,1,2,5.33,1.5,12,0,4,0.67,0.67,1,3,1,3,2,0
1,0,0,1,1,1,2,5.33,1.5,12,0,4,0.67,0.67,1,3,1,3,2,0
1,0,0,1,1,1,2,5.33,1.5,12,0,4,0.67,0.67,1,3,1,3,2,0
1,0,0,1,1,1,2,5.33,1.5,12,0,4,0.67,0.67,1,3,1,3,2,0
1,0,0,1,1,1,2,5.33,1.5,12,0,4,0.67,0.67,1,3,1,3,2,0
1,0,0,1,1,1,2,5.33,1.5,12,0,4,0.67,0.67,1,3,1,3,2,0
1,0,0,1,1,1,2,5.33,1.5,12,0,4,0.67,0.67,1,3,1,3,2,0
1,0,0,1,1,1,2,5.33,1.5,12,0,4,0.67,0.67,1,3,1,3,2,0
1,0,0,1,1,1,2,7.74,1.5,17.41,0,5,0.67,0.97,2,3,2,3,2,0
1,0,0,1,1,1,2,7.74,1.5,17.41,0,5,0.67,0.97,2,3,2,3,2,0
1,0,0,1,1,1,2,7.74,1.5,17.41,0,5,0.67,0.97,2,3,2,3,2,0
1,0,0,1,1,1,2,7.74,1.5,17.41,0,5,0.67,0.97,2,3,2,3,2,0
1,0,0,1,1,1,2,7.74,1.5,17.41,0,5,0.67,0.97,2,3,2,3,2,0
1,0,0,1,1,1,2,7.74,1.5,17.41,0,5,0.67,0.97,2,3,2,3,2,0
1,0,0,1,1,1,2,7.74,1.5,17.41,0,5,0.67,0.97,2,3,2,3,2,0
1,0,0,1,1,1,0,0,0,0,0,0,0,0,0,0,0,0,0,0
1,0,0,1,1,1,2,7.74,1.5,17.41,0,5,0.67,0.97,2,3,2,3,2,0
1,0,0,1,1,1,0,0,0,0,0,0,0,0,0,0,0,0,0,0
1,0,0,1,1,1,0,0,0,0,0,1,0,0,0,1,0,1,0,0
1,0,0,1,1,1,2,5.33,1.5,12,0,4,0.67,0.67,1,3,1,3,2,0
1,0,0,1,1,1,2,5.33,1.5,12,0,4,0.67,0.67,1,3,1,3,2,0
1,0,0,1,1,1,2,5.33,1.5,12,0,4,0.67,0.67,1,3,1,3,2,0
1,0,0,1,1,1,2,7.74,1.5,17.41,0,5,0.67,0.97,2,3,2,3,2,0
1,0,0,1,1,1,5,39.21,1.5,88.22,0.02,17,0.67,4.9,8,9,8,3,5,0
1,0,0,1,1,1,2,7.74,1.5,17.41,0,5,0.67,0.97,2,3,2,3,2,0
1,0,0,1,1,1,2,7.74,1.5,17.41,0,5,0.67,0.97,2,3,2,3,2,0
1,0,0,1,1,1,2,7.74,1.5,17.41,0,5,0.67,0.97,2,3,2,3,2,0
1,0,0,1,1,1,0,0,0,0,0,1,0,0,0,1,0,1,0,0
1,0,0,1,1,1,0,0,0,0,0,1,0,0,0,1,0,1,0,0
9,3,0,5,5,4,4,6.95,27.62,5307.06,0.06,47,0.04,294.84,17,30,4,13,7,0
1,0,0,1,1,1,2,13.18,5.25,363.24,0.02,20,0.19,20.18,6,14,4,7,2,0
1,0,0,1,1,1,2,5.33,1.5,12,0,4,0.67,0.67,1,3,1,3,2,0
1,0,0,1,1,1,2,5.33,1.5,12,0,4,0.67,0.67,1,3,1,3,2,0
1,0,0,1,1,1,2,5.33,1.5,12,0,4,0.67,0.67,1,3,1,3,2,0
1,0,0,1,1,1,2,11.3,6.13,423.78,0.02,20,0.16,23.54,7,13,4,7,2,0
1,0,0,1,1,1,2,7.74,1.5,17.41,0,5,0.67,0.97,2,3,2,3,2,0
1,0,0,1,1,1,0,0,0,0,0,1,0,0,0,1,0,1,0,0
3,0,0,2,2,1,6,5.89,7,288.46,0.01,13,0.14,16.03,4,9,2,7,6,0
1,0,0,1,1,1,2,5.33,1.5,12,0,4,0.67,0.67,1,3,1,3,2,0
1,0,0,1,1,1,0,0,0,0,0,1,0,0,0,1,0,1,0,0
1,0,0,1,1,1,2,5.33,1.5,12,0,4,0.67,0.67,1,3,1,3,2,0
1,0,0,1,1,1,0,0,0,0,0,1,0,0,0,1,0,1,0,0
65,1,3,33,2,1,161,124.02,34.8,150174.45,1.44,722,0.03,8343.02,329,393,52,11,162,0
1,0,0,1,1,1,0,0,0,0,0,1,0,0,0,1,0,1,0,0
5,0,2,3,1,1,15,15.21,9,1232.25,0.05,37,0.11,68.46,21,16,7,6,15,0
15,3,13,8,3,4,41,32.32,26.36,22461.45,0.28,158,0.04,1247.86,58,100,22,20,44,0
1,0,0,1,1,1,0,0,0,0,0,1,0,0,0,1,0,1,0,0
1,0,0,1,1,1,2,5.33,1.5,12,0,4,0.67,0.67,1,3,1,3,2,0
1,0,0,1,1,1,2,5.33,1.5,12,0,4,0.67,0.67,1,3,1,3,2,0
1,0,0,1,1,1,2,5.33,1.5,12,0,4,0.67,0.67,1,3,1,3,2,0
1,0,0,1,1,1,2,5.33,1.5,12,0,4,0.67,0.67,1,3,1,3,2,0
1,0,0,1,1,1,2,5.33,1.5,12,0,4,0.67,0.67,1,3,1,3,2,0
1,0,0,1,1,1,2,5.33,1.5,12,0,4,0.67,0.67,1,3,1,3,2,0
1,0,0,1,1,1,2,5.33,1.5,12,0,4,0.67,0.67,1,3,1,3,2,0
1,0,0,1,1,1,2,5.33,1.5,12,0,4,0.67,0.67,1,3,1,3,2,0
1,0,0,1,1,1,2,5.33,1.5,12,0,4,0.67,0.67,1,3,1,3,2,0
1,0,0,1,1,1,2,5.33,1.5,12,0,4,0.67,0.67,1,3,1,3,2,0
1,0,0,1,1,1,2,5.33,1.5,12,0,4,0.67,0.67,1,3,1,3,2,0
1,0,0,1,1,1,2,5.33,1.5,12,0,4,0.67,0.67,1,3,1,3,2,0
1,0,0,1,1,1,2,7.74,1.5,17.41,0,5,0.67,0.97,2,3,2,3,2,0
1,0,0,1,1,1,2,7.74,1.5,17.41,0,5,0.67,0.97,2,3,2,3,2,0
1,0,0,1,1,1,2,7.74,1.5,17.41,0,5,0.67,0.97,2,3,2,3,2,0
1,0,0,1,1,1,2,7.74,1.5,17.41,0,5,0.67,0.97,2,3,2,3,2,0
1,0,0,1,1,1,2,7.74,1.5,17.41,0,5,0.67,0.97,2,3,2,3,2,0
1,0,0,1,1,1,2,7.74,1.5,17.41,0,5,0.67,0.97,2,3,2,3,2,0
1,0,0,1,1,1,2,7.74,1.5,17.41,0,5,0.67,0.97,2,3,2,3,2,0
1,0,0,1,1,1,0,0,0,0,0,0,0,0,0,0,0,0,0,0
1,0,0,1,1,1,2,7.74,1.5,17.41,0,5,0.67,0.97,2,3,2,3,2,0
1,0,0,1,1,1,0,0,0,0,0,0,0,0,0,0,0,0,0,0
1,0,0,1,1,1,0,0,0,0,0,1,0,0,0,1,0,1,0,0
1,0,0,1,1,1,2,5.33,1.5,12,0,4,0.67,0.67,1,3,1,3,2,0
1,0,0,1,1,1,2,5.33,1.5,12,0,4,0.67,0.67,1,3,1,3,2,0
1,0,0,1,1,1,2,5.33,1.5,12,0,4,0.67,0.67,1,3,1,3,2,0
1,0,0,1,1,1,2,7.74,1.5,17.41,0,5,0.67,0.97,2,3,2,3,2,0
1,0,0,1,1,1,2,7.74,1.5,17.41,0,5,0.67,0.97,2,3,2,3,2,0
1,0,0,1,1,1,2,7.74,1.5,17.41,0,5,0.67,0.97,2,3,2,3,2,0
1,0,0,1,1,1,0,0,0,0,0,1,0,0,0,1,0,1,0,0
1,0,0,1,1,1,0,0,0,0,0,1,0,0,0,1,0,1,0,0
1,0,0,1,1,1,0,0,0,0,0,1,0,0,0,1,0,1,0,0
9,3,0,5,5,4,4,6.95,27.62,5307.06,0.06,47,0.04,294.84,17,30,4,13,7,0
1,0,0,1,1,1,2,13.18,5.25,363.24,0.02,20,0.19,20.18,6,14,4,7,2,0
1,0,0,1,1,1,2,5.8,2,23.22,0,5,0.5,1.29,1,4,1,4,2,0
1,0,0,1,1,1,2,5.8,2,23.22,0,5,0.5,1.29,1,4,1,4,2,0
1,0,0,1,1,1,2,5.8,2,23.22,0,5,0.5,1.29,1,4,1,4,2,0
1,0,0,1,1,1,2,5.8,2,23.22,0,5,0.5,1.29,1,4,1,4,2,0
1,0,0,1,1,1,2,5.33,1.5,12,0,4,0.67,0.67,1,3,1,3,2,0
1,0,0,1,1,1,2,5.33,1.5,12,0,4,0.67,0.67,1,3,1,3,2,0
1,0,0,1,1,1,2,5.33,1.5,12,0,4,0.67,0.67,1,3,1,3,2,0
1,0,0,1,1,1,2,5.33,1.5,12,0,4,0.67,0.67,1,3,1,3,2,0
1,0,0,1,1,1,2,5.33,1.5,12,0,4,0.67,0.67,1,3,1,3,2,0
1,0,0,1,1,1,2,5.33,1.5,12,0,4,0.67,0.67,1,3,1,3,2,0
1,0,0,1,1,1,2,5.33,1.5,12,0,4,0.67,0.67,1,3,1,3,2,0
1,0,0,1,1,1,2,5.33,1.5,12,0,4,0.67,0.67,1,3,1,3,2,0
1,0,0,1,1,1,2,5.33,1.5,12,0,4,0.67,0.67,1,3,1,3,2,0
1,0,0,1,1,1,2,5.33,1.5,12,0,4,0.67,0.67,1,3,1,3,2,0
1,0,0,1,1,1,2,5.33,1.5,12,0,4,0.67,0.67,1,3,1,3,2,0
1,0,0,1,1,1,2,5.8,2,23.22,0,5,0.5,1.29,1,4,1,4,2,0
1,0,0,1,1,1,2,5.33,1.5,12,0,4,0.67,0.67,1,3,1,3,2,0
1,0,0,1,1,1,2,5.33,1.5,12,0,4,0.67,0.67,1,3,1,3,2,0
1,0,0,1,1,1,2,5.33,1.5,12,0,4,0.67,0.67,1,3,1,3,2,0
1,0,0,1,1,1,2,5.33,1.5,12,0,4,0.67,0.67,1,3,1,3,2,0
1,0,0,1,1,1,2,5.33,1.5,12,0,4,0.67,0.67,1,3,1,3,2,0
1,0,0,1,1,1,2,11.3,6.13,423.78,0.02,20,0.16,23.54,7,13,4,7,2,0
1,0,0,1,1,1,2,7.74,1.5,17.41,0,5,0.67,0.97,2,3,2,3,2,0
1,0,0,1,1,1,2,7.74,1.5,17.41,0,5,0.67,0.97,2,3,2,3,2,0
1,0,0,1,1,1,2,7.74,1.5,17.41,0,5,0.67,0.97,2,3,2,3,2,0
9,1,8,5,1,5,31,51.01,31.25,49810.99,0.53,281,0.03,2767.28,125,156,34,17,32,0
1,0,3,1,1,1,9,39.29,6.92,1883.25,0.09,61,0.14,104.63,20,41,13,9,9,0
21,4,15,11,3,7,51,97.49,18.21,32331.72,0.59,277,0.05,1796.21,111,166,64,21,55,0
15,2,10,8,1,4,38,56.48,23.11,30169.26,0.44,229,0.04,1676.07,104,125,36,16,40,0
1,0,1,1,1,1,4,22.56,3.38,257,0.03,20,0.3,14.28,9,11,8,6,4,0
29,4,18,15,3,3,91,85.05,35.1,104798.43,1,475,0.03,5822.13,218,257,59,19,95,0
3,0,1,2,1,1,5,13.66,4.2,240.91,0.02,16,0.24,13.38,6,10,5,7,5,0
3,0,0,2,2,1,6,5.89,7,288.46,0.01,13,0.14,16.03,4,9,2,7,6,0
1,1,3,1,1,1,20,100.03,9.06,8208.7,0.3,165,0.11,456.04,56,109,34,11,21,0
15,3,14,8,2,1,44,52.07,14.34,10714.04,0.25,136,0.07,595.22,52,84,29,16,47,0
27,4,4,14,6,9,66,62.92,15,14157.88,0.31,169,0.07,786.55,60,109,32,16,70,0
11,1,2,6,2,3,29,63.19,12.75,10272.47,0.27,140,0.08,570.69,51,89,36,18,30,0
33,4,16,17,5,11,79,97.51,21.67,45776.17,0.7,318,0.05,2543.12,130,188,75,25,83,0
11,0,6,6,3,3,18,29.59,8.36,2066.34,0.08,52,0.12,114.8,18,34,14,13,18,0
5,0,4,3,2,1,11,19.59,6.6,853.54,0.04,29,0.15,47.42,11,18,10,12,11,0
3,0,2,2,1,1,10,26.93,4.8,620.48,0.04,31,0.21,34.47,12,19,10,8,10,0
1,0,1,1,1,1,3,7.75,2,31.02,0.01,6,0.5,1.72,2,4,2,4,3,0
29,5,5,15,1,1,94,142.46,19.77,55695.58,0.94,417,0.05,3094.2,174,243,88,20,99,0
19,3,2,10,4,7,32,63.39,12.07,9234.01,0.26,141,0.08,513,50,91,29,14,35,0
419,1,3,210,2,1,1046,1126.81,33.08,1233245.74,12.43,4424,0.03,68513.65,2003,2421,333,11,1047,0
7,1,8,4,4,4,33,22.11,35,27089.44,0.26,161,0.03,1504.97,70,91,14,14,34,0
11,0,0,6,1,1,187,894.09,6.47,37418.93,1.93,768,0.15,2078.83,386,382,179,6,187,0
1,0,0,1,1,1,0,0,0,0,0,1,0,0,0,1,0,1,0,0
1,0,0,1,1,1,2,5.33,1.5,12,0,4,0.67,0.67,1,3,1,3,2,0
1,0,0,1,1,1,2,5.33,1.5,12,0,4,0.67,0.67,1,3,1,3,2,0
1,0,0,1,1,1,2,5.33,1.5,12,0,4,0.67,0.67,1,3,1,3,2,0
1,0,0,1,1,1,2,5.33,1.5,12,0,4,0.67,0.67,1,3,1,3,2,0
1,0,0,1,1,1,2,5.33,1.5,12,0,4,0.67,0.67,1,3,1,3,2,0
1,0,0,1,1,1,2,5.33,1.5,12,0,4,0.67,0.67,1,3,1,3,2,0
1,0,0,1,1,1,2,5.33,1.5,12,0,4,0.67,0.67,1,3,1,3,2,0
1,0,0,1,1,1,2,5.33,1.5,12,0,4,0.67,0.67,1,3,1,3,2,0
1,0,0,1,1,1,2,5.33,1.5,12,0,4,0.67,0.67,1,3,1,3,2,0
1,0,0,1,1,1,2,5.33,1.5,12,0,4,0.67,0.67,1,3,1,3,2,0
1,0,0,1,1,1,2,5.33,1.5,12,0,4,0.67,0.67,1,3,1,3,2,0
1,0,0,1,1,1,2,5.33,1.5,12,0,4,0.67,0.67,1,3,1,3,2,0
1,0,0,1,1,1,2,7.74,1.5,17.41,0,5,0.67,0.97,2,3,2,3,2,0
1,0,0,1,1,1,2,7.74,1.5,17.41,0,5,0.67,0.97,2,3,2,3,2,0
1,0,0,1,1,1,2,7.74,1.5,17.41,0,5,0.67,0.97,2,3,2,3,2,0
1,0,0,1,1,1,2,7.74,1.5,17.41,0,5,0.67,0.97,2,3,2,3,2,0
1,0,0,1,1,1,2,7.74,1.5,17.41,0,5,0.67,0.97,2,3,2,3,2,0
1,0,0,1,1,1,2,7.74,1.5,17.41,0,5,0.67,0.97,2,3,2,3,2,0
1,0,0,1,1,1,2,7.74,1.5,17.41,0,5,0.67,0.97,2,3,2,3,2,0
1,0,0,1,1,1,0,0,0,0,0,0,0,0,0,0,0,0,0,0
1,0,0,1,1,1,2,7.74,1.5,17.41,0,5,0.67,0.97,2,3,2,3,2,0
1,0,0,1,1,1,0,0,0,0,0,0,0,0,0,0,0,0,0,0
1,0,0,1,1,1,0,0,0,0,0,1,0,0,0,1,0,1,0,0
1,0,0,1,1,1,2,5.33,1.5,12,0,4,0.67,0.67,1,3,1,3,2,0
1,0,0,1,1,1,2,5.33,1.5,12,0,4,0.67,0.67,1,3,1,3,2,0
1,0,0,1,1,1,2,5.33,1.5,12,0,4,0.67,0.67,1,3,1,3,2,0
1,0,0,1,1,1,0,0,0,0,0,1,0,0,0,1,0,1,0,0
1,0,0,1,1,1,2,5.33,1.5,12,0,4,0.67,0.67,1,3,1,3,2,0
1,0,0,1,1,1,2,5.33,1.5,12,0,4,0.67,0.67,1,3,1,3,2,0
1,0,0,1,1,1,2,5.33,1.5,12,0,4,0.67,0.67,1,3,1,3,2,0
1,0,0,1,1,1,2,5.33,1.5,12,0,4,0.67,0.67,1,3,1,3,2,0
1,0,0,1,1,1,2,5.33,1.5,12,0,4,0.67,0.67,1,3,1,3,2,0
1,0,0,1,1,1,2,7.74,1.5,17.41,0,5,0.67,0.97,2,3,2,3,2,0
1,0,0,1,1,1,2,7.74,1.5,17.41,0,5,0.67,0.97,2,3,2,3,2,0
1,0,0,1,1,1,2,7.74,1.5,17.41,0,5,0.67,0.97,2,3,2,3,2,0
1,0,0,1,1,1,2,7.74,1.5,17.41,0,5,0.67,0.97,2,3,2,3,2,0
1,0,0,1,1,1,2,7.74,1.5,17.41,0,5,0.67,0.97,2,3,2,3,2,0
1,0,0,1,1,1,2,7.74,1.5,17.41,0,5,0.67,0.97,2,3,2,3,2,0
1,0,0,1,1,1,0,0,0,0,0,0,0,0,0,0,0,0,0,0
1,0,0,1,1,1,2,7.74,1.5,17.41,0,5,0.67,0.97,2,3,2,3,2,0
1,0,0,1,1,1,5,39.21,1.5,88.22,0.02,17,0.67,4.9,8,9,8,3,5,0
1,0,0,1,1,1,2,7.74,1.5,17.41,0,5,0.67,0.97,2,3,2,3,2,0
1,0,0,1,1,1,2,7.74,1.5,17.41,0,5,0.67,0.97,2,3,2,3,2,0
1,0,0,1,1,1,2,7.74,1.5,17.41,0,5,0.67,0.97,2,3,2,3,2,0
1,0,0,1,1,1,0,0,0,0,0,1,0,0,0,1,0,1,0,0
1,0,0,1,1,1,0,0,0,0,0,1,0,0,0,1,0,1,0,0
1,0,0,1,1,1,0,0,0,0,0,1,0,0,0,1,0,1,0,0
9,3,0,5,5,4,4,6.95,27.62,5307.06,0.06,47,0.04,294.84,17,30,4,13,7,0
1,0,0,1,1,1,2,13.18,5.25,363.24,0.02,20,0.19,20.18,6,14,4,7,2,0
1,0,0,1,1,1,2,5.8,2,23.22,0,5,0.5,1.29,1,4,1,4,2,0
1,0,0,1,1,1,2,5.8,2,23.22,0,5,0.5,1.29,1,4,1,4,2,0
1,0,0,1,1,1,2,5.8,2,23.22,0,5,0.5,1.29,1,4,1,4,2,0
1,0,0,1,1,1,2,5.8,2,23.22,0,5,0.5,1.29,1,4,1,4,2,0
1,0,0,1,1,1,2,5.33,1.5,12,0,4,0.67,0.67,1,3,1,3,2,0
1,0,0,1,1,1,2,5.33,1.5,12,0,4,0.67,0.67,1,3,1,3,2,0
1,0,0,1,1,1,2,5.33,1.5,12,0,4,0.67,0.67,1,3,1,3,2,0
1,0,0,1,1,1,2,5.33,1.5,12,0,4,0.67,0.67,1,3,1,3,2,0
1,0,0,1,1,1,2,5.33,1.5,12,0,4,0.67,0.67,1,3,1,3,2,0
1,0,0,1,1,1,2,5.33,1.5,12,0,4,0.67,0.67,1,3,1,3,2,0
1,0,0,1,1,1,2,5.33,1.5,12,0,4,0.67,0.67,1,3,1,3,2,0
1,0,0,1,1,1,2,5.33,1.5,12,0,4,0.67,0.67,1,3,1,3,2,0
1,0,0,1,1,1,2,5.33,1.5,12,0,4,0.67,0.67,1,3,1,3,2,0
1,0,0,1,1,1,2,5.33,1.5,12,0,4,0.67,0.67,1,3,1,3,2,0
1,0,0,1,1,1,2,5.33,1.5,12,0,4,0.67,0.67,1,3,1,3,2,0
1,0,0,1,1,1,2,5.8,2,23.22,0,5,0.5,1.29,1,4,1,4,2,0
1,0,0,1,1,1,2,5.33,1.5,12,0,4,0.67,0.67,1,3,1,3,2,0
1,0,0,1,1,1,2,5.33,1.5,12,0,4,0.67,0.67,1,3,1,3,2,0
1,0,0,1,1,1,2,5.33,1.5,12,0,4,0.67,0.67,1,3,1,3,2,0
1,0,0,1,1,1,2,5.33,1.5,12,0,4,0.67,0.67,1,3,1,3,2,0
1,0,0,1,1,1,2,5.33,1.5,12,0,4,0.67,0.67,1,3,1,3,2,0
1,0,0,1,1,1,2,11.3,6.13,423.78,0.02,20,0.16,23.54,7,13,4,7,2,0
1,0,0,1,1,1,2,7.74,1.5,17.41,0,5,0.67,0.97,2,3,2,3,2,0
1,0,0,1,1,1,2,7.74,1.5,17.41,0,5,0.67,0.97,2,3,2,3,2,0
1,0,0,1,1,1,2,7.74,1.5,17.41,0,5,0.67,0.97,2,3,2,3,2,0
1,0,1,1,1,1,2,9.9,3.33,110,0.01,11,0.3,6.11,4,7,3,5,2,0
3,0,0,2,2,1,6,5.89,7,288.46,0.01,13,0.14,16.03,4,9,2,7,6,0
1,0,3,1,1,1,4,12.68,2.5,79.25,0.01,10,0.4,4.4,4,6,4,5,4,0
5,1,5,3,2,1,16,31.18,7.94,1967.92,0.08,50,0.13,109.33,22,28,18,13,17,0
9,1,3,5,1,4,29,51.46,7.91,3218.98,0.14,80,0.13,178.83,29,51,22,12,30,1
23,5,16,12,5,7,54,66.71,20.22,27279.99,0.45,224,0.05,1515.55,91,133,45,20,59,0
3,0,2,2,2,1,13,26.05,4.55,539.34,0.04,29,0.22,29.96,13,16,10,7,13,0
3,0,2,2,1,1,11,30.17,4.2,532.19,0.04,31,0.24,29.57,12,19,10,7,11,0
3,1,1,2,2,1,10,16.65,4.67,362.64,0.03,21,0.21,20.15,8,13,6,7,11,0
43,6,10,22,3,10,95,124.6,22.77,64628.74,0.95,435,0.04,3590.49,154,281,71,21,101,1
15,1,9,8,2,3,45,56.18,10.75,6492.35,0.2,112,0.09,360.69,43,69,28,14,46,0
93,2,5,47,2,1,230,287.47,19.11,104930.94,1.83,818,0.05,5829.5,363,455,95,10,232,1
3,0,10,2,2,1,20,25.53,14.62,5460.2,0.12,85,0.07,303.34,39,46,12,9,20,0
1,0,0,1,1,1,59,480.28,2.85,3901.07,0.46,229,0.35,216.73,114,115,60,3,59,1
1,0,0,1,1,1,0,0,0,0,0,1,0,0,0,1,0,1,0,0
1,0,0,1,1,1,2,5.33,1.5,12,0,4,0.67,0.67,1,3,1,3,2,0
1,0,0,1,1,1,2,5.33,1.5,12,0,4,0.67,0.67,1,3,1,3,2,0
1,0,0,1,1,1,2,5.33,1.5,12,0,4,0.67,0.67,1,3,1,3,2,0
1,0,0,1,1,1,2,5.33,1.5,12,0,4,0.67,0.67,1,3,1,3,2,0
1,0,0,1,1,1,2,5.33,1.5,12,0,4,0.67,0.67,1,3,1,3,2,0
1,0,0,1,1,1,2,5.33,1.5,12,0,4,0.67,0.67,1,3,1,3,2,0
1,0,0,1,1,1,2,5.33,1.5,12,0,4,0.67,0.67,1,3,1,3,2,0
1,0,0,1,1,1,2,5.33,1.5,12,0,4,0.67,0.67,1,3,1,3,2,0
1,0,0,1,1,1,2,5.33,1.5,12,0,4,0.67,0.67,1,3,1,3,2,0
1,0,0,1,1,1,2,5.33,1.5,12,0,4,0.67,0.67,1,3,1,3,2,0
1,0,0,1,1,1,2,5.33,1.5,12,0,4,0.67,0.67,1,3,1,3,2,0
1,0,0,1,1,1,2,5.33,1.5,12,0,4,0.67,0.67,1,3,1,3,2,0
1,0,0,1,1,1,2,7.74,1.5,17.41,0,5,0.67,0.97,2,3,2,3,2,0
1,0,0,1,1,1,2,7.74,1.5,17.41,0,5,0.67,0.97,2,3,2,3,2,0
1,0,0,1,1,1,2,7.74,1.5,17.41,0,5,0.67,0.97,2,3,2,3,2,0
1,0,0,1,1,1,2,7.74,1.5,17.41,0,5,0.67,0.97,2,3,2,3,2,0
1,0,0,1,1,1,2,7.74,1.5,17.41,0,5,0.67,0.97,2,3,2,3,2,0
1,0,0,1,1,1,2,7.74,1.5,17.41,0,5,0.67,0.97,2,3,2,3,2,0
1,0,0,1,1,1,2,7.74,1.5,17.41,0,5,0.67,0.97,2,3,2,3,2,0
1,0,0,1,1,1,0,0,0,0,0,0,0,0,0,0,0,0,0,0
1,0,0,1,1,1,2,7.74,1.5,17.41,0,5,0.67,0.97,2,3,2,3,2,0
1,0,0,1,1,1,0,0,0,0,0,0,0,0,0,0,0,0,0,0
1,0,0,1,1,1,0,0,0,0,0,1,0,0,0,1,0,1,0,0
1,0,0,1,1,1,2,5.33,1.5,12,0,4,0.67,0.67,1,3,1,3,2,0
1,0,0,1,1,1,2,5.33,1.5,12,0,4,0.67,0.67,1,3,1,3,2,0
1,0,0,1,1,1,2,5.33,1.5,12,0,4,0.67,0.67,1,3,1,3,2,0
1,0,0,1,1,1,0,0,0,0,0,1,0,0,0,1,0,1,0,0
1,0,0,1,1,1,2,5.33,1.5,12,0,4,0.67,0.67,1,3,1,3,2,0
1,0,0,1,1,1,2,5.33,1.5,12,0,4,0.67,0.67,1,3,1,3,2,0
1,0,0,1,1,1,2,5.33,1.5,12,0,4,0.67,0.67,1,3,1,3,2,0
1,0,0,1,1,1,2,5.33,1.5,12,0,4,0.67,0.67,1,3,1,3,2,0
1,0,0,1,1,1,2,5.33,1.5,12,0,4,0.67,0.67,1,3,1,3,2,0
1,0,0,1,1,1,2,7.74,1.5,17.41,0,5,0.67,0.97,2,3,2,3,2,0
1,0,0,1,1,1,2,7.74,1.5,17.41,0,5,0.67,0.97,2,3,2,3,2,0
1,0,0,1,1,1,2,7.74,1.5,17.41,0,5,0.67,0.97,2,3,2,3,2,0
1,0,0,1,1,1,2,7.74,1.5,17.41,0,5,0.67,0.97,2,3,2,3,2,0
1,0,0,1,1,1,2,7.74,1.5,17.41,0,5,0.67,0.97,2,3,2,3,2,0
1,0,0,1,1,1,2,7.74,1.5,17.41,0,5,0.67,0.97,2,3,2,3,2,0
1,0,0,1,1,1,0,0,0,0,0,0,0,0,0,0,0,0,0,0
1,0,0,1,1,1,2,7.74,1.5,17.41,0,5,0.67,0.97,2,3,2,3,2,0
1,0,0,1,1,1,5,39.21,1.5,88.22,0.02,17,0.67,4.9,8,9,8,3,5,0
1,0,0,1,1,1,2,7.74,1.5,17.41,0,5,0.67,0.97,2,3,2,3,2,0
1,0,0,1,1,1,2,7.74,1.5,17.41,0,5,0.67,0.97,2,3,2,3,2,0
1,0,0,1,1,1,2,7.74,1.5,17.41,0,5,0.67,0.97,2,3,2,3,2,0
1,0,0,1,1,1,0,0,0,0,0,1,0,0,0,1,0,1,0,0
1,0,0,1,1,1,0,0,0,0,0,1,0,0,0,1,0,1,0,0
1,0,0,1,1,1,0,0,0,0,0,1,0,0,0,1,0,1,0,0
9,3,0,5,5,4,4,6.95,27.62,5307.06,0.06,47,0.04,294.84,17,30,4,13,7,0
1,0,0,1,1,1,2,13.18,5.25,363.24,0.02,20,0.19,20.18,6,14,4,7,2,0
1,0,0,1,1,1,2,5.8,2,23.22,0,5,0.5,1.29,1,4,1,4,2,0
1,0,0,1,1,1,2,5.8,2,23.22,0,5,0.5,1.29,1,4,1,4,2,0
1,0,0,1,1,1,2,5.8,2,23.22,0,5,0.5,1.29,1,4,1,4,2,0
1,0,0,1,1,1,2,5.8,2,23.22,0,5,0.5,1.29,1,4,1,4,2,0
1,0,0,1,1,1,2,5.33,1.5,12,0,4,0.67,0.67,1,3,1,3,2,0
1,0,0,1,1,1,2,5.33,1.5,12,0,4,0.67,0.67,1,3,1,3,2,0
1,0,0,1,1,1,2,5.33,1.5,12,0,4,0.67,0.67,1,3,1,3,2,0
1,0,0,1,1,1,2,5.33,1.5,12,0,4,0.67,0.67,1,3,1,3,2,0
1,0,0,1,1,1,2,5.33,1.5,12,0,4,0.67,0.67,1,3,1,3,2,0
1,0,0,1,1,1,2,5.33,1.5,12,0,4,0.67,0.67,1,3,1,3,2,0
1,0,0,1,1,1,2,5.33,1.5,12,0,4,0.67,0.67,1,3,1,3,2,0
1,0,0,1,1,1,2,5.33,1.5,12,0,4,0.67,0.67,1,3,1,3,2,0
1,0,0,1,1,1,2,5.33,1.5,12,0,4,0.67,0.67,1,3,1,3,2,0
1,0,0,1,1,1,2,5.33,1.5,12,0,4,0.67,0.67,1,3,1,3,2,0
1,0,0,1,1,1,2,5.33,1.5,12,0,4,0.67,0.67,1,3,1,3,2,0
1,0,0,1,1,1,2,5.8,2,23.22,0,5,0.5,1.29,1,4,1,4,2,0
1,0,0,1,1,1,2,5.33,1.5,12,0,4,0.67,0.67,1,3,1,3,2,0
1,0,0,1,1,1,2,5.33,1.5,12,0,4,0.67,0.67,1,3,1,3,2,0
1,0,0,1,1,1,2,5.33,1.5,12,0,4,0.67,0.67,1,3,1,3,2,0
1,0,0,1,1,1,2,5.33,1.5,12,0,4,0.67,0.67,1,3,1,3,2,0
1,0,0,1,1,1,2,5.33,1.5,12,0,4,0.67,0.67,1,3,1,3,2,0
13,1,13,7,2,1,28,44.37,12.8,7269.13,0.19,106,0.08,403.84,40,66,25,16,29,1
1,0,0,1,1,1,2,11.3,6.13,423.78,0.02,20,0.16,23.54,7,13,4,7,2,0
43,21,12,22,1,17,73,31.02,36.21,40675.75,0.37,219,0.03,2259.76,86,133,19,16,94,1
29,1,2,15,2,1,70,70.43,20.11,28480,0.47,261,0.05,1582.22,117,144,32,11,71,0
1,0,0,1,1,1,2,7.74,1.5,17.41,0,5,0.67,0.97,2,3,2,3,2,0
1,0,0,1,1,1,27,29.42,8.5,2125.35,0.08,64,0.12,118.07,34,30,10,5,27,1
1,0,0,1,1,1,0,0,0,0,0,1,0,0,0,1,0,1,0,0
1,0,0,1,1,1,2,5.33,1.5,12,0,4,0.67,0.67,1,3,1,3,2,0
1,0,0,1,1,1,2,5.33,1.5,12,0,4,0.67,0.67,1,3,1,3,2,0
1,0,0,1,1,1,2,5.33,1.5,12,0,4,0.67,0.67,1,3,1,3,2,0
1,0,0,1,1,1,2,5.33,1.5,12,0,4,0.67,0.67,1,3,1,3,2,0
1,0,0,1,1,1,2,5.33,1.5,12,0,4,0.67,0.67,1,3,1,3,2,0
1,0,0,1,1,1,2,5.33,1.5,12,0,4,0.67,0.67,1,3,1,3,2,0
1,0,0,1,1,1,2,5.33,1.5,12,0,4,0.67,0.67,1,3,1,3,2,0
1,0,0,1,1,1,2,5.33,1.5,12,0,4,0.67,0.67,1,3,1,3,2,0
1,0,0,1,1,1,2,5.33,1.5,12,0,4,0.67,0.67,1,3,1,3,2,0
1,0,0,1,1,1,2,5.33,1.5,12,0,4,0.67,0.67,1,3,1,3,2,0
1,0,0,1,1,1,2,5.33,1.5,12,0,4,0.67,0.67,1,3,1,3,2,0
1,0,0,1,1,1,2,5.33,1.5,12,0,4,0.67,0.67,1,3,1,3,2,0
1,0,0,1,1,1,2,7.74,1.5,17.41,0,5,0.67,0.97,2,3,2,3,2,0
1,0,0,1,1,1,2,7.74,1.5,17.41,0,5,0.67,0.97,2,3,2,3,2,0
1,0,0,1,1,1,2,7.74,1.5,17.41,0,5,0.67,0.97,2,3,2,3,2,0
1,0,0,1,1,1,2,7.74,1.5,17.41,0,5,0.67,0.97,2,3,2,3,2,0
1,0,0,1,1,1,2,7.74,1.5,17.41,0,5,0.67,0.97,2,3,2,3,2,0
1,0,0,1,1,1,2,7.74,1.5,17.41,0,5,0.67,0.97,2,3,2,3,2,0
1,0,0,1,1,1,2,7.74,1.5,17.41,0,5,0.67,0.97,2,3,2,3,2,0
1,0,0,1,1,1,0,0,0,0,0,0,0,0,0,0,0,0,0,0
1,0,0,1,1,1,2,7.74,1.5,17.41,0,5,0.67,0.97,2,3,2,3,2,0
1,0,0,1,1,1,0,0,0,0,0,0,0,0,0,0,0,0,0,0
1,0,0,1,1,1,0,0,0,0,0,1,0,0,0,1,0,1,0,0
1,0,0,1,1,1,2,5.33,1.5,12,0,4,0.67,0.67,1,3,1,3,2,0
1,0,0,1,1,1,2,5.33,1.5,12,0,4,0.67,0.67,1,3,1,3,2,0
1,0,0,1,1,1,2,5.33,1.5,12,0,4,0.67,0.67,1,3,1,3,2,0
3,1,6,2,1,1,9,19.72,3.33,219.1,0.02,19,0.3,12.17,8,11,6,5,10,0
1,0,0,1,1,1,2,7.74,1.5,17.41,0,5,0.67,0.97,2,3,2,3,2,0
1,0,0,1,1,1,5,39.21,1.5,88.22,0.02,17,0.67,4.9,8,9,8,3,5,0
3,1,0,2,1,1,8,16.61,3,149.49,0.02,15,0.33,8.3,6,9,5,5,9,0
3,1,0,2,1,1,8,16.61,3,149.49,0.02,15,0.33,8.3,6,9,5,5,9,0
1,0,0,1,1,1,2,7.74,1.5,17.41,0,5,0.67,0.97,2,3,2,3,2,0
1,0,0,1,1,1,2,7.74,1.5,17.41,0,5,0.67,0.97,2,3,2,3,2,0
1,0,0,1,1,1,2,7.74,1.5,17.41,0,5,0.67,0.97,2,3,2,3,2,0
1,0,0,1,1,1,0,0,0,0,0,1,0,0,0,1,0,1,0,0
9,3,0,5,5,4,4,6.95,27.62,5307.06,0.06,47,0.04,294.84,17,30,4,13,7,0
1,0,0,1,1,1,2,13.18,5.25,363.24,0.02,20,0.19,20.18,6,14,4,7,2,0
1,0,0,1,1,1,2,5.33,1.5,12,0,4,0.67,0.67,1,3,1,3,2,0
1,0,0,1,1,1,2,5.33,1.5,12,0,4,0.67,0.67,1,3,1,3,2,0
1,0,0,1,1,1,2,5.33,1.5,12,0,4,0.67,0.67,1,3,1,3,2,0
1,0,0,1,1,1,2,11.3,6.13,423.78,0.02,20,0.16,23.54,7,13,4,7,2,0
1,0,0,1,1,1,0,0,0,0,0,1,0,0,0,1,0,1,0,0
1,0,0,1,1,1,2,5.33,1.5,12,0,4,0.67,0.67,1,3,1,3,2,0
1,0,0,1,1,1,2,5.33,1.5,12,0,4,0.67,0.67,1,3,1,3,2,0
1,0,0,1,1,1,2,5.33,1.5,12,0,4,0.67,0.67,1,3,1,3,2,0
1,0,0,1,1,1,2,5.33,1.5,12,0,4,0.67,0.67,1,3,1,3,2,0
1,0,0,1,1,1,2,5.33,1.5,12,0,4,0.67,0.67,1,3,1,3,2,0
1,0,0,1,1,1,2,5.33,1.5,12,0,4,0.67,0.67,1,3,1,3,2,0
1,0,0,1,1,1,2,5.33,1.5,12,0,4,0.67,0.67,1,3,1,3,2,0
1,0,0,1,1,1,2,5.33,1.5,12,0,4,0.67,0.67,1,3,1,3,2,0
1,0,0,1,1,1,2,5.33,1.5,12,0,4,0.67,0.67,1,3,1,3,2,0
1,0,0,1,1,1,2,5.33,1.5,12,0,4,0.67,0.67,1,3,1,3,2,0
1,0,0,1,1,1,2,5.33,1.5,12,0,4,0.67,0.67,1,3,1,3,2,0
1,0,0,1,1,1,2,5.33,1.5,12,0,4,0.67,0.67,1,3,1,3,2,0
5,1,0,3,1,1,13,27.01,5.6,846.92,0.05,37,0.18,47.05,16,21,10,7,14,0
3,0,0,2,1,1,20,39.65,9.25,3392.87,0.12,80,0.11,188.49,37,43,16,8,20,0
3,0,7,2,1,1,5,11.53,4.8,265.68,0.02,16,0.21,14.76,8,8,5,6,5,0
3,0,7,2,1,1,5,11.53,4.8,265.68,0.02,16,0.21,14.76,8,8,5,6,5,0
1,0,0,1,1,1,2,7.74,1.5,17.41,0,5,0.67,0.97,2,3,2,3,2,0
1,0,0,1,1,1,2,7.74,1.5,17.41,0,5,0.67,0.97,2,3,2,3,2,0
1,0,0,1,1,1,2,7.74,1.5,17.41,0,5,0.67,0.97,2,3,2,3,2,0
1,0,0,1,1,1,2,7.74,1.5,17.41,0,5,0.67,0.97,2,3,2,3,2,0
1,0,0,1,1,1,2,7.74,1.5,17.41,0,5,0.67,0.97,2,3,2,3,2,0
3,0,7,2,1,1,5,11.53,4.8,265.68,0.02,16,0.21,14.76,8,8,5,6,5,0
1,0,0,1,1,1,2,7.74,1.5,17.41,0,5,0.67,0.97,2,3,2,3,2,0
3,0,7,2,1,1,5,11.53,4.8,265.68,0.02,16,0.21,14.76,8,8,5,6,5,0
3,0,7,2,1,1,5,11.53,4.8,265.68,0.02,16,0.21,14.76,8,8,5,6,5,0
1,0,0,1,1,1,2,7.74,1.5,17.41,0,5,0.67,0.97,2,3,2,3,2,0
1,0,0,1,1,1,0,0,0,0,0,0,0,0,0,0,0,0,0,0
1,0,0,1,1,1,0,0,0,0,0,1,0,0,0,1,0,1,0,0
1,0,0,1,1,1,2,5.33,1.5,12,0,4,0.67,0.67,1,3,1,3,2,0
1,0,0,1,1,1,2,5.33,1.5,12,0,4,0.67,0.67,1,3,1,3,2,0
1,0,0,1,1,1,2,5.33,1.5,12,0,4,0.67,0.67,1,3,1,3,2,0
1,0,0,1,1,1,2,7.74,1.5,17.41,0,5,0.67,0.97,2,3,2,3,2,0
1,0,0,1,1,1,2,7.74,1.5,17.41,0,5,0.67,0.97,2,3,2,3,2,0
1,0,0,1,1,1,2,7.74,1.5,17.41,0,5,0.67,0.97,2,3,2,3,2,0
1,0,0,1,1,1,0,0,0,0,0,1,0,0,0,1,0,1,0,0
1,0,0,1,1,1,0,0,0,0,0,1,0,0,0,1,0,1,0,0
1,0,0,1,1,1,0,0,0,0,0,1,0,0,0,1,0,1,0,0
9,3,0,5,5,4,4,6.95,27.62,5307.06,0.06,47,0.04,294.84,17,30,4,13,7,0
1,0,0,1,1,1,0,5.33,1.5,12,0,4,0.67,0.67,1,3,1,3,0,0
1,0,0,1,1,1,0,5.33,1.5,12,0,4,0.67,0.67,1,3,1,3,0,0
1,0,0,1,1,1,0,5.33,1.5,12,0,4,0.67,0.67,1,3,1,3,0,0
1,0,0,1,1,1,2,13.18,5.25,363.24,0.02,20,0.19,20.18,6,14,4,7,2,0
1,0,0,1,1,1,2,5.8,2,23.22,0,5,0.5,1.29,1,4,1,4,2,0
1,0,0,1,1,1,2,5.8,2,23.22,0,5,0.5,1.29,1,4,1,4,2,0
1,0,0,1,1,1,2,5.8,2,23.22,0,5,0.5,1.29,1,4,1,4,2,0
1,0,0,1,1,1,2,5.8,2,23.22,0,5,0.5,1.29,1,4,1,4,2,0
1,0,0,1,1,1,2,5.33,1.5,12,0,4,0.67,0.67,1,3,1,3,2,0
1,0,0,1,1,1,2,5.33,1.5,12,0,4,0.67,0.67,1,3,1,3,2,0
1,0,0,1,1,1,2,5.33,1.5,12,0,4,0.67,0.67,1,3,1,3,2,0
1,0,0,1,1,1,2,5.33,1.5,12,0,4,0.67,0.67,1,3,1,3,2,0
1,0,0,1,1,1,2,5.33,1.5,12,0,4,0.67,0.67,1,3,1,3,2,0
1,0,0,1,1,1,2,5.33,1.5,12,0,4,0.67,0.67,1,3,1,3,2,0
1,0,0,1,1,1,2,5.33,1.5,12,0,4,0.67,0.67,1,3,1,3,2,0
1,0,0,1,1,1,2,5.33,1.5,12,0,4,0.67,0.67,1,3,1,3,2,0
1,0,0,1,1,1,2,5.33,1.5,12,0,4,0.67,0.67,1,3,1,3,2,0
1,0,0,1,1,1,2,5.33,1.5,12,0,4,0.67,0.67,1,3,1,3,2,0
1,0,0,1,1,1,2,5.33,1.5,12,0,4,0.67,0.67,1,3,1,3,2,0
1,0,0,1,1,1,2,5.8,2,23.22,0,5,0.5,1.29,1,4,1,4,2,0
1,0,0,1,1,1,2,5.33,1.5,12,0,4,0.67,0.67,1,3,1,3,2,0
1,0,0,1,1,1,2,5.33,1.5,12,0,4,0.67,0.67,1,3,1,3,2,0
1,0,0,1,1,1,2,5.33,1.5,12,0,4,0.67,0.67,1,3,1,3,2,0
1,0,0,1,1,1,2,5.33,1.5,12,0,4,0.67,0.67,1,3,1,3,2,0
1,0,0,1,1,1,2,5.33,1.5,12,0,4,0.67,0.67,1,3,1,3,2,0
1,0,0,1,1,1,2,11.3,6.13,423.78,0.02,20,0.16,23.54,7,13,4,7,2,0
1,0,0,1,1,1,2,7.74,1.5,17.41,0,5,0.67,0.97,2,3,2,3,2,0
1,0,0,1,1,1,2,7.74,1.5,17.41,0,5,0.67,0.97,2,3,2,3,2,0
1,0,0,1,1,1,0,0,0,0,0,1,0,0,0,1,0,1,0,0
1,0,0,1,1,1,2,5.33,1.5,12,0,4,0.67,0.67,1,3,1,3,2,0
1,0,0,1,1,1,2,5.33,1.5,12,0,4,0.67,0.67,1,3,1,3,2,0
1,0,0,1,1,1,2,5.33,1.5,12,0,4,0.67,0.67,1,3,1,3,2,0
1,0,0,1,1,1,2,5.33,1.5,12,0,4,0.67,0.67,1,3,1,3,2,0
1,0,0,1,1,1,2,5.33,1.5,12,0,4,0.67,0.67,1,3,1,3,2,0
1,0,0,1,1,1,2,5.33,1.5,12,0,4,0.67,0.67,1,3,1,3,2,0
1,0,0,1,1,1,2,5.33,1.5,12,0,4,0.67,0.67,1,3,1,3,2,0
1,0,0,1,1,1,2,5.33,1.5,12,0,4,0.67,0.67,1,3,1,3,2,0
1,0,0,1,1,1,2,5.33,1.5,12,0,4,0.67,0.67,1,3,1,3,2,0
1,0,0,1,1,1,2,5.33,1.5,12,0,4,0.67,0.67,1,3,1,3,2,0
1,0,0,1,1,1,2,5.33,1.5,12,0,4,0.67,0.67,1,3,1,3,2,0
1,0,0,1,1,1,2,5.33,1.5,12,0,4,0.67,0.67,1,3,1,3,2,0
1,0,0,1,1,1,2,7.74,1.5,17.41,0,5,0.67,0.97,2,3,2,3,2,0
1,0,0,1,1,1,2,7.74,1.5,17.41,0,5,0.67,0.97,2,3,2,3,2,0
1,0,0,1,1,1,2,7.74,1.5,17.41,0,5,0.67,0.97,2,3,2,3,2,0
1,0,0,1,1,1,2,7.74,1.5,17.41,0,5,0.67,0.97,2,3,2,3,2,0
1,0,0,1,1,1,2,7.74,1.5,17.41,0,5,0.67,0.97,2,3,2,3,2,0
1,0,0,1,1,1,2,7.74,1.5,17.41,0,5,0.67,0.97,2,3,2,3,2,0
9,0,0,5,3,1,16,13.2,11.25,1670.2,0.05,38,0.09,92.79,15,23,6,9,16,0
11,3,9,6,2,5,31,50.45,19.92,20022.14,0.34,179,0.05,1112.34,75,104,32,17,34,0
5,3,5,3,2,1,26,34.32,17.59,10615.34,0.2,123,0.06,589.74,46,77,17,13,29,0
15,6,25,8,7,1,48,49.74,16,12732.54,0.27,141,0.06,707.36,68,73,34,16,54,0
23,6,64,12,8,7,70,75.45,22.43,37944,0.56,282,0.04,2108,124,158,47,17,76,1
19,3,7,10,9,3,47,21.37,45,43272.27,0.32,186,0.02,2404.02,72,114,16,20,50,0
7,0,6,4,2,1,14,37.37,9.55,3405.1,0.12,69,0.1,189.17,30,39,22,14,14,0
1,0,1,1,1,1,2,7.74,1.5,17.41,0,5,0.67,0.97,2,3,2,3,2,0
1,0,8,1,1,1,8,38.54,3.82,561.84,0.05,36,0.26,31.21,14,22,11,6,8,0
323,1,4,162,3,1,823,545.95,59.58,1938231.09,10.84,4170,0.02,107679.51,1925,2245,210,13,824,0
11,1,40,6,2,1,67,91.12,19.29,33890.31,0.59,283,0.05,1882.79,120,163,56,18,68,0
21,3,47,11,3,8,42,19.25,40.59,31716.38,0.26,150,0.02,1762.02,69,81,17,20,45,0
19,0,2,10,1,1,101,284.56,8.91,22586.42,0.85,385,0.11,1254.8,196,189,88,8,101,0
9,1,27,5,4,1,39,77.85,17.63,24182.87,0.46,227,0.06,1343.49,94,133,48,18,40,0
1,0,7,1,1,1,9,31.52,11.79,4378.49,0.12,80,0.08,243.25,30,50,14,11,9,0
1,0,1,1,1,1,4,12,4.5,243,0.02,18,0.22,13.5,9,9,4,4,4,0
17,1,4,9,5,4,43,40.64,14.96,9090.89,0.2,115,0.07,505.05,43,72,23,16,44,0
5,3,11,3,3,1,24,50.46,13.25,8859.58,0.22,124,0.08,492.2,53,71,28,14,27,0
1,0,0,1,1,1,2,7.74,1.5,17.41,0,5,0.67,0.97,2,3,2,3,2,0
1,0,0,1,1,1,0,0,0,0,0,0,0,0,0,0,0,0,0,0
1,0,0,1,1,1,2,7.74,1.5,17.41,0,5,0.67,0.97,2,3,2,3,2,0
1,0,0,1,1,1,0,0,0,0,0,0,0,0,0,0,0,0,0,0
1,0,0,1,1,1,0,0,0,0,0,1,0,0,0,1,0,1,0,0
1,0,0,1,1,1,2,5.33,1.5,12,0,4,0.67,0.67,1,3,1,3,2,0
1,0,0,1,1,1,2,5.33,1.5,12,0,4,0.67,0.67,1,3,1,3,2,0
1,0,0,1,1,1,2,5.33,1.5,12,0,4,0.67,0.67,1,3,1,3,2,0
1,0,0,1,1,1,2,7.74,1.5,17.41,0,5,0.67,0.97,2,3,2,3,2,0
1,0,0,1,1,1,5,39.21,1.5,88.22,0.02,17,0.67,4.9,8,9,8,3,5,0
1,0,0,1,1,1,2,7.74,1.5,17.41,0,5,0.67,0.97,2,3,2,3,2,0
1,0,0,1,1,1,2,7.74,1.5,17.41,0,5,0.67,0.97,2,3,2,3,2,0
1,0,0,1,1,1,2,7.74,1.5,17.41,0,5,0.67,0.97,2,3,2,3,2,0
1,0,0,1,1,1,0,0,0,0,0,1,0,0,0,1,0,1,0,0
1,0,0,1,1,1,0,0,0,0,0,1,0,0,0,1,0,1,0,0
9,3,0,5,5,4,4,6.95,27.62,5307.06,0.06,47,0.04,294.84,17,30,4,13,7,0
1,0,0,1,1,1,2,13.18,5.25,363.24,0.02,20,0.19,20.18,6,14,4,7,2,0
1,0,0,1,1,1,2,5.33,1.5,12,0,4,0.67,0.67,1,3,1,3,2,0
1,0,0,1,1,1,2,5.33,1.5,12,0,4,0.67,0.67,1,3,1,3,2,0
1,0,0,1,1,1,2,5.33,1.5,12,0,4,0.67,0.67,1,3,1,3,2,0
1,0,0,1,1,1,2,11.3,6.13,423.78,0.02,20,0.16,23.54,7,13,4,7,2,0
1,0,0,1,1,1,2,7.74,1.5,17.41,0,5,0.67,0.97,2,3,2,3,2,0
1,0,0,1,1,1,2,7.74,1.5,17.41,0,5,0.67,0.97,2,3,2,3,2,0
1,0,0,1,1,1,0,0,0,0,0,1,0,0,0,1,0,1,0,0
1,0,0,1,1,1,2,5.33,1.5,12,0,4,0.67,0.67,1,3,1,3,2,0
1,0,0,1,1,1,0,0,0,0,0,1,0,0,0,1,0,1,0,0
1,0,0,1,1,1,2,5.33,1.5,12,0,4,0.67,0.67,1,3,1,3,2,0
1,0,0,1,1,1,0,0,0,0,0,1,0,0,0,1,0,1,0,0
1,0,0,1,1,1,0,0,0,0,0,1,0,0,0,1,0,1,0,0
1,0,0,1,1,1,2,7.74,1.5,17.41,0,5,0.67,0.97,2,3,2,3,2,0
1,0,0,1,1,1,2,7.74,1.5,17.41,0,5,0.67,0.97,2,3,2,3,2,0
1,0,0,1,1,1,0,0,0,0,0,1,0,0,0,1,0,1,0,0
1,0,0,1,1,1,2,5.33,1.5,12,0,4,0.67,0.67,1,3,1,3,2,0
1,0,0,1,1,1,2,5.33,1.5,12,0,4,0.67,0.67,1,3,1,3,2,0
1,0,0,1,1,1,2,5.33,1.5,12,0,4,0.67,0.67,1,3,1,3,2,0
1,0,0,1,1,1,2,5.33,1.5,12,0,4,0.67,0.67,1,3,1,3,2,0
1,0,0,1,1,1,2,5.33,1.5,12,0,4,0.67,0.67,1,3,1,3,2,0
1,0,0,1,1,1,2,5.33,1.5,12,0,4,0.67,0.67,1,3,1,3,2,0
1,0,0,1,1,1,2,5.33,1.5,12,0,4,0.67,0.67,1,3,1,3,2,0
1,0,0,1,1,1,2,5.33,1.5,12,0,4,0.67,0.67,1,3,1,3,2,0
1,0,0,1,1,1,2,5.33,1.5,12,0,4,0.67,0.67,1,3,1,3,2,0
1,0,0,1,1,1,2,5.33,1.5,12,0,4,0.67,0.67,1,3,1,3,2,0
1,0,0,1,1,1,2,5.33,1.5,12,0,4,0.67,0.67,1,3,1,3,2,0
1,0,0,1,1,1,2,5.33,1.5,12,0,4,0.67,0.67,1,3,1,3,2,0
1,0,0,1,1,1,2,7.74,1.5,17.41,0,5,0.67,0.97,2,3,2,3,2,0
1,0,0,1,1,1,2,7.74,1.5,17.41,0,5,0.67,0.97,2,3,2,3,2,0
1,0,0,1,1,1,2,7.74,1.5,17.41,0,5,0.67,0.97,2,3,2,3,2,0
1,0,0,1,1,1,2,7.74,1.5,17.41,0,5,0.67,0.97,2,3,2,3,2,0
1,0,0,1,1,1,2,7.74,1.5,17.41,0,5,0.67,0.97,2,3,2,3,2,0
1,0,0,1,1,1,2,7.74,1.5,17.41,0,5,0.67,0.97,2,3,2,3,2,0
9,0,5,5,5,1,22,20.73,9,1679.04,0.06,49,0.11,93.28,18,31,7,7,22,0
3,0,0,2,2,1,6,5.89,7,288.46,0.01,13,0.14,16.03,4,9,2,7,6,0
15,3,9,8,8,1,45,18.07,22,8747.58,0.13,92,0.05,485.98,36,56,9,11,48,0
9,0,9,5,5,1,39,21.41,15,4816.26,0.11,77,0.07,267.57,30,47,9,9,39,0
1,0,0,1,1,1,0,0,0,0,0,1,0,0,0,1,0,1,0,0
1,0,0,1,1,1,0,0,0,0,0,0,0,0,0,0,0,0,0,0
1,0,0,1,1,1,2,7.74,1.5,17.41,0,5,0.67,0.97,2,3,2,3,2,0
1,0,0,1,1,1,0,0,0,0,0,0,0,0,0,0,0,0,0,0
1,0,0,1,1,1,0,0,0,0,0,1,0,0,0,1,0,1,0,0
1,0,0,1,1,1,2,5.33,1.5,12,0,4,0.67,0.67,1,3,1,3,2,0
1,0,0,1,1,1,2,5.33,1.5,12,0,4,0.67,0.67,1,3,1,3,2,0
1,0,0,1,1,1,2,5.33,1.5,12,0,4,0.67,0.67,1,3,1,3,2,0
1,0,0,1,1,1,2,7.74,1.5,17.41,0,5,0.67,0.97,2,3,2,3,2,0
1,0,0,1,1,1,2,7.74,1.5,17.41,0,5,0.67,0.97,2,3,2,3,2,0
1,0,0,1,1,1,2,7.74,1.5,17.41,0,5,0.67,0.97,2,3,2,3,2,0
1,0,0,1,1,1,0,0,0,0,0,1,0,0,0,1,0,1,0,0
1,0,0,1,1,1,2,7.49,3,67.38,0.01,8,0.33,3.74,1,7,1,6,2,0
1,0,0,1,1,1,0,0,0,0,0,0,0,0,0,0,0,0,0,0
3,0,6,2,2,1,9,8.96,10,896.24,0.03,25,0.1,49.79,10,15,4,8,9,0
41,0,1,21,1,21,46,109.88,12.14,16192.96,0.44,234,0.08,899.61,116,118,43,9,46,0
11,3,6,6,3,1,26,16.05,16.9,4586.89,0.09,60,0.06,254.83,26,34,10,13,29,0
7,1,2,4,2,3,13,15.01,12,2161.02,0.06,41,0.08,120.06,18,23,9,12,14,0
3,0,0,2,2,1,6,5.89,7,288.46,0.01,13,0.14,16.03,4,9,2,7,6,0
3,1,1,2,2,1,9,11.6,10,1160,0.04,29,0.1,64.44,12,17,6,10,10,0
3,1,1,2,2,1,10,11.89,11,1438.79,0.04,32,0.09,79.93,12,20,6,11,11,0
3,1,1,2,2,1,10,11.6,10,1160,0.04,29,0.1,64.44,12,17,6,10,11,0
3,1,1,2,2,1,10,11.6,10,1160,0.04,29,0.1,64.44,12,17,6,10,11,0
3,1,1,2,2,1,10,11.6,10,1160,0.04,29,0.1,64.44,12,17,6,10,11,0
3,1,1,2,2,1,10,11.6,10,1160,0.04,29,0.1,64.44,12,17,6,10,11,0
3,1,1,2,2,1,10,11.6,10,1160,0.04,29,0.1,64.44,12,17,6,10,11,0
3,1,1,2,2,1,10,11.6,10,1160,0.04,29,0.1,64.44,12,17,6,10,11,0
3,0,0,2,1,1,22,8.07,15,1816.2,0.04,35,0.07,100.9,25,10,5,6,22,0
1,0,50,1,1,1,31,151.23,6.84,7079.87,0.34,213,0.15,393.33,26,187,19,10,31,0
1,0,0,1,1,1,2,7.74,1.5,17.41,0,5,0.67,0.97,2,3,2,3,2,0
1,0,0,1,1,1,0,0,0,0,0,0,0,0,0,0,0,0,0,0
1,0,0,1,1,1,2,5.33,1.5,12,0,4,0.67,0.67,1,3,1,3,2,0
1,0,0,1,1,1,2,5.33,1.5,12,0,4,0.67,0.67,1,3,1,3,2,0
1,0,0,1,1,1,2,5.33,1.5,12,0,4,0.67,0.67,1,3,1,3,2,0
1,0,0,1,1,1,1,0,0,0,0,1,0,0,0,1,0,1,1,0
1,0,0,1,1,1,2,7.74,1.5,17.41,0,5,0.67,0.97,2,3,2,3,2,0
3,0,0,2,2,1,6,7.97,5.83,271.29,0.02,14,0.17,15.07,5,9,3,7,6,0
1,0,0,1,1,1,0,0,0,0,0,0,0,0,0,0,0,0,0,0
1,0,0,1,1,1,0,0,0,0,0,1,0,0,0,1,0,1,0,0
1,0,0,1,1,1,0,0,0,0,0,1,0,0,0,1,0,1,0,0
9,3,0,5,5,4,4,6.95,27.62,5307.06,0.06,47,0.04,294.84,17,30,4,13,7,0
1,0,0,1,1,1,2,13.18,5.25,363.24,0.02,20,0.19,20.18,6,14,4,7,2,0
1,0,0,1,1,1,2,5.33,1.5,12,0,4,0.67,0.67,1,3,1,3,2,0
1,0,0,1,1,1,2,5.33,1.5,12,0,4,0.67,0.67,1,3,1,3,2,0
1,0,0,1,1,1,2,5.33,1.5,12,0,4,0.67,0.67,1,3,1,3,2,0
1,0,0,1,1,1,4,27.47,1.5,61.81,0.01,13,0.67,3.43,6,7,6,3,4,0
1,0,0,1,1,1,2,11.3,6.13,423.78,0.02,20,0.16,23.54,7,13,4,7,2,0
1,0,0,1,1,1,0,0,0,0,0,1,0,0,0,1,0,1,0,0
1,0,0,1,1,1,2,5.33,1.5,12,0,4,0.67,0.67,1,3,1,3,2,0
1,0,0,1,1,1,2,5.33,1.5,12,0,4,0.67,0.67,1,3,1,3,2,0
1,0,0,1,1,1,2,5.33,1.5,12,0,4,0.67,0.67,1,3,1,3,2,0
1,0,0,1,1,1,2,5.33,1.5,12,0,4,0.67,0.67,1,3,1,3,2,0
1,0,0,1,1,1,2,5.33,1.5,12,0,4,0.67,0.67,1,3,1,3,2,0
1,0,0,1,1,1,2,5.33,1.5,12,0,4,0.67,0.67,1,3,1,3,2,0
1,0,0,1,1,1,2,5.33,1.5,12,0,4,0.67,0.67,1,3,1,3,2,0
1,0,0,1,1,1,2,5.33,1.5,12,0,4,0.67,0.67,1,3,1,3,2,0
1,0,0,1,1,1,2,5.33,1.5,12,0,4,0.67,0.67,1,3,1,3,2,0
1,0,0,1,1,1,2,5.33,1.5,12,0,4,0.67,0.67,1,3,1,3,2,0
1,0,0,1,1,1,2,5.33,1.5,12,0,4,0.67,0.67,1,3,1,3,2,0
1,0,0,1,1,1,2,5.33,1.5,12,0,4,0.67,0.67,1,3,1,3,2,0
1,0,0,1,1,1,2,5.33,1.5,12,0,4,0.67,0.67,1,3,1,3,2,0
1,1,0,1,1,1,12,55.45,3.54,694.24,0.07,48,0.28,38.57,23,25,13,4,13,0
1,0,0,1,1,1,0,0,0,0,0,1,0,0,0,1,0,1,0,0
1,0,0,1,1,1,2,5.33,1.5,12,0,4,0.67,0.67,1,3,1,3,2,0
1,0,0,1,1,1,2,5.33,1.5,12,0,4,0.67,0.67,1,3,1,3,2,0
1,0,0,1,1,1,2,5.33,1.5,12,0,4,0.67,0.67,1,3,1,3,2,0
1,0,0,1,1,1,2,5.33,1.5,12,0,4,0.67,0.67,1,3,1,3,2,0
1,0,0,1,1,1,2,5.33,1.5,12,0,4,0.67,0.67,1,3,1,3,2,0
1,0,0,1,1,1,2,5.33,1.5,12,0,4,0.67,0.67,1,3,1,3,2,0
1,0,0,1,1,1,2,5.33,1.5,12,0,4,0.67,0.67,1,3,1,3,2,0
1,0,0,1,1,1,2,5.33,1.5,12,0,4,0.67,0.67,1,3,1,3,2,0
1,0,0,1,1,1,2,5.33,1.5,12,0,4,0.67,0.67,1,3,1,3,2,0
1,0,0,1,1,1,2,5.33,1.5,12,0,4,0.67,0.67,1,3,1,3,2,0
1,0,0,1,1,1,2,5.33,1.5,12,0,4,0.67,0.67,1,3,1,3,2,0
1,0,0,1,1,1,2,5.33,1.5,12,0,4,0.67,0.67,1,3,1,3,2,0
1,0,0,1,1,1,2,5.33,1.5,12,0,4,0.67,0.67,1,3,1,3,2,0
1,0,0,1,1,1,2,5.33,1.5,12,0,4,0.67,0.67,1,3,1,3,2,0
1,0,0,1,1,1,2,5.33,1.5,12,0,4,0.67,0.67,1,3,1,3,2,0
1,0,0,1,1,1,2,5.33,1.5,12,0,4,0.67,0.67,1,3,1,3,2,0
1,0,0,1,1,1,2,5.33,1.5,12,0,4,0.67,0.67,1,3,1,3,2,0
1,0,0,1,1,1,2,5.33,1.5,12,0,4,0.67,0.67,1,3,1,3,2,0
1,0,0,1,1,1,2,7.74,1.5,17.41,0,5,0.67,0.97,2,3,2,3,2,0
1,0,0,1,1,1,0,0,0,0,0,0,0,0,0,0,0,0,0,0
1,0,0,1,1,1,0,0,0,0,0,1,0,0,0,1,0,1,0,0
1,0,1,1,1,1,3,15,2,60,0.01,10,0.5,3.33,4,6,4,4,3,0
49,6,19,25,24,6,52,48.19,26.59,34076.93,0.43,246,0.04,1893.16,78,168,22,15,58,0
1,0,0,1,1,1,2,5.33,1.5,12,0,4,0.67,0.67,1,3,1,3,2,0
1,0,0,1,1,1,2,5.33,1.5,12,0,4,0.67,0.67,1,3,1,3,2,0
1,0,0,1,1,1,2,5.33,1.5,12,0,4,0.67,0.67,1,3,1,3,2,0
1,0,0,1,1,1,2,5.33,1.5,12,0,4,0.67,0.67,1,3,1,3,2,0
1,0,0,1,1,1,2,5.33,1.5,12,0,4,0.67,0.67,1,3,1,3,2,0
1,0,0,1,1,1,2,5.33,1.5,12,0,4,0.67,0.67,1,3,1,3,2,0
1,1,4,1,1,1,58,201.59,7.24,10564.15,0.49,256,0.14,586.9,111,145,46,6,59,0
1,0,0,1,1,1,3,11.63,2,46.53,0.01,9,0.5,2.58,4,5,3,3,3,0
449,1,3,225,223,225,1185,1041.01,39.6,1632847.95,13.74,4862,0.03,90713.78,2096,2766,344,13,1186,0
1,0,0,1,1,1,2,7.75,2,31.02,0.01,6,0.5,1.72,2,4,2,4,2,0
5,0,5,3,3,1,19,59.31,11.32,7603.23,0.22,123,0.09,422.4,54,69,31,13,19,0
11,2,8,6,1,1,142,467.5,9.17,39350.94,1.43,607,0.11,2186.16,289,318,126,8,144,0
35,4,26,18,9,1,88,85.56,22.35,42751.59,0.64,311,0.04,2375.09,114,197,51,20,92,0
1,0,7,1,1,1,5,24.58,3.5,301.14,0.03,24,0.29,16.73,7,17,6,6,5,0
3,0,4,2,1,1,16,53.29,4.71,1180.09,0.08,54,0.21,65.56,20,34,17,8,16,0
1,0,3,1,1,1,6,27.25,4.5,551.81,0.04,30,0.22,30.66,8,22,8,9,6,0
60,7,52,31,17,15,166,127.55,46.49,275619.47,1.98,843,0.02,15312.19,327,516,102,29,173,0
1,0,0,1,1,1,2,5.33,1.5,12,0,4,0.67,0.67,1,3,1,3,2,0
1,0,0,1,1,1,2,5.33,1.5,12,0,4,0.67,0.67,1,3,1,3,2,0
1,0,0,1,1,1,2,5.33,1.5,12,0,4,0.67,0.67,1,3,1,3,2,0
1,0,0,1,1,1,2,5.33,1.5,12,0,4,0.67,0.67,1,3,1,3,2,0
1,0,0,1,1,1,2,5.33,1.5,12,0,4,0.67,0.67,1,3,1,3,2,0
1,0,0,1,1,1,2,5.33,1.5,12,0,4,0.67,0.67,1,3,1,3,2,0
1,0,0,1,1,1,2,5.33,1.5,12,0,4,0.67,0.67,1,3,1,3,2,0
1,0,0,1,1,1,2,5.33,1.5,12,0,4,0.67,0.67,1,3,1,3,2,0
1,0,0,1,1,1,2,5.33,1.5,12,0,4,0.67,0.67,1,3,1,3,2,0
1,0,0,1,1,1,2,5.33,1.5,12,0,4,0.67,0.67,1,3,1,3,2,0
1,0,0,1,1,1,2,5.33,1.5,12,0,4,0.67,0.67,1,3,1,3,2,0
1,0,0,1,1,1,2,5.33,1.5,12,0,4,0.67,0.67,1,3,1,3,2,0
1,0,0,1,1,1,2,5.33,1.5,12,0,4,0.67,0.67,1,3,1,3,2,0
1,0,0,1,1,1,2,5.33,1.5,12,0,4,0.67,0.67,1,3,1,3,2,0
1,0,0,1,1,1,2,5.33,1.5,12,0,4,0.67,0.67,1,3,1,3,2,0
1,0,0,1,1,1,2,5.33,1.5,12,0,4,0.67,0.67,1,3,1,3,2,0
1,0,0,1,1,1,2,5.33,1.5,12,0,4,0.67,0.67,1,3,1,3,2,0
1,0,0,1,1,1,2,7.74,1.5,17.41,0,5,0.67,0.97,2,3,2,3,2,0
1,0,0,1,1,1,2,7.74,1.5,17.41,0,5,0.67,0.97,2,3,2,3,2,0
1,0,0,1,1,1,2,7.74,1.5,17.41,0,5,0.67,0.97,2,3,2,3,2,0
1,0,0,1,1,1,2,5.33,1.5,12,0,4,0.67,0.67,1,3,1,3,2,0
1,0,0,1,1,1,2,5.33,1.5,12,0,4,0.67,0.67,1,3,1,3,2,0
1,0,0,1,1,1,2,5.33,1.5,12,0,4,0.67,0.67,1,3,1,3,2,0
1,0,0,1,1,1,2,5.33,1.5,12,0,4,0.67,0.67,1,3,1,3,2,0
1,0,0,1,1,1,2,5.33,1.5,12,0,4,0.67,0.67,1,3,1,3,2,0
1,0,0,1,1,1,2,5.33,1.5,12,0,4,0.67,0.67,1,3,1,3,2,0
1,0,0,1,1,1,2,5.33,1.5,12,0,4,0.67,0.67,1,3,1,3,2,0
1,0,0,1,1,1,2,5.33,1.5,12,0,4,0.67,0.67,1,3,1,3,2,0
1,0,0,1,1,1,2,5.33,1.5,12,0,4,0.67,0.67,1,3,1,3,2,0
1,0,0,1,1,1,2,5.33,1.5,12,0,4,0.67,0.67,1,3,1,3,2,0
1,0,0,1,1,1,2,5.33,1.5,12,0,4,0.67,0.67,1,3,1,3,2,0
1,0,0,1,1,1,2,5.33,1.5,12,0,4,0.67,0.67,1,3,1,3,2,0
1,0,0,1,1,1,2,5.33,1.5,12,0,4,0.67,0.67,1,3,1,3,2,0
1,0,0,1,1,1,2,5.33,1.5,12,0,4,0.67,0.67,1,3,1,3,2,0
1,0,0,1,1,1,2,5.33,1.5,12,0,4,0.67,0.67,1,3,1,3,2,0
1,0,0,1,1,1,2,5.33,1.5,12,0,4,0.67,0.67,1,3,1,3,2,0
1,0,0,1,1,1,2,5.33,1.5,12,0,4,0.67,0.67,1,3,1,3,2,0
1,0,0,1,1,1,2,5.33,1.5,12,0,4,0.67,0.67,1,3,1,3,2,0
1,0,0,1,1,1,2,5.33,1.5,12,0,4,0.67,0.67,1,3,1,3,2,0
1,0,0,1,1,1,2,5.33,1.5,12,0,4,0.67,0.67,1,3,1,3,2,0
1,0,0,1,1,1,2,5.33,1.5,12,0,4,0.67,0.67,1,3,1,3,2,0
1,0,0,1,1,1,2,5.33,1.5,12,0,4,0.67,0.67,1,3,1,3,2,0
1,0,0,1,1,1,2,5.33,1.5,12,0,4,0.67,0.67,1,3,1,3,2,0
1,0,0,1,1,1,2,5.33,1.5,12,0,4,0.67,0.67,1,3,1,3,2,0
1,0,0,1,1,1,2,5.33,1.5,12,0,4,0.67,0.67,1,3,1,3,2,0
1,0,0,1,1,1,2,5.33,1.5,12,0,4,0.67,0.67,1,3,1,3,2,0
1,0,0,1,1,1,2,5.33,1.5,12,0,4,0.67,0.67,1,3,1,3,2,0
1,0,0,1,1,1,2,5.33,1.5,12,0,4,0.67,0.67,1,3,1,3,2,0
1,0,0,1,1,1,2,5.33,1.5,12,0,4,0.67,0.67,1,3,1,3,2,0
1,0,0,1,1,1,2,5.33,1.5,12,0,4,0.67,0.67,1,3,1,3,2,0
1,0,0,1,1,1,2,5.33,1.5,12,0,4,0.67,0.67,1,3,1,3,2,0
1,0,0,1,1,1,2,5.33,1.5,12,0,4,0.67,0.67,1,3,1,3,2,0
1,0,0,1,1,1,2,5.33,1.5,12,0,4,0.67,0.67,1,3,1,3,2,0
1,0,0,1,1,1,2,5.33,1.5,12,0,4,0.67,0.67,1,3,1,3,2,0
1,0,0,1,1,1,2,5.33,1.5,12,0,4,0.67,0.67,1,3,1,3,2,0
1,0,0,1,1,1,2,5.33,1.5,12,0,4,0.67,0.67,1,3,1,3,2,0
1,0,0,1,1,1,2,5.33,1.5,12,0,4,0.67,0.67,1,3,1,3,2,0
1,0,0,1,1,1,2,5.33,1.5,12,0,4,0.67,0.67,1,3,1,3,2,0
1,0,0,1,1,1,2,5.33,1.5,12,0,4,0.67,0.67,1,3,1,3,2,0
1,0,0,1,1,1,2,5.33,1.5,12,0,4,0.67,0.67,1,3,1,3,2,0
1,0,0,1,1,1,2,5.33,1.5,12,0,4,0.67,0.67,1,3,1,3,2,0
1,0,0,1,1,1,2,5.33,1.5,12,0,4,0.67,0.67,1,3,1,3,2,0
1,0,0,1,1,1,2,5.33,1.5,12,0,4,0.67,0.67,1,3,1,3,2,0
1,0,0,1,1,1,2,7.74,1.5,17.41,0,5,0.67,0.97,2,3,2,3,2,0
1,0,0,1,1,1,2,7.74,1.5,17.41,0,5,0.67,0.97,2,3,2,3,2,0
1,0,0,1,1,1,2,7.74,1.5,17.41,0,5,0.67,0.97,2,3,2,3,2,0
1,0,0,1,1,1,2,7.74,1.5,17.41,0,5,0.67,0.97,2,3,2,3,2,0
1,0,0,1,1,1,2,7.74,1.5,17.41,0,5,0.67,0.97,2,3,2,3,2,0
1,0,0,1,1,1,2,7.74,1.5,17.41,0,5,0.67,0.97,2,3,2,3,2,0
1,0,0,1,1,1,2,7.74,1.5,17.41,0,5,0.67,0.97,2,3,2,3,2,0
1,0,0,1,1,1,2,7.74,1.5,17.41,0,5,0.67,0.97,2,3,2,3,2,0
1,0,0,1,1,1,2,7.74,1.5,17.41,0,5,0.67,0.97,2,3,2,3,2,0
1,0,0,1,1,1,2,7.74,1.5,17.41,0,5,0.67,0.97,2,3,2,3,2,0
1,0,0,1,1,1,2,7.74,1.5,17.41,0,5,0.67,0.97,2,3,2,3,2,0
1,0,0,1,1,1,2,7.74,1.5,17.41,0,5,0.67,0.97,2,3,2,3,2,0
1,0,0,1,1,1,2,7.74,1.5,17.41,0,5,0.67,0.97,2,3,2,3,2,0
1,0,0,1,1,1,2,7.74,1.5,17.41,0,5,0.67,0.97,2,3,2,3,2,0
1,0,0,1,1,1,2,7.74,1.5,17.41,0,5,0.67,0.97,2,3,2,3,2,0
1,0,0,1,1,1,2,7.74,1.5,17.41,0,5,0.67,0.97,2,3,2,3,2,0
1,0,0,1,1,1,2,7.74,1.5,17.41,0,5,0.67,0.97,2,3,2,3,2,0
1,0,0,1,1,1,2,7.74,1.5,17.41,0,5,0.67,0.97,2,3,2,3,2,0
1,0,0,1,1,1,2,7.74,1.5,17.41,0,5,0.67,0.97,2,3,2,3,2,0
1,0,0,1,1,1,2,7.74,1.5,17.41,0,5,0.67,0.97,2,3,2,3,2,0
1,0,0,1,1,1,2,7.74,1.5,17.41,0,5,0.67,0.97,2,3,2,3,2,0
1,0,0,1,1,1,2,7.74,1.5,17.41,0,5,0.67,0.97,2,3,2,3,2,0
1,0,0,1,1,1,2,7.74,1.5,17.41,0,5,0.67,0.97,2,3,2,3,2,0
1,0,0,1,1,1,2,7.74,1.5,17.41,0,5,0.67,0.97,2,3,2,3,2,0
1,0,0,1,1,1,2,7.74,1.5,17.41,0,5,0.67,0.97,2,3,2,3,2,0
1,0,0,1,1,1,2,7.74,1.5,17.41,0,5,0.67,0.97,2,3,2,3,2,0
1,0,0,1,1,1,0,0,0,0,0,1,0,0,0,1,0,1,0,0
1,0,0,1,1,1,2,5.33,1.5,12,0,4,0.67,0.67,1,3,1,3,2,0
1,0,0,1,1,1,2,5.33,1.5,12,0,4,0.67,0.67,1,3,1,3,2,0
1,0,0,1,1,1,2,5.33,1.5,12,0,4,0.67,0.67,1,3,1,3,2,0
1,0,0,1,1,1,0,0,0,0,0,1,0,0,0,1,0,1,0,0
1,0,0,1,1,1,2,5.33,1.5,12,0,4,0.67,0.67,1,3,1,3,2,0
1,0,0,1,1,1,2,5.33,1.5,12,0,4,0.67,0.67,1,3,1,3,2,0
1,0,0,1,1,1,2,5.33,1.5,12,0,4,0.67,0.67,1,3,1,3,2,0
1,0,0,1,1,1,2,5.33,1.5,12,0,4,0.67,0.67,1,3,1,3,2,0
1,0,0,1,1,1,2,5.33,1.5,12,0,4,0.67,0.67,1,3,1,3,2,0
1,0,0,1,1,1,2,5.33,1.5,12,0,4,0.67,0.67,1,3,1,3,2,0
1,0,0,1,1,1,2,7.74,1.5,17.41,0,5,0.67,0.97,2,3,2,3,2,0
1,0,0,1,1,1,2,7.74,1.5,17.41,0,5,0.67,0.97,2,3,2,3,2,0
1,0,0,1,1,1,2,7.74,1.5,17.41,0,5,0.67,0.97,2,3,2,3,2,0
1,0,0,1,1,1,2,7.74,1.5,17.41,0,5,0.67,0.97,2,3,2,3,2,0
3,0,0,2,1,1,5,6.74,3.75,94.75,0.01,9,0.27,5.26,3,6,2,5,5,0
1,0,0,1,1,1,2,5.33,1.5,12,0,4,0.67,0.67,1,3,1,3,2,0
1,0,0,1,1,1,2,5.33,1.5,12,0,4,0.67,0.67,1,3,1,3,2,0
1,0,0,1,1,1,2,5.33,1.5,12,0,4,0.67,0.67,1,3,1,3,2,0
5,1,20,3,1,1,14,8.26,14.67,1775.84,0.04,35,0.07,98.66,11,24,3,8,15,0
1,1,1,1,1,1,5,17.05,4.81,394.84,0.03,21,0.21,21.94,11,10,8,7,6,0
1,0,0,1,1,1,0,0,0,0,0,1,0,0,0,1,0,1,0,0
1,0,0,1,1,1,0,0,0,0,0,1,0,0,0,1,0,1,0,0
1,0,0,1,1,1,0,0,0,0,0,1,0,0,0,1,0,1,0,0
9,3,0,5,5,4,4,6.95,27.62,5307.06,0.06,47,0.04,294.84,17,30,4,13,7,0
1,0,0,1,1,1,2,5.33,1.5,12,0,4,0.67,0.67,1,3,1,3,2,0
5,0,1,3,2,1,13,15.96,8.25,1086.41,0.04,31,0.12,60.36,12,19,8,11,13,0
1,0,0,1,1,1,2,5.8,2,23.22,0,5,0.5,1.29,1,4,1,4,2,0
1,0,0,1,1,1,2,13.18,5.25,363.24,0.02,20,0.19,20.18,6,14,4,7,2,0
1,0,0,1,1,1,2,5.33,1.5,12,0,4,0.67,0.67,1,3,1,3,2,0
1,0,0,1,1,1,2,5.33,1.5,12,0,4,0.67,0.67,1,3,1,3,2,0
1,0,0,1,1,1,2,5.33,1.5,12,0,4,0.67,0.67,1,3,1,3,2,0
1,0,0,1,1,1,2,5.33,1.5,12,0,4,0.67,0.67,1,3,1,3,2,0
1,0,0,1,1,1,4,27.47,1.5,61.81,0.01,13,0.67,3.43,6,7,6,3,4,0
1,0,0,1,1,1,2,11.3,6.13,423.78,0.02,20,0.16,23.54,7,13,4,7,2,0
1,0,0,1,1,1,0,0,0,0,0,1,0,0,0,1,0,1,0,0
1,0,0,1,1,1,2,5.33,1.5,12,0,4,0.67,0.67,1,3,1,3,2,0
1,0,0,1,1,1,2,5.33,1.5,12,0,4,0.67,0.67,1,3,1,3,2,0
1,0,0,1,1,1,2,5.33,1.5,12,0,4,0.67,0.67,1,3,1,3,2,0
1,0,0,1,1,1,2,5.33,1.5,12,0,4,0.67,0.67,1,3,1,3,2,0
1,0,0,1,1,1,2,5.33,1.5,12,0,4,0.67,0.67,1,3,1,3,2,0
1,0,0,1,1,1,2,5.33,1.5,12,0,4,0.67,0.67,1,3,1,3,2,0
1,0,0,1,1,1,2,5.33,1.5,12,0,4,0.67,0.67,1,3,1,3,2,0
1,0,0,1,1,1,2,5.33,1.5,12,0,4,0.67,0.67,1,3,1,3,2,0
1,0,0,1,1,1,2,5.33,1.5,12,0,4,0.67,0.67,1,3,1,3,2,0
1,0,0,1,1,1,2,5.33,1.5,12,0,4,0.67,0.67,1,3,1,3,2,0
1,0,0,1,1,1,2,5.33,1.5,12,0,4,0.67,0.67,1,3,1,3,2,0
1,0,0,1,1,1,2,5.33,1.5,12,0,4,0.67,0.67,1,3,1,3,2,0
1,0,0,1,1,1,2,5.33,1.5,12,0,4,0.67,0.67,1,3,1,3,2,0
1,1,0,1,1,1,12,55.45,3.54,694.24,0.07,48,0.28,38.57,23,25,13,4,13,0
1,0,0,1,1,1,0,0,0,0,0,1,0,0,0,1,0,1,0,0
1,0,0,1,1,1,2,5.33,1.5,12,0,4,0.67,0.67,1,3,1,3,2,0
1,0,0,1,1,1,2,5.33,1.5,12,0,4,0.67,0.67,1,3,1,3,2,0
1,0,0,1,1,1,2,5.33,1.5,12,0,4,0.67,0.67,1,3,1,3,2,0
1,0,0,1,1,1,2,5.33,1.5,12,0,4,0.67,0.67,1,3,1,3,2,0
1,0,0,1,1,1,2,5.33,1.5,12,0,4,0.67,0.67,1,3,1,3,2,0
1,0,0,1,1,1,2,5.33,1.5,12,0,4,0.67,0.67,1,3,1,3,2,0
1,0,0,1,1,1,2,5.33,1.5,12,0,4,0.67,0.67,1,3,1,3,2,0
1,0,0,1,1,1,2,5.33,1.5,12,0,4,0.67,0.67,1,3,1,3,2,0
1,0,0,1,1,1,2,5.33,1.5,12,0,4,0.67,0.67,1,3,1,3,2,0
1,0,0,1,1,1,2,5.33,1.5,12,0,4,0.67,0.67,1,3,1,3,2,0
1,0,0,1,1,1,2,5.33,1.5,12,0,4,0.67,0.67,1,3,1,3,2,0
1,0,0,1,1,1,2,5.33,1.5,12,0,4,0.67,0.67,1,3,1,3,2,0
1,0,0,1,1,1,2,5.33,1.5,12,0,4,0.67,0.67,1,3,1,3,2,0
1,0,0,1,1,1,2,5.33,1.5,12,0,4,0.67,0.67,1,3,1,3,2,0
1,0,0,1,1,1,2,5.33,1.5,12,0,4,0.67,0.67,1,3,1,3,2,0
1,0,0,1,1,1,2,5.33,1.5,12,0,4,0.67,0.67,1,3,1,3,2,0
1,0,0,1,1,1,2,5.33,1.5,12,0,4,0.67,0.67,1,3,1,3,2,0
1,0,0,1,1,1,2,5.33,1.5,12,0,4,0.67,0.67,1,3,1,3,2,0
1,0,0,1,1,1,0,0,0,0,0,1,0,0,0,1,0,1,0,0
1,0,0,1,1,1,2,5.33,1.5,12,0,4,0.67,0.67,1,3,1,3,2,0
1,0,0,1,1,1,2,5.33,1.5,12,0,4,0.67,0.67,1,3,1,3,2,0
1,0,0,1,1,1,2,5.33,1.5,12,0,4,0.67,0.67,1,3,1,3,2,0
1,0,0,1,1,1,2,5.33,1.5,12,0,4,0.67,0.67,1,3,1,3,2,0
1,0,0,1,1,1,2,5.33,1.5,12,0,4,0.67,0.67,1,3,1,3,2,0
1,0,0,1,1,1,2,5.33,1.5,12,0,4,0.67,0.67,1,3,1,3,2,0
1,0,0,1,1,1,3,11.63,2,46.53,0.01,9,0.5,2.58,4,5,3,3,3,0
1,0,0,1,1,1,2,7.75,2,31.02,0.01,6,0.5,1.72,2,4,2,4,2,0
1,0,1,1,1,1,4,15.85,2,63.4,0.01,10,0.5,3.52,5,5,5,4,4,0
1,0,0,1,1,1,2,5.33,1.5,12,0,4,0.67,0.67,1,3,1,3,2,0
1,0,0,1,1,1,2,5.33,1.5,12,0,4,0.67,0.67,1,3,1,3,2,0
1,0,0,1,1,1,2,5.33,1.5,12,0,4,0.67,0.67,1,3,1,3,2,0
1,0,0,1,1,1,2,5.33,1.5,12,0,4,0.67,0.67,1,3,1,3,2,0
1,0,0,1,1,1,2,5.33,1.5,12,0,4,0.67,0.67,1,3,1,3,2,0
1,0,0,1,1,1,2,5.33,1.5,12,0,4,0.67,0.67,1,3,1,3,2,0
1,0,0,1,1,1,2,5.33,1.5,12,0,4,0.67,0.67,1,3,1,3,2,0
1,0,0,1,1,1,2,5.33,1.5,12,0,4,0.67,0.67,1,3,1,3,2,0
1,0,0,1,1,1,2,5.33,1.5,12,0,4,0.67,0.67,1,3,1,3,2,0
1,0,0,1,1,1,2,5.33,1.5,12,0,4,0.67,0.67,1,3,1,3,2,0
1,0,0,1,1,1,2,5.33,1.5,12,0,4,0.67,0.67,1,3,1,3,2,0
1,0,0,1,1,1,2,5.33,1.5,12,0,4,0.67,0.67,1,3,1,3,2,0
1,0,0,1,1,1,2,5.33,1.5,12,0,4,0.67,0.67,1,3,1,3,2,0
1,0,0,1,1,1,2,5.33,1.5,12,0,4,0.67,0.67,1,3,1,3,2,0
1,0,0,1,1,1,2,5.33,1.5,12,0,4,0.67,0.67,1,3,1,3,2,0
1,0,0,1,1,1,2,5.33,1.5,12,0,4,0.67,0.67,1,3,1,3,2,0
1,0,0,1,1,1,2,5.33,1.5,12,0,4,0.67,0.67,1,3,1,3,2,0
1,0,0,1,1,1,2,5.33,1.5,12,0,4,0.67,0.67,1,3,1,3,2,0
1,0,0,1,1,1,2,5.33,1.5,12,0,4,0.67,0.67,1,3,1,3,2,0
1,0,0,1,1,1,2,5.33,1.5,12,0,4,0.67,0.67,1,3,1,3,2,0
1,0,0,1,1,1,2,5.33,1.5,12,0,4,0.67,0.67,1,3,1,3,2,0
1,0,0,1,1,1,2,5.33,1.5,12,0,4,0.67,0.67,1,3,1,3,2,0
1,0,0,1,1,1,2,5.33,1.5,12,0,4,0.67,0.67,1,3,1,3,2,0
1,0,0,1,1,1,2,5.33,1.5,12,0,4,0.67,0.67,1,3,1,3,2,0
1,0,0,1,1,1,2,5.33,1.5,12,0,4,0.67,0.67,1,3,1,3,2,0
1,0,0,1,1,1,2,5.33,1.5,12,0,4,0.67,0.67,1,3,1,3,2,0
1,0,0,1,1,1,2,5.33,1.5,12,0,4,0.67,0.67,1,3,1,3,2,0
1,0,0,1,1,1,2,5.33,1.5,12,0,4,0.67,0.67,1,3,1,3,2,0
1,0,0,1,1,1,2,5.33,1.5,12,0,4,0.67,0.67,1,3,1,3,2,0
1,0,0,1,1,1,2,5.33,1.5,12,0,4,0.67,0.67,1,3,1,3,2,0
1,0,0,1,1,1,2,5.33,1.5,12,0,4,0.67,0.67,1,3,1,3,2,0
1,0,0,1,1,1,2,5.33,1.5,12,0,4,0.67,0.67,1,3,1,3,2,0
1,0,0,1,1,1,2,5.33,1.5,12,0,4,0.67,0.67,1,3,1,3,2,0
1,0,0,1,1,1,2,5.33,1.5,12,0,4,0.67,0.67,1,3,1,3,2,0
1,0,0,1,1,1,2,5.33,1.5,12,0,4,0.67,0.67,1,3,1,3,2,0
1,0,0,1,1,1,2,5.33,1.5,12,0,4,0.67,0.67,1,3,1,3,2,0
1,0,0,1,1,1,2,5.33,1.5,12,0,4,0.67,0.67,1,3,1,3,2,0
1,0,0,1,1,1,2,5.33,1.5,12,0,4,0.67,0.67,1,3,1,3,2,0
1,0,0,1,1,1,2,5.33,1.5,12,0,4,0.67,0.67,1,3,1,3,2,0
1,0,0,1,1,1,2,5.33,1.5,12,0,4,0.67,0.67,1,3,1,3,2,0
1,0,0,1,1,1,2,5.33,1.5,12,0,4,0.67,0.67,1,3,1,3,2,0
1,0,0,1,1,1,2,5.33,1.5,12,0,4,0.67,0.67,1,3,1,3,2,0
1,0,0,1,1,1,2,5.33,1.5,12,0,4,0.67,0.67,1,3,1,3,2,0
3,0,2,2,1,1,7,9.88,5.25,272.43,0.02,15,0.19,15.14,6,9,4,7,7,0
9,0,9,5,2,1,38,30.74,11.6,4136.75,0.12,75,0.09,229.82,29,46,15,12,38,0
1,0,0,1,1,1,2,7.74,1.5,17.41,0,5,0.67,0.97,2,3,2,3,2,0
1,0,0,1,1,1,2,7.74,1.5,17.41,0,5,0.67,0.97,2,3,2,3,2,0
1,0,0,1,1,1,2,7.74,1.5,17.41,0,5,0.67,0.97,2,3,2,3,2,0
1,0,0,1,1,1,2,7.74,1.5,17.41,0,5,0.67,0.97,2,3,2,3,2,0
1,0,0,1,1,1,2,7.74,1.5,17.41,0,5,0.67,0.97,2,3,2,3,2,0
1,0,0,1,1,1,2,7.74,1.5,17.41,0,5,0.67,0.97,2,3,2,3,2,0
1,0,0,1,1,1,2,7.74,1.5,17.41,0,5,0.67,0.97,2,3,2,3,2,0
1,0,0,1,1,1,2,7.74,1.5,17.41,0,5,0.67,0.97,2,3,2,3,2,0
1,0,0,1,1,1,2,7.74,1.5,17.41,0,5,0.67,0.97,2,3,2,3,2,0
1,0,0,1,1,1,2,7.74,1.5,17.41,0,5,0.67,0.97,2,3,2,3,2,0
1,0,0,1,1,1,2,7.74,1.5,17.41,0,5,0.67,0.97,2,3,2,3,2,0
1,0,0,1,1,1,2,7.74,1.5,17.41,0,5,0.67,0.97,2,3,2,3,2,0
1,0,0,1,1,1,2,7.74,1.5,17.41,0,5,0.67,0.97,2,3,2,3,2,0
1,0,0,1,1,1,2,7.74,1.5,17.41,0,5,0.67,0.97,2,3,2,3,2,0
1,0,0,1,1,1,2,7.74,1.5,17.41,0,5,0.67,0.97,2,3,2,3,2,0
1,0,0,1,1,1,2,7.74,1.5,17.41,0,5,0.67,0.97,2,3,2,3,2,0
1,0,0,1,1,1,2,7.74,1.5,17.41,0,5,0.67,0.97,2,3,2,3,2,0
1,0,0,1,1,1,2,7.74,1.5,17.41,0,5,0.67,0.97,2,3,2,3,2,0
1,0,0,1,1,1,2,7.74,1.5,17.41,0,5,0.67,0.97,2,3,2,3,2,0
1,0,0,1,1,1,2,7.74,1.5,17.41,0,5,0.67,0.97,2,3,2,3,2,0
1,0,0,1,1,1,2,7.74,1.5,17.41,0,5,0.67,0.97,2,3,2,3,2,0
1,0,0,1,1,1,2,7.74,1.5,17.41,0,5,0.67,0.97,2,3,2,3,2,0
1,0,0,1,1,1,2,7.74,1.5,17.41,0,5,0.67,0.97,2,3,2,3,2,0
1,0,0,1,1,1,2,7.74,1.5,17.41,0,5,0.67,0.97,2,3,2,3,2,0
1,0,0,1,1,1,2,7.74,1.5,17.41,0,5,0.67,0.97,2,3,2,3,2,0
1,0,0,1,1,1,2,7.74,1.5,17.41,0,5,0.67,0.97,2,3,2,3,2,0
1,0,0,1,1,1,0,0,0,0,0,1,0,0,0,1,0,1,0,0
1,0,0,1,1,1,2,5.33,1.5,12,0,4,0.67,0.67,1,3,1,3,2,0
1,0,0,1,1,1,2,5.33,1.5,12,0,4,0.67,0.67,1,3,1,3,2,0
1,0,0,1,1,1,2,5.33,1.5,12,0,4,0.67,0.67,1,3,1,3,2,0
13,1,7,7,1,7,16,25.27,9,2046.88,0.08,51,0.11,113.72,18,33,11,11,17,0
9,0,5,5,1,5,9,23.63,6,850.66,0.05,34,0.17,47.26,12,22,9,9,9,0
1,0,0,1,1,1,0,0,0,0,0,1,0,0,0,1,0,1,0,0
1,0,0,1,1,1,2,5.33,1.5,12,0,4,0.67,0.67,1,3,1,3,2,0
1,0,0,1,1,1,2,5.33,1.5,12,0,4,0.67,0.67,1,3,1,3,2,0
1,0,0,1,1,1,2,5.33,1.5,12,0,4,0.67,0.67,1,3,1,3,2,0
1,0,0,1,1,1,2,5.33,1.5,12,0,4,0.67,0.67,1,3,1,3,2,0
1,0,0,1,1,1,2,5.33,1.5,12,0,4,0.67,0.67,1,3,1,3,2,0
1,0,0,1,1,1,2,5.33,1.5,12,0,4,0.67,0.67,1,3,1,3,2,0
1,0,0,1,1,1,2,7.74,1.5,17.41,0,5,0.67,0.97,2,3,2,3,2,0
1,0,0,1,1,1,0,0,0,0,0,1,0,0,0,1,0,1,0,0
1,0,0,1,1,1,2,5.33,1.5,12,0,4,0.67,0.67,1,3,1,3,2,0
1,0,0,1,1,1,2,5.33,1.5,12,0,4,0.67,0.67,1,3,1,3,2,0
1,0,0,1,1,1,2,5.33,1.5,12,0,4,0.67,0.67,1,3,1,3,2,0
1,0,0,1,1,1,2,5.33,1.5,12,0,4,0.67,0.67,1,3,1,3,2,0
1,0,0,1,1,1,2,5.33,1.5,12,0,4,0.67,0.67,1,3,1,3,2,0
1,0,0,1,1,1,2,7.74,1.5,17.41,0,5,0.67,0.97,2,3,2,3,2,0
1,0,0,1,1,1,2,7.74,1.5,17.41,0,5,0.67,0.97,2,3,2,3,2,0
1,0,0,1,1,1,2,7.74,1.5,17.41,0,5,0.67,0.97,2,3,2,3,2,0
1,0,0,1,1,1,2,7.74,1.5,17.41,0,5,0.67,0.97,2,3,2,3,2,0
1,0,0,1,1,1,2,7.74,1.5,17.41,0,5,0.67,0.97,2,3,2,3,2,0
1,0,0,1,1,1,2,7.74,1.5,17.41,0,5,0.67,0.97,2,3,2,3,2,0
1,0,0,1,1,1,0,0,0,0,0,0,0,0,0,0,0,0,0,0
1,0,0,1,1,1,2,7.74,1.5,17.41,0,5,0.67,0.97,2,3,2,3,2,0
1,0,0,1,1,1,2,7.74,1.5,17.41,0,5,0.67,0.97,2,3,2,3,2,0
1,0,0,1,1,1,2,7.74,1.5,17.41,0,5,0.67,0.97,2,3,2,3,2,0
1,0,0,1,1,1,0,0,0,0,0,1,0,0,0,1,0,1,0,0
1,0,0,1,1,1,0,0,0,0,0,1,0,0,0,1,0,1,0,0
1,0,0,1,1,1,0,0,0,0,0,1,0,0,0,1,0,1,0,0
9,3,0,5,5,4,4,6.95,27.62,5307.06,0.06,47,0.04,294.84,17,30,4,13,7,0
1,0,0,1,1,1,2,5.33,1.5,12,0,4,0.67,0.67,1,3,1,3,2,0
1,0,0,1,1,1,2,5.8,2,23.22,0,5,0.5,1.29,1,4,1,4,2,0
1,0,0,1,1,1,2,13.18,5.25,363.24,0.02,20,0.19,20.18,6,14,4,7,2,0
1,0,0,1,1,1,2,5.33,1.5,12,0,4,0.67,0.67,1,3,1,3,2,0
1,0,0,1,1,1,2,5.33,1.5,12,0,4,0.67,0.67,1,3,1,3,2,0
1,0,0,1,1,1,2,5.33,1.5,12,0,4,0.67,0.67,1,3,1,3,2,0
1,0,0,1,1,1,2,5.33,1.5,12,0,4,0.67,0.67,1,3,1,3,2,0
1,0,0,1,1,1,4,27.47,1.5,61.81,0.01,13,0.67,3.43,6,7,6,3,4,0
1,0,0,1,1,1,2,11.3,6.13,423.78,0.02,20,0.16,23.54,7,13,4,7,2,0
1,0,0,1,1,1,0,0,0,0,0,1,0,0,0,1,0,1,0,0
1,0,0,1,1,1,2,5.33,1.5,12,0,4,0.67,0.67,1,3,1,3,2,0
1,0,0,1,1,1,2,5.33,1.5,12,0,4,0.67,0.67,1,3,1,3,2,0
1,0,0,1,1,1,2,5.33,1.5,12,0,4,0.67,0.67,1,3,1,3,2,0
1,0,0,1,1,1,2,5.33,1.5,12,0,4,0.67,0.67,1,3,1,3,2,0
1,0,0,1,1,1,2,5.33,1.5,12,0,4,0.67,0.67,1,3,1,3,2,0
1,0,0,1,1,1,2,5.33,1.5,12,0,4,0.67,0.67,1,3,1,3,2,0
1,0,0,1,1,1,2,5.33,1.5,12,0,4,0.67,0.67,1,3,1,3,2,0
1,0,0,1,1,1,2,5.33,1.5,12,0,4,0.67,0.67,1,3,1,3,2,0
1,0,0,1,1,1,2,5.33,1.5,12,0,4,0.67,0.67,1,3,1,3,2,0
1,0,0,1,1,1,2,5.33,1.5,12,0,4,0.67,0.67,1,3,1,3,2,0
1,0,0,1,1,1,2,5.33,1.5,12,0,4,0.67,0.67,1,3,1,3,2,0
1,0,0,1,1,1,2,5.33,1.5,12,0,4,0.67,0.67,1,3,1,3,2,0
1,0,0,1,1,1,2,5.33,1.5,12,0,4,0.67,0.67,1,3,1,3,2,0
1,1,0,1,1,1,12,55.45,3.54,694.24,0.07,48,0.28,38.57,23,25,13,4,13,0
1,0,0,1,1,1,0,0,0,0,0,1,0,0,0,1,0,1,0,0
1,0,0,1,1,1,2,5.33,1.5,12,0,4,0.67,0.67,1,3,1,3,2,0
1,0,0,1,1,1,2,5.33,1.5,12,0,4,0.67,0.67,1,3,1,3,2,0
1,0,0,1,1,1,2,5.33,1.5,12,0,4,0.67,0.67,1,3,1,3,2,0
1,0,0,1,1,1,2,5.33,1.5,12,0,4,0.67,0.67,1,3,1,3,2,0
1,0,0,1,1,1,2,5.33,1.5,12,0,4,0.67,0.67,1,3,1,3,2,0
1,0,0,1,1,1,2,5.33,1.5,12,0,4,0.67,0.67,1,3,1,3,2,0
1,0,0,1,1,1,2,5.33,1.5,12,0,4,0.67,0.67,1,3,1,3,2,0
1,0,0,1,1,1,2,5.33,1.5,12,0,4,0.67,0.67,1,3,1,3,2,0
1,0,0,1,1,1,2,5.33,1.5,12,0,4,0.67,0.67,1,3,1,3,2,0
1,0,0,1,1,1,2,5.33,1.5,12,0,4,0.67,0.67,1,3,1,3,2,0
1,0,0,1,1,1,2,5.33,1.5,12,0,4,0.67,0.67,1,3,1,3,2,0
1,0,0,1,1,1,2,5.33,1.5,12,0,4,0.67,0.67,1,3,1,3,2,0
1,0,0,1,1,1,2,5.33,1.5,12,0,4,0.67,0.67,1,3,1,3,2,0
1,0,0,1,1,1,2,5.33,1.5,12,0,4,0.67,0.67,1,3,1,3,2,0
1,0,0,1,1,1,2,5.33,1.5,12,0,4,0.67,0.67,1,3,1,3,2,0
1,0,0,1,1,1,2,5.33,1.5,12,0,4,0.67,0.67,1,3,1,3,2,0
1,0,0,1,1,1,2,5.33,1.5,12,0,4,0.67,0.67,1,3,1,3,2,0
1,0,0,1,1,1,2,5.33,1.5,12,0,4,0.67,0.67,1,3,1,3,2,0
1,0,0,1,1,1,0,0,0,0,0,1,0,0,0,1,0,1,0,0
1,0,0,1,1,1,2,5.33,1.5,12,0,4,0.67,0.67,1,3,1,3,2,0
1,0,0,1,1,1,2,5.33,1.5,12,0,4,0.67,0.67,1,3,1,3,2,0
1,0,0,1,1,1,2,5.33,1.5,12,0,4,0.67,0.67,1,3,1,3,2,0
1,0,0,1,1,1,2,5.33,1.5,12,0,4,0.67,0.67,1,3,1,3,2,0
1,0,0,1,1,1,2,5.33,1.5,12,0,4,0.67,0.67,1,3,1,3,2,0
1,0,0,1,1,1,2,5.33,1.5,12,0,4,0.67,0.67,1,3,1,3,2,0
1,0,0,1,1,1,3,11.63,2,46.53,0.01,9,0.5,2.58,4,5,3,3,3,0
1,0,0,1,1,1,2,7.75,2,31.02,0.01,6,0.5,1.72,2,4,2,4,2,0
1,0,1,1,1,1,4,15.85,2,63.4,0.01,10,0.5,3.52,5,5,5,4,4,0
1,0,0,1,1,1,2,5.33,1.5,12,0,4,0.67,0.67,1,3,1,3,2,0
1,0,0,1,1,1,2,5.33,1.5,12,0,4,0.67,0.67,1,3,1,3,2,0
1,0,0,1,1,1,2,5.33,1.5,12,0,4,0.67,0.67,1,3,1,3,2,0
1,0,0,1,1,1,2,5.33,1.5,12,0,4,0.67,0.67,1,3,1,3,2,0
1,0,0,1,1,1,2,5.33,1.5,12,0,4,0.67,0.67,1,3,1,3,2,0
1,0,0,1,1,1,2,5.33,1.5,12,0,4,0.67,0.67,1,3,1,3,2,0
1,0,0,1,1,1,2,5.33,1.5,12,0,4,0.67,0.67,1,3,1,3,2,0
1,0,0,1,1,1,2,5.33,1.5,12,0,4,0.67,0.67,1,3,1,3,2,0
1,0,0,1,1,1,2,5.33,1.5,12,0,4,0.67,0.67,1,3,1,3,2,0
1,0,0,1,1,1,2,5.33,1.5,12,0,4,0.67,0.67,1,3,1,3,2,0
1,0,0,1,1,1,2,5.33,1.5,12,0,4,0.67,0.67,1,3,1,3,2,0
1,0,0,1,1,1,2,5.33,1.5,12,0,4,0.67,0.67,1,3,1,3,2,0
1,0,0,1,1,1,2,5.33,1.5,12,0,4,0.67,0.67,1,3,1,3,2,0
1,0,0,1,1,1,2,5.33,1.5,12,0,4,0.67,0.67,1,3,1,3,2,0
1,0,0,1,1,1,2,5.33,1.5,12,0,4,0.67,0.67,1,3,1,3,2,0
1,0,0,1,1,1,2,5.33,1.5,12,0,4,0.67,0.67,1,3,1,3,2,0
1,0,0,1,1,1,2,5.33,1.5,12,0,4,0.67,0.67,1,3,1,3,2,0
1,0,0,1,1,1,2,5.33,1.5,12,0,4,0.67,0.67,1,3,1,3,2,0
1,0,0,1,1,1,2,5.33,1.5,12,0,4,0.67,0.67,1,3,1,3,2,0
1,0,0,1,1,1,2,5.33,1.5,12,0,4,0.67,0.67,1,3,1,3,2,0
1,0,0,1,1,1,2,5.33,1.5,12,0,4,0.67,0.67,1,3,1,3,2,0
1,0,0,1,1,1,2,5.33,1.5,12,0,4,0.67,0.67,1,3,1,3,2,0
1,0,0,1,1,1,2,5.33,1.5,12,0,4,0.67,0.67,1,3,1,3,2,0
1,0,0,1,1,1,2,5.33,1.5,12,0,4,0.67,0.67,1,3,1,3,2,0
1,0,0,1,1,1,2,5.33,1.5,12,0,4,0.67,0.67,1,3,1,3,2,0
1,0,0,1,1,1,2,5.33,1.5,12,0,4,0.67,0.67,1,3,1,3,2,0
1,0,0,1,1,1,2,5.33,1.5,12,0,4,0.67,0.67,1,3,1,3,2,0
1,0,0,1,1,1,2,5.33,1.5,12,0,4,0.67,0.67,1,3,1,3,2,0
1,0,0,1,1,1,2,5.33,1.5,12,0,4,0.67,0.67,1,3,1,3,2,0
1,0,0,1,1,1,2,5.33,1.5,12,0,4,0.67,0.67,1,3,1,3,2,0
1,0,0,1,1,1,2,5.33,1.5,12,0,4,0.67,0.67,1,3,1,3,2,0
1,0,0,1,1,1,2,5.33,1.5,12,0,4,0.67,0.67,1,3,1,3,2,0
1,0,0,1,1,1,2,5.33,1.5,12,0,4,0.67,0.67,1,3,1,3,2,0
1,0,0,1,1,1,2,5.33,1.5,12,0,4,0.67,0.67,1,3,1,3,2,0
1,0,0,1,1,1,2,5.33,1.5,12,0,4,0.67,0.67,1,3,1,3,2,0
1,0,0,1,1,1,2,5.33,1.5,12,0,4,0.67,0.67,1,3,1,3,2,0
1,0,0,1,1,1,2,5.33,1.5,12,0,4,0.67,0.67,1,3,1,3,2,0
1,0,0,1,1,1,2,5.33,1.5,12,0,4,0.67,0.67,1,3,1,3,2,0
1,0,0,1,1,1,2,5.33,1.5,12,0,4,0.67,0.67,1,3,1,3,2,0
1,0,0,1,1,1,2,5.33,1.5,12,0,4,0.67,0.67,1,3,1,3,2,0
1,0,0,1,1,1,2,5.33,1.5,12,0,4,0.67,0.67,1,3,1,3,2,0
1,0,0,1,1,1,2,5.33,1.5,12,0,4,0.67,0.67,1,3,1,3,2,0
1,0,0,1,1,1,2,5.33,1.5,12,0,4,0.67,0.67,1,3,1,3,2,0
3,0,2,2,1,1,7,9.88,5.25,272.43,0.02,15,0.19,15.14,6,9,4,7,7,0
9,0,9,5,2,1,39,30.74,11.6,4136.75,0.12,75,0.09,229.82,29,46,15,12,39,0
1,0,0,1,1,1,2,7.74,1.5,17.41,0,5,0.67,0.97,2,3,2,3,2,0
1,0,0,1,1,1,2,7.74,1.5,17.41,0,5,0.67,0.97,2,3,2,3,2,0
1,0,0,1,1,1,2,7.74,1.5,17.41,0,5,0.67,0.97,2,3,2,3,2,0
1,0,0,1,1,1,2,7.74,1.5,17.41,0,5,0.67,0.97,2,3,2,3,2,0
1,0,0,1,1,1,2,7.74,1.5,17.41,0,5,0.67,0.97,2,3,2,3,2,0
1,0,0,1,1,1,2,7.74,1.5,17.41,0,5,0.67,0.97,2,3,2,3,2,0
1,0,0,1,1,1,2,7.74,1.5,17.41,0,5,0.67,0.97,2,3,2,3,2,0
1,0,0,1,1,1,2,7.74,1.5,17.41,0,5,0.67,0.97,2,3,2,3,2,0
1,0,0,1,1,1,2,7.74,1.5,17.41,0,5,0.67,0.97,2,3,2,3,2,0
1,0,0,1,1,1,2,7.74,1.5,17.41,0,5,0.67,0.97,2,3,2,3,2,0
1,0,0,1,1,1,2,7.74,1.5,17.41,0,5,0.67,0.97,2,3,2,3,2,0
1,0,0,1,1,1,2,7.74,1.5,17.41,0,5,0.67,0.97,2,3,2,3,2,0
1,0,0,1,1,1,2,7.74,1.5,17.41,0,5,0.67,0.97,2,3,2,3,2,0
1,0,0,1,1,1,2,7.74,1.5,17.41,0,5,0.67,0.97,2,3,2,3,2,0
1,0,0,1,1,1,2,7.74,1.5,17.41,0,5,0.67,0.97,2,3,2,3,2,0
1,0,0,1,1,1,2,7.74,1.5,17.41,0,5,0.67,0.97,2,3,2,3,2,0
1,0,0,1,1,1,2,7.74,1.5,17.41,0,5,0.67,0.97,2,3,2,3,2,0
1,0,0,1,1,1,2,7.74,1.5,17.41,0,5,0.67,0.97,2,3,2,3,2,0
1,0,0,1,1,1,2,7.74,1.5,17.41,0,5,0.67,0.97,2,3,2,3,2,0
1,0,0,1,1,1,2,7.74,1.5,17.41,0,5,0.67,0.97,2,3,2,3,2,0
1,0,0,1,1,1,2,7.74,1.5,17.41,0,5,0.67,0.97,2,3,2,3,2,0
1,0,0,1,1,1,2,7.74,1.5,17.41,0,5,0.67,0.97,2,3,2,3,2,0
1,0,0,1,1,1,2,7.74,1.5,17.41,0,5,0.67,0.97,2,3,2,3,2,0
1,0,0,1,1,1,2,7.74,1.5,17.41,0,5,0.67,0.97,2,3,2,3,2,0
1,0,0,1,1,1,2,7.74,1.5,17.41,0,5,0.67,0.97,2,3,2,3,2,0
1,0,0,1,1,1,2,7.74,1.5,17.41,0,5,0.67,0.97,2,3,2,3,2,0
1,0,0,1,1,1,0,0,0,0,0,1,0,0,0,1,0,1,0,0
1,0,0,1,1,1,2,5.33,1.5,12,0,4,0.67,0.67,1,3,1,3,2,0
1,0,0,1,1,1,2,5.33,1.5,12,0,4,0.67,0.67,1,3,1,3,2,0
1,0,0,1,1,1,2,5.33,1.5,12,0,4,0.67,0.67,1,3,1,3,2,0
15,2,8,8,1,8,16,28.13,9.17,2363.56,0.09,57,0.11,131.31,20,37,12,11,18,0
11,0,6,6,1,6,10,26.97,6.3,1070.48,0.06,40,0.16,59.47,14,26,10,9,10,0
1,0,0,1,1,1,0,0,0,0,0,1,0,0,0,1,0,1,0,0
1,0,0,1,1,1,2,5.33,1.5,12,0,4,0.67,0.67,1,3,1,3,2,0
1,0,0,1,1,1,2,5.33,1.5,12,0,4,0.67,0.67,1,3,1,3,2,0
1,0,0,1,1,1,2,5.33,1.5,12,0,4,0.67,0.67,1,3,1,3,2,0
1,0,0,1,1,1,2,5.33,1.5,12,0,4,0.67,0.67,1,3,1,3,2,0
1,0,0,1,1,1,2,5.33,1.5,12,0,4,0.67,0.67,1,3,1,3,2,0
1,0,0,1,1,1,2,5.33,1.5,12,0,4,0.67,0.67,1,3,1,3,2,0
1,0,0,1,1,1,2,7.74,1.5,17.41,0,5,0.67,0.97,2,3,2,3,2,0
1,0,0,1,1,1,0,0,0,0,0,1,0,0,0,1,0,1,0,0
1,0,0,1,1,1,2,5.33,1.5,12,0,4,0.67,0.67,1,3,1,3,2,0
1,0,0,1,1,1,2,5.33,1.5,12,0,4,0.67,0.67,1,3,1,3,2,0
1,0,0,1,1,1,2,5.33,1.5,12,0,4,0.67,0.67,1,3,1,3,2,0
1,0,0,1,1,1,2,5.33,1.5,12,0,4,0.67,0.67,1,3,1,3,2,0
1,0,0,1,1,1,2,5.33,1.5,12,0,4,0.67,0.67,1,3,1,3,2,0
1,0,0,1,1,1,2,7.74,1.5,17.41,0,5,0.67,0.97,2,3,2,3,2,0
1,0,0,1,1,1,2,7.74,1.5,17.41,0,5,0.67,0.97,2,3,2,3,2,0
1,0,0,1,1,1,2,7.74,1.5,17.41,0,5,0.67,0.97,2,3,2,3,2,0
1,0,0,1,1,1,2,7.74,1.5,17.41,0,5,0.67,0.97,2,3,2,3,2,0
1,0,0,1,1,1,2,7.74,1.5,17.41,0,5,0.67,0.97,2,3,2,3,2,0
1,0,0,1,1,1,2,7.74,1.5,17.41,0,5,0.67,0.97,2,3,2,3,2,0
1,0,0,1,1,1,0,0,0,0,0,0,0,0,0,0,0,0,0,0
1,0,0,1,1,1,2,7.74,1.5,17.41,0,5,0.67,0.97,2,3,2,3,2,0
1,0,0,1,1,1,2,7.74,1.5,17.41,0,5,0.67,0.97,2,3,2,3,2,0
1,0,0,1,1,1,2,7.74,1.5,17.41,0,5,0.67,0.97,2,3,2,3,2,0
1,0,0,1,1,1,0,0,0,0,0,1,0,0,0,1,0,1,0,0
1,0,0,1,1,1,0,0,0,0,0,1,0,0,0,1,0,1,0,0
9,3,0,5,5,4,4,6.95,27.62,5307.06,0.06,47,0.04,294.84,17,30,4,13,7,0
1,0,0,1,1,1,2,13.18,5.25,363.24,0.02,20,0.19,20.18,6,14,4,7,2,0
1,0,0,1,1,1,2,5.33,1.5,12,0,4,0.67,0.67,1,3,1,3,2,0
1,0,0,1,1,1,2,5.33,1.5,12,0,4,0.67,0.67,1,3,1,3,2,0
1,0,0,1,1,1,2,5.33,1.5,12,0,4,0.67,0.67,1,3,1,3,2,0
1,0,0,1,1,1,4,27.47,1.5,61.81,0.01,13,0.67,3.43,6,7,6,3,4,0
1,0,0,1,1,1,2,11.3,6.13,423.78,0.02,20,0.16,23.54,7,13,4,7,2,0
1,0,0,1,1,1,0,0,0,0,0,1,0,0,0,1,0,1,0,0
1,0,0,1,1,1,2,5.33,1.5,12,0,4,0.67,0.67,1,3,1,3,2,0
1,0,0,1,1,1,2,5.33,1.5,12,0,4,0.67,0.67,1,3,1,3,2,0
1,0,0,1,1,1,2,5.33,1.5,12,0,4,0.67,0.67,1,3,1,3,2,0
1,0,0,1,1,1,2,5.33,1.5,12,0,4,0.67,0.67,1,3,1,3,2,0
1,0,0,1,1,1,2,5.33,1.5,12,0,4,0.67,0.67,1,3,1,3,2,0
1,0,0,1,1,1,2,5.33,1.5,12,0,4,0.67,0.67,1,3,1,3,2,0
1,0,0,1,1,1,2,5.33,1.5,12,0,4,0.67,0.67,1,3,1,3,2,0
1,0,0,1,1,1,2,5.33,1.5,12,0,4,0.67,0.67,1,3,1,3,2,0
1,0,0,1,1,1,2,5.33,1.5,12,0,4,0.67,0.67,1,3,1,3,2,0
1,0,0,1,1,1,2,5.33,1.5,12,0,4,0.67,0.67,1,3,1,3,2,0
1,0,0,1,1,1,2,5.33,1.5,12,0,4,0.67,0.67,1,3,1,3,2,0
1,0,0,1,1,1,2,5.33,1.5,12,0,4,0.67,0.67,1,3,1,3,2,0
1,0,0,1,1,1,2,5.33,1.5,12,0,4,0.67,0.67,1,3,1,3,2,0
1,1,0,1,1,1,12,55.45,3.54,694.24,0.07,48,0.28,38.57,23,25,13,4,13,0
1,0,0,1,1,1,0,0,0,0,0,1,0,0,0,1,0,1,0,0
1,0,0,1,1,1,2,5.33,1.5,12,0,4,0.67,0.67,1,3,1,3,2,0
1,0,0,1,1,1,2,5.33,1.5,12,0,4,0.67,0.67,1,3,1,3,2,0
1,0,0,1,1,1,2,5.33,1.5,12,0,4,0.67,0.67,1,3,1,3,2,0
1,0,0,1,1,1,2,5.33,1.5,12,0,4,0.67,0.67,1,3,1,3,2,0
1,0,0,1,1,1,2,5.33,1.5,12,0,4,0.67,0.67,1,3,1,3,2,0
1,0,0,1,1,1,2,5.33,1.5,12,0,4,0.67,0.67,1,3,1,3,2,0
1,0,0,1,1,1,2,5.33,1.5,12,0,4,0.67,0.67,1,3,1,3,2,0
1,0,0,1,1,1,2,5.33,1.5,12,0,4,0.67,0.67,1,3,1,3,2,0
1,0,0,1,1,1,2,5.33,1.5,12,0,4,0.67,0.67,1,3,1,3,2,0
1,0,0,1,1,1,2,5.33,1.5,12,0,4,0.67,0.67,1,3,1,3,2,0
1,0,0,1,1,1,2,5.33,1.5,12,0,4,0.67,0.67,1,3,1,3,2,0
1,0,0,1,1,1,2,5.33,1.5,12,0,4,0.67,0.67,1,3,1,3,2,0
1,0,0,1,1,1,2,5.33,1.5,12,0,4,0.67,0.67,1,3,1,3,2,0
1,0,0,1,1,1,2,5.33,1.5,12,0,4,0.67,0.67,1,3,1,3,2,0
1,0,0,1,1,1,2,5.33,1.5,12,0,4,0.67,0.67,1,3,1,3,2,0
1,0,0,1,1,1,2,5.33,1.5,12,0,4,0.67,0.67,1,3,1,3,2,0
1,0,0,1,1,1,2,5.33,1.5,12,0,4,0.67,0.67,1,3,1,3,2,0
1,0,0,1,1,1,2,5.33,1.5,12,0,4,0.67,0.67,1,3,1,3,2,0
1,0,0,1,1,1,0,0,0,0,0,1,0,0,0,1,0,1,0,0
1,0,0,1,1,1,2,5.33,1.5,12,0,4,0.67,0.67,1,3,1,3,2,0
1,0,0,1,1,1,2,5.33,1.5,12,0,4,0.67,0.67,1,3,1,3,2,0
1,0,0,1,1,1,2,5.33,1.5,12,0,4,0.67,0.67,1,3,1,3,2,0
1,0,0,1,1,1,2,5.33,1.5,12,0,4,0.67,0.67,1,3,1,3,2,0
1,0,0,1,1,1,2,5.33,1.5,12,0,4,0.67,0.67,1,3,1,3,2,0
1,0,0,1,1,1,2,5.33,1.5,12,0,4,0.67,0.67,1,3,1,3,2,0
1,0,0,1,1,1,3,11.63,2,46.53,0.01,9,0.5,2.58,4,5,3,3,3,0
1,0,0,1,1,1,2,7.75,2,31.02,0.01,6,0.5,1.72,2,4,2,4,2,0
1,0,0,1,1,1,0,0,0,0,0,1,0,0,0,1,0,1,0,0
1,0,0,1,1,1,2,5.33,1.5,12,0,4,0.67,0.67,1,3,1,3,2,0
13,4,6,7,5,4,26,26.29,13.93,5099.62,0.12,77,0.07,283.31,30,47,14,13,30,0
1,0,0,1,1,1,2,5.8,2,23.22,0,5,0.5,1.29,1,4,1,4,2,0
1,0,0,1,1,1,2,5.8,2,23.22,0,5,0.5,1.29,1,4,1,4,2,0
1,0,0,1,1,1,2,5.33,1.5,12,0,4,0.67,0.67,1,3,1,3,2,0
1,0,0,1,1,1,2,5.33,1.5,12,0,4,0.67,0.67,1,3,1,3,2,0
3,0,4,2,1,1,9,20.54,4.38,393.13,0.03,23,0.23,21.84,10,13,8,7,9,0
19,1,11,10,2,10,19,33.9,10.42,3678.2,0.12,70,0.1,204.34,25,45,18,15,20,0
13,4,6,7,5,6,37,47.28,10.79,5503.58,0.17,105,0.09,305.75,41,64,19,10,41,0
3,0,1,2,2,1,8,29.49,3.82,429.88,0.04,27,0.26,23.88,12,15,11,7,8,0
9,0,5,5,1,5,9,22.93,6,825.65,0.05,33,0.17,45.87,12,21,9,9,9,0
1,1,0,1,1,1,5,19.03,2,76.11,0.01,11,0.5,4.23,7,4,7,4,6,0
1,0,0,1,1,1,2,5.33,1.5,12,0,4,0.67,0.67,1,3,1,3,2,0
1,0,0,1,1,1,2,5.33,1.5,12,0,4,0.67,0.67,1,3,1,3,2,0
1,0,0,1,1,1,2,5.33,1.5,12,0,4,0.67,0.67,1,3,1,3,2,0
1,0,0,1,1,1,2,5.33,1.5,12,0,4,0.67,0.67,1,3,1,3,2,0
1,0,0,1,1,1,2,5.33,1.5,12,0,4,0.67,0.67,1,3,1,3,2,0
1,0,0,1,1,1,2,5.33,1.5,12,0,4,0.67,0.67,1,3,1,3,2,0
1,0,0,1,1,1,2,5.33,1.5,12,0,4,0.67,0.67,1,3,1,3,2,0
1,0,0,1,1,1,2,5.33,1.5,12,0,4,0.67,0.67,1,3,1,3,2,0
1,0,0,1,1,1,2,5.33,1.5,12,0,4,0.67,0.67,1,3,1,3,2,0
1,0,0,1,1,1,2,5.33,1.5,12,0,4,0.67,0.67,1,3,1,3,2,0
1,0,0,1,1,1,2,5.33,1.5,12,0,4,0.67,0.67,1,3,1,3,2,0
1,0,0,1,1,1,2,5.33,1.5,12,0,4,0.67,0.67,1,3,1,3,2,0
1,0,0,1,1,1,2,5.33,1.5,12,0,4,0.67,0.67,1,3,1,3,2,0
1,0,0,1,1,1,2,5.33,1.5,12,0,4,0.67,0.67,1,3,1,3,2,0
1,0,0,1,1,1,2,5.33,1.5,12,0,4,0.67,0.67,1,3,1,3,2,0
1,0,0,1,1,1,2,5.33,1.5,12,0,4,0.67,0.67,1,3,1,3,2,0
1,0,0,1,1,1,2,5.33,1.5,12,0,4,0.67,0.67,1,3,1,3,2,0
1,0,0,1,1,1,2,5.33,1.5,12,0,4,0.67,0.67,1,3,1,3,2,0
1,0,0,1,1,1,2,5.33,1.5,12,0,4,0.67,0.67,1,3,1,3,2,0
1,0,0,1,1,1,2,5.33,1.5,12,0,4,0.67,0.67,1,3,1,3,2,0
1,0,0,1,1,1,2,5.33,1.5,12,0,4,0.67,0.67,1,3,1,3,2,0
1,0,0,1,1,1,2,5.33,1.5,12,0,4,0.67,0.67,1,3,1,3,2,0
1,0,0,1,1,1,2,5.33,1.5,12,0,4,0.67,0.67,1,3,1,3,2,0
1,0,0,1,1,1,2,5.33,1.5,12,0,4,0.67,0.67,1,3,1,3,2,0
1,0,0,1,1,1,2,5.33,1.5,12,0,4,0.67,0.67,1,3,1,3,2,0
1,0,0,1,1,1,2,5.33,1.5,12,0,4,0.67,0.67,1,3,1,3,2,0
1,0,0,1,1,1,2,5.33,1.5,12,0,4,0.67,0.67,1,3,1,3,2,0
1,0,0,1,1,1,2,5.33,1.5,12,0,4,0.67,0.67,1,3,1,3,2,0
1,0,0,1,1,1,2,5.33,1.5,12,0,4,0.67,0.67,1,3,1,3,2,0
1,0,0,1,1,1,2,5.33,1.5,12,0,4,0.67,0.67,1,3,1,3,2,0
1,0,0,1,1,1,2,5.33,1.5,12,0,4,0.67,0.67,1,3,1,3,2,0
1,0,0,1,1,1,2,5.33,1.5,12,0,4,0.67,0.67,1,3,1,3,2,0
1,0,0,1,1,1,2,5.33,1.5,12,0,4,0.67,0.67,1,3,1,3,2,0
1,0,0,1,1,1,2,5.33,1.5,12,0,4,0.67,0.67,1,3,1,3,2,0
1,0,0,1,1,1,2,5.33,1.5,12,0,4,0.67,0.67,1,3,1,3,2,0
1,0,0,1,1,1,2,5.33,1.5,12,0,4,0.67,0.67,1,3,1,3,2,0
1,0,0,1,1,1,2,5.33,1.5,12,0,4,0.67,0.67,1,3,1,3,2,0
1,0,0,1,1,1,2,5.33,1.5,12,0,4,0.67,0.67,1,3,1,3,2,0
1,0,0,1,1,1,2,5.33,1.5,12,0,4,0.67,0.67,1,3,1,3,2,0
1,0,0,1,1,1,2,5.33,1.5,12,0,4,0.67,0.67,1,3,1,3,2,0
1,0,0,1,1,1,2,5.33,1.5,12,0,4,0.67,0.67,1,3,1,3,2,0
1,0,0,1,1,1,2,5.33,1.5,12,0,4,0.67,0.67,1,3,1,3,2,0
1,0,0,1,1,1,2,5.33,1.5,12,0,4,0.67,0.67,1,3,1,3,2,0
1,0,0,1,1,1,2,7.74,1.5,17.41,0,5,0.67,0.97,2,3,2,3,2,0
1,0,0,1,1,1,2,7.74,1.5,17.41,0,5,0.67,0.97,2,3,2,3,2,0
1,0,0,1,1,1,2,7.74,1.5,17.41,0,5,0.67,0.97,2,3,2,3,2,0
1,0,0,1,1,1,2,7.74,1.5,17.41,0,5,0.67,0.97,2,3,2,3,2,0
1,0,0,1,1,1,2,7.74,1.5,17.41,0,5,0.67,0.97,2,3,2,3,2,0
1,0,0,1,1,1,2,7.74,1.5,17.41,0,5,0.67,0.97,2,3,2,3,2,0
1,0,0,1,1,1,2,7.74,1.5,17.41,0,5,0.67,0.97,2,3,2,3,2,0
1,0,0,1,1,1,2,7.74,1.5,17.41,0,5,0.67,0.97,2,3,2,3,2,0
1,0,0,1,1,1,2,7.74,1.5,17.41,0,5,0.67,0.97,2,3,2,3,2,0
1,0,0,1,1,1,2,7.74,1.5,17.41,0,5,0.67,0.97,2,3,2,3,2,0
1,0,0,1,1,1,2,7.74,1.5,17.41,0,5,0.67,0.97,2,3,2,3,2,0
1,0,0,1,1,1,2,7.74,1.5,17.41,0,5,0.67,0.97,2,3,2,3,2,0
1,0,0,1,1,1,2,7.74,1.5,17.41,0,5,0.67,0.97,2,3,2,3,2,0
1,0,0,1,1,1,2,7.74,1.5,17.41,0,5,0.67,0.97,2,3,2,3,2,0
1,0,0,1,1,1,2,7.74,1.5,17.41,0,5,0.67,0.97,2,3,2,3,2,0
1,0,0,1,1,1,2,7.74,1.5,17.41,0,5,0.67,0.97,2,3,2,3,2,0
1,0,0,1,1,1,2,7.74,1.5,17.41,0,5,0.67,0.97,2,3,2,3,2,0
1,0,0,1,1,1,2,7.74,1.5,17.41,0,5,0.67,0.97,2,3,2,3,2,0
1,0,0,1,1,1,2,7.74,1.5,17.41,0,5,0.67,0.97,2,3,2,3,2,0
1,0,0,1,1,1,2,7.74,1.5,17.41,0,5,0.67,0.97,2,3,2,3,2,0
1,0,0,1,1,1,2,7.74,1.5,17.41,0,5,0.67,0.97,2,3,2,3,2,0
1,0,0,1,1,1,2,7.74,1.5,17.41,0,5,0.67,0.97,2,3,2,3,2,0
1,0,0,1,1,1,2,7.74,1.5,17.41,0,5,0.67,0.97,2,3,2,3,2,0
1,0,0,1,1,1,2,7.74,1.5,17.41,0,5,0.67,0.97,2,3,2,3,2,0
1,0,0,1,1,1,2,7.74,1.5,17.41,0,5,0.67,0.97,2,3,2,3,2,0
1,0,0,1,1,1,2,7.74,1.5,17.41,0,5,0.67,0.97,2,3,2,3,2,0
1,0,0,1,1,1,0,0,0,0,0,1,0,0,0,1,0,1,0,0
1,0,0,1,1,1,2,5.33,1.5,12,0,4,0.67,0.67,1,3,1,3,2,0
1,0,0,1,1,1,2,5.33,1.5,12,0,4,0.67,0.67,1,3,1,3,2,0
1,0,0,1,1,1,2,5.33,1.5,12,0,4,0.67,0.67,1,3,1,3,2,0
1,0,0,1,1,1,0,0,0,0,0,1,0,0,0,1,0,1,0,0
1,0,0,1,1,1,2,5.33,1.5,12,0,4,0.67,0.67,1,3,1,3,2,0
1,0,0,1,1,1,2,5.33,1.5,12,0,4,0.67,0.67,1,3,1,3,2,0
1,0,0,1,1,1,2,5.33,1.5,12,0,4,0.67,0.67,1,3,1,3,2,0
1,0,0,1,1,1,2,5.33,1.5,12,0,4,0.67,0.67,1,3,1,3,2,0
1,0,0,1,1,1,2,5.33,1.5,12,0,4,0.67,0.67,1,3,1,3,2,0
1,0,0,1,1,1,2,5.33,1.5,12,0,4,0.67,0.67,1,3,1,3,2,0
1,0,0,1,1,1,2,7.74,1.5,17.41,0,5,0.67,0.97,2,3,2,3,2,0
1,0,0,1,1,1,2,7.74,1.5,17.41,0,5,0.67,0.97,2,3,2,3,2,0
1,0,0,1,1,1,2,7.74,1.5,17.41,0,5,0.67,0.97,2,3,2,3,2,0
1,0,0,1,1,1,2,7.74,1.5,17.41,0,5,0.67,0.97,2,3,2,3,2,0
1,0,0,1,1,1,0,0,0,0,0,1,0,0,0,1,0,1,0,0
1,0,0,1,1,1,0,0,0,0,0,1,0,0,0,1,0,1,0,0
9,3,0,5,5,4,4,6.95,27.62,5307.06,0.06,47,0.04,294.84,17,30,4,13,7,0
1,0,0,1,1,1,2,13.18,5.25,363.24,0.02,20,0.19,20.18,6,14,4,7,2,0
1,0,0,1,1,1,2,5.33,1.5,12,0,4,0.67,0.67,1,3,1,3,2,0
1,0,0,1,1,1,2,5.33,1.5,12,0,4,0.67,0.67,1,3,1,3,2,0
1,0,0,1,1,1,2,5.33,1.5,12,0,4,0.67,0.67,1,3,1,3,2,0
1,0,0,1,1,1,2,11.3,6.13,423.78,0.02,20,0.16,23.54,7,13,4,7,2,0
1,0,0,1,1,1,2,7.74,1.5,17.41,0,5,0.67,0.97,2,3,2,3,2,0
1,0,0,1,1,1,0,0,0,0,0,1,0,0,0,1,0,1,0,0
1,0,0,1,1,1,2,5.33,1.5,12,0,4,0.67,0.67,1,3,1,3,2,0
1,0,0,1,1,1,2,5.33,1.5,12,0,4,0.67,0.67,1,3,1,3,2,0
1,0,0,1,1,1,2,5.33,1.5,12,0,4,0.67,0.67,1,3,1,3,2,0
1,0,0,1,1,1,2,5.33,1.5,12,0,4,0.67,0.67,1,3,1,3,2,0
1,0,0,1,1,1,2,5.33,1.5,12,0,4,0.67,0.67,1,3,1,3,2,0
1,0,0,1,1,1,2,5.33,1.5,12,0,4,0.67,0.67,1,3,1,3,2,0
1,0,0,1,1,1,2,5.33,1.5,12,0,4,0.67,0.67,1,3,1,3,2,0
1,0,0,1,1,1,2,5.33,1.5,12,0,4,0.67,0.67,1,3,1,3,2,0
1,0,0,1,1,1,2,5.33,1.5,12,0,4,0.67,0.67,1,3,1,3,2,0
1,0,0,1,1,1,2,5.33,1.5,12,0,4,0.67,0.67,1,3,1,3,2,0
1,0,0,1,1,1,2,5.33,1.5,12,0,4,0.67,0.67,1,3,1,3,2,0
1,0,0,1,1,1,2,5.33,1.5,12,0,4,0.67,0.67,1,3,1,3,2,0
1,0,0,1,1,1,2,7.74,1.5,17.41,0,5,0.67,0.97,2,3,2,3,2,0
1,0,0,1,1,1,2,7.74,1.5,17.41,0,5,0.67,0.97,2,3,2,3,2,0
1,0,0,1,1,1,2,7.74,1.5,17.41,0,5,0.67,0.97,2,3,2,3,2,0
1,0,0,1,1,1,2,7.74,1.5,17.41,0,5,0.67,0.97,2,3,2,3,2,0
1,0,0,1,1,1,2,7.74,1.5,17.41,0,5,0.67,0.97,2,3,2,3,2,0
1,0,0,1,1,1,2,7.74,1.5,17.41,0,5,0.67,0.97,2,3,2,3,2,0
1,0,0,1,1,1,2,7.74,1.5,17.41,0,5,0.67,0.97,2,3,2,3,2,0
1,0,0,1,1,1,0,0,0,0,0,0,0,0,0,0,0,0,0,0
1,0,0,1,1,1,0,0,0,0,0,1,0,0,0,1,0,1,0,0
21,1,5,11,1,9,15,36.1,10.29,3819.44,0.12,79,0.1,212.19,24,55,14,12,16,0
7,0,6,4,2,3,23,28.62,10.8,3337.93,0.1,65,0.09,185.44,27,38,15,12,23,0
11,0,2,6,1,1,33,26.88,13.46,4871.53,0.12,80,0.07,270.64,35,45,13,10,33,0
11,0,7,6,1,5,17,30.02,8.14,1990.3,0.08,52,0.12,110.57,19,33,14,12,17,0
3,0,21,2,2,1,17,22.94,9.44,2046.09,0.07,51,0.11,113.67,17,34,9,10,17,0
1,0,0,1,1,1,7,10,3,90,0.01,10,0.33,5,6,4,4,4,7,0
1,0,0,1,1,1,2,7.74,1.5,17.41,0,5,0.67,0.97,2,3,2,3,2,0
1,0,0,1,1,1,0,0,0,0,0,0,0,0,0,0,0,0,0,0
1,0,0,1,1,1,0,0,0,0,0,1,0,0,0,1,0,1,0,0
1,0,0,1,1,1,2,5.33,1.5,12,0,4,0.67,0.67,1,3,1,3,2,0
1,0,0,1,1,1,2,5.33,1.5,12,0,4,0.67,0.67,1,3,1,3,2,0
1,0,0,1,1,1,2,5.33,1.5,12,0,4,0.67,0.67,1,3,1,3,2,0
1,0,0,1,1,1,2,7.74,1.5,17.41,0,5,0.67,0.97,2,3,2,3,2,0
1,0,0,1,1,1,2,7.74,1.5,17.41,0,5,0.67,0.97,2,3,2,3,2,0
1,0,0,1,1,1,2,7.74,1.5,17.41,0,5,0.67,0.97,2,3,2,3,2,0
1,0,0,1,1,1,0,0,0,0,0,1,0,0,0,1,0,1,0,0
1,0,0,1,1,1,0,0,0,0,0,1,0,0,0,1,0,1,0,0
9,3,0,5,5,4,4,6.95,27.62,5307.06,0.06,47,0.04,294.84,17,30,4,13,7,0
1,0,0,1,1,1,2,13.18,5.25,363.24,0.02,20,0.19,20.18,6,14,4,7,2,0
1,0,0,1,1,1,2,5.33,1.5,12,0,4,0.67,0.67,1,3,1,3,2,0
1,0,0,1,1,1,2,5.33,1.5,12,0,4,0.67,0.67,1,3,1,3,2,0
1,0,0,1,1,1,2,5.33,1.5,12,0,4,0.67,0.67,1,3,1,3,2,0
1,0,0,1,1,1,2,11.3,6.13,423.78,0.02,20,0.16,23.54,7,13,4,7,2,0
1,0,0,1,1,1,2,7.74,1.5,17.41,0,5,0.67,0.97,2,3,2,3,2,0
1,0,0,1,1,1,0,0,0,0,0,1,0,0,0,1,0,1,0,0
1,0,0,1,1,1,2,5.33,1.5,12,0,4,0.67,0.67,1,3,1,3,2,0
1,0,0,1,1,1,2,5.33,1.5,12,0,4,0.67,0.67,1,3,1,3,2,0
1,0,0,1,1,1,2,5.33,1.5,12,0,4,0.67,0.67,1,3,1,3,2,0
1,0,0,1,1,1,2,5.33,1.5,12,0,4,0.67,0.67,1,3,1,3,2,0
1,0,0,1,1,1,2,5.33,1.5,12,0,4,0.67,0.67,1,3,1,3,2,0
1,0,0,1,1,1,2,5.33,1.5,12,0,4,0.67,0.67,1,3,1,3,2,0
1,0,0,1,1,1,2,5.33,1.5,12,0,4,0.67,0.67,1,3,1,3,2,0
1,0,0,1,1,1,2,5.33,1.5,12,0,4,0.67,0.67,1,3,1,3,2,0
1,0,0,1,1,1,2,5.33,1.5,12,0,4,0.67,0.67,1,3,1,3,2,0
1,0,0,1,1,1,2,5.33,1.5,12,0,4,0.67,0.67,1,3,1,3,2,0
1,0,0,1,1,1,2,5.33,1.5,12,0,4,0.67,0.67,1,3,1,3,2,0
1,0,0,1,1,1,2,5.33,1.5,12,0,4,0.67,0.67,1,3,1,3,2,0
1,0,0,1,1,1,2,7.74,1.5,17.41,0,5,0.67,0.97,2,3,2,3,2,0
1,0,0,1,1,1,2,7.74,1.5,17.41,0,5,0.67,0.97,2,3,2,3,2,0
1,0,0,1,1,1,2,7.74,1.5,17.41,0,5,0.67,0.97,2,3,2,3,2,0
1,0,0,1,1,1,2,7.74,1.5,17.41,0,5,0.67,0.97,2,3,2,3,2,0
1,0,0,1,1,1,2,7.74,1.5,17.41,0,5,0.67,0.97,2,3,2,3,2,0
1,0,0,1,1,1,2,7.74,1.5,17.41,0,5,0.67,0.97,2,3,2,3,2,0
1,0,0,1,1,1,2,7.74,1.5,17.41,0,5,0.67,0.97,2,3,2,3,2,0
1,0,0,1,1,1,0,0,0,0,0,0,0,0,0,0,0,0,0,0
1,0,0,1,1,1,0,0,0,0,0,1,0,0,0,1,0,1,0,0
19,1,4,10,1,10,18,29.77,12,4286.8,0.12,76,0.08,238.16,24,52,13,13,19,0
7,0,6,4,2,3,23,30.86,10.13,3163.84,0.1,65,0.1,175.77,27,38,16,12,23,0
9,0,2,5,1,1,25,24.26,11.05,2959.73,0.09,62,0.09,164.43,27,35,11,9,25,0
19,0,7,10,1,9,21,30.87,11.57,4133.7,0.12,76,0.09,229.65,27,49,14,12,21,0
3,0,16,2,2,1,15,20.02,8.75,1532.45,0.06,42,0.11,85.14,14,28,8,10,15,0
1,0,0,1,1,1,6,10.8,2.5,67.5,0.01,9,0.4,3.75,5,4,4,4,6,0
1,0,0,1,1,1,2,7.74,1.5,17.41,0,5,0.67,0.97,2,3,2,3,2,0
1,0,0,1,1,1,0,0,0,0,0,0,0,0,0,0,0,0,0,0
1,0,0,1,1,1,0,0,0,0,0,1,0,0,0,1,0,1,0,0
1,0,0,1,1,1,2,5.33,1.5,12,0,4,0.67,0.67,1,3,1,3,2,0
1,0,0,1,1,1,2,5.33,1.5,12,0,4,0.67,0.67,1,3,1,3,2,0
1,0,0,1,1,1,2,5.33,1.5,12,0,4,0.67,0.67,1,3,1,3,2,0
1,0,0,1,1,1,2,7.74,1.5,17.41,0,5,0.67,0.97,2,3,2,3,2,0
1,0,0,1,1,1,2,7.74,1.5,17.41,0,5,0.67,0.97,2,3,2,3,2,0
1,0,0,1,1,1,2,7.74,1.5,17.41,0,5,0.67,0.97,2,3,2,3,2,0
1,0,0,1,1,1,2,5.33,1.5,12,0,4,0.67,0.67,1,3,1,3,2,0
1,0,0,1,1,1,2,5.33,1.5,12,0,4,0.67,0.67,1,3,1,3,2,0
1,0,0,1,1,1,2,5.33,1.5,12,0,4,0.67,0.67,1,3,1,3,2,0
5,2,7,3,2,1,11,7.99,15.75,1981.59,0.04,34,0.06,110.09,14,20,4,9,13,0
9,2,7,5,3,1,27,17.34,14.4,3596.09,0.08,56,0.07,199.78,24,32,10,12,29,0
7,0,3,4,2,3,14,15.01,12,2161.02,0.06,41,0.08,120.06,18,23,9,12,14,0
3,0,0,2,2,1,6,5.89,7,288.46,0.01,13,0.14,16.03,4,9,2,7,6,0
12,1,1,11,11,1,59,34.18,20.57,14456.47,0.23,128,0.05,803.14,43,85,23,22,60,0
12,1,1,11,11,1,59,34.18,20.57,14456.47,0.23,128,0.05,803.14,43,85,23,22,60,0
3,0,10,2,2,1,58,153.4,9.84,14840.71,0.5,247,0.1,824.48,150,97,61,8,58,1
1,0,3,1,1,1,4,13.16,4.5,266.43,0.02,16,0.22,14.8,4,12,4,9,4,0
1,0,3,1,1,1,4,13.16,4.5,266.43,0.02,16,0.22,14.8,4,12,4,9,4,0
1,0,3,1,1,1,4,13.16,4.5,266.43,0.02,16,0.22,14.8,4,12,4,9,4,0
1,0,3,1,1,1,4,13.16,4.5,266.43,0.02,16,0.22,14.8,4,12,4,9,4,0
1,0,3,1,1,1,4,13.16,4.5,266.43,0.02,16,0.22,14.8,4,12,4,9,4,0
1,0,3,1,1,1,4,13.16,4.5,266.43,0.02,16,0.22,14.8,4,12,4,9,4,0
1,0,3,1,1,1,4,13.16,4.5,266.43,0.02,16,0.22,14.8,4,12,4,9,4,0
1,0,3,1,1,1,4,13.16,4.5,266.43,0.02,16,0.22,14.8,4,12,4,9,4,0
1,0,3,1,1,1,4,13.16,4.5,266.43,0.02,16,0.22,14.8,4,12,4,9,4,0
1,0,3,1,1,1,4,13.16,4.5,266.43,0.02,16,0.22,14.8,4,12,4,9,4,0
1,0,3,1,1,1,4,13.16,4.5,266.43,0.02,16,0.22,14.8,4,12,4,9,4,0
1,0,3,1,1,1,5,13.16,4.5,266.43,0.02,16,0.22,14.8,4,12,4,9,5,0
1,0,3,1,1,1,4,13.16,4.5,266.43,0.02,16,0.22,14.8,4,12,4,9,4,0
1,0,3,1,1,1,4,13.16,4.5,266.43,0.02,16,0.22,14.8,4,12,4,9,4,0
1,0,3,1,1,1,4,13.16,4.5,266.43,0.02,16,0.22,14.8,4,12,4,9,4,0
1,0,3,1,1,1,4,13.16,4.5,266.43,0.02,16,0.22,14.8,4,12,4,9,4,0
1,0,3,1,1,1,4,13.16,4.5,266.43,0.02,16,0.22,14.8,4,12,4,9,4,0
1,0,3,1,1,1,4,13.16,4.5,266.43,0.02,16,0.22,14.8,4,12,4,9,4,0
1,0,3,1,1,1,4,13.16,4.5,266.43,0.02,16,0.22,14.8,4,12,4,9,4,0
1,0,3,1,1,1,5,13.16,4.5,266.43,0.02,16,0.22,14.8,4,12,4,9,5,0
1,0,6,1,1,1,11,24.95,10.56,2780.03,0.09,62,0.09,154.45,19,43,9,10,11,0
1,0,3,1,1,1,4,13.16,4.5,266.43,0.02,16,0.22,14.8,4,12,4,9,4,0
1,0,6,1,1,1,11,24.95,10.56,2780.03,0.09,62,0.09,154.45,19,43,9,10,11,0
1,0,3,1,1,1,4,13.16,4.5,266.43,0.02,16,0.22,14.8,4,12,4,9,4,0
1,0,3,1,1,1,4,13.16,4.5,266.43,0.02,16,0.22,14.8,4,12,4,9,4,0
1,0,3,1,1,1,4,13.16,4.5,266.43,0.02,16,0.22,14.8,4,12,4,9,4,0
1,0,6,1,1,1,11,24.95,10.56,2780.03,0.09,62,0.09,154.45,19,43,9,10,11,0
1,0,3,1,1,1,4,13.16,4.5,266.43,0.02,16,0.22,14.8,4,12,4,9,4,0
1,0,6,1,1,1,11,24.95,10.56,2780.03,0.09,62,0.09,154.45,19,43,9,10,11,0
1,0,6,1,1,1,11,24.95,10.56,2780.03,0.09,62,0.09,154.45,19,43,9,10,11,0
7,1,3,6,6,1,35,25.84,14.57,5486.42,0.13,76,0.07,304.8,24,52,14,17,36,0
1,0,13,1,1,1,32,76.84,13.26,13512.4,0.34,202,0.08,750.69,61,141,23,10,32,0
1,0,13,1,1,1,32,76.84,13.26,13512.4,0.34,202,0.08,750.69,61,141,23,10,32,0
1,0,3,1,1,1,4,13.16,4.5,266.43,0.02,16,0.22,14.8,4,12,4,9,4,0
7,1,3,6,6,1,35,27.94,13.6,5168,0.13,76,0.07,287.11,24,52,15,17,36,0
7,1,3,6,6,1,35,25.84,14.57,5486.42,0.13,76,0.07,304.8,24,52,14,17,36,0
7,1,3,6,6,1,35,25.84,14.57,5486.42,0.13,76,0.07,304.8,24,52,14,17,36,0
1,0,13,1,1,1,32,76.84,13.26,13512.4,0.34,202,0.08,750.69,61,141,23,10,32,0
1,0,13,1,1,1,32,76.84,13.26,13512.4,0.34,202,0.08,750.69,61,141,23,10,32,0
1,0,13,1,1,1,32,76.84,13.26,13512.4,0.34,202,0.08,750.69,61,141,23,10,32,0
1,0,3,1,1,1,4,13.16,4.5,266.43,0.02,16,0.22,14.8,4,12,4,9,4,0
1,0,13,1,1,1,32,76.84,13.26,13512.4,0.34,202,0.08,750.69,61,141,23,10,32,0
1,0,13,1,1,1,32,76.84,13.26,13512.4,0.34,202,0.08,750.69,61,141,23,10,32,0
1,0,0,1,1,1,2,7.74,1.5,17.41,0,5,0.67,0.97,2,3,2,3,2,0
1,0,0,1,1,1,0,0,0,0,0,0,0,0,0,0,0,0,0,0
1,0,0,1,1,1,2,7.74,1.5,17.41,0,5,0.67,0.97,2,3,2,3,2,0
3,0,0,2,2,1,6,7.97,5.83,271.29,0.02,14,0.17,15.07,5,9,3,7,6,0
1,0,0,1,1,1,0,0,0,0,0,0,0,0,0,0,0,0,0,0
1,0,0,1,1,1,1,0,0,0,0,1,0,0,0,1,0,1,1,0
1,0,0,1,1,1,1,0,0,0,0,1,0,0,0,1,0,1,1,0
1,0,0,1,1,1,1,0,0,0,0,1,0,0,0,1,0,1,1,0
1,0,0,1,1,1,1,0,0,0,0,1,0,0,0,1,0,1,1,0
1,0,0,1,1,1,1,0,0,0,0,1,0,0,0,1,0,1,1,0
1,0,0,1,1,1,1,0,0,0,0,1,0,0,0,1,0,1,1,0
1,0,0,1,1,1,2,5.33,1.5,12,0,4,0.67,0.67,1,3,1,3,2,0
1,0,0,1,1,1,2,5.33,1.5,12,0,4,0.67,0.67,1,3,1,3,2,0
1,0,0,1,1,1,2,5.33,1.5,12,0,4,0.67,0.67,1,3,1,3,2,0
1,0,0,1,1,1,2,5.33,1.5,12,0,4,0.67,0.67,1,3,1,3,2,0
1,0,0,1,1,1,2,5.33,1.5,12,0,4,0.67,0.67,1,3,1,3,2,0
1,0,0,1,1,1,2,5.33,1.5,12,0,4,0.67,0.67,1,3,1,3,2,0
1,0,0,1,1,1,2,5.33,1.5,12,0,4,0.67,0.67,1,3,1,3,2,0
1,0,0,1,1,1,2,5.33,1.5,12,0,4,0.67,0.67,1,3,1,3,2,0
1,0,0,1,1,1,2,5.33,1.5,12,0,4,0.67,0.67,1,3,1,3,2,0
1,0,0,1,1,1,2,0,0,0,0,4,0,0,0,4,0,4,2,0
1,0,0,1,1,1,1,0,0,0,0,1,0,0,0,1,0,1,1,0
1,0,0,1,1,1,2,0,0,0,0,5,0,0,0,5,0,5,2,0
1,0,0,1,1,1,2,7.74,1.5,17.41,0,5,0.67,0.97,2,3,2,3,2,0
1,0,0,1,1,1,0,0,0,0,0,0,0,0,0,0,0,0,0,0
1,0,0,1,1,1,2,7.74,1.5,17.41,0,5,0.67,0.97,2,3,2,3,2,0
1,0,0,1,1,1,0,0,0,0,0,0,0,0,0,0,0,0,0,0
9,0,0,5,1,1,18,18.95,7,928.51,0.04,37,0.14,51.58,14,23,6,6,18,0
1,0,1,1,1,1,2,7.74,1.5,17.41,0,5,0.67,0.97,2,3,2,3,2,1
3,1,34,2,2,1,1076,5475.53,23.38,2992935.22,42.67,12476,0.04,166274.17,5169,7307,1216,11,1077,0
17,1,0,9,1,5,27,30.56,9.33,2662.31,0.1,66,0.11,147.91,28,38,12,8,28,0
1,0,0,1,1,1,2,5.33,1.5,12,0,4,0.67,0.67,1,3,1,3,2,0
7,1,1,4,1,3,11,20.37,7,998.37,0.05,33,0.14,55.46,14,19,10,10,12,0
3,0,0,2,2,1,6,5.89,7,288.46,0.01,13,0.14,16.03,4,9,2,7,6,0
3,0,2,2,1,1,7,13.45,3.6,174.36,0.02,14,0.28,9.69,6,8,5,6,7,0
1,0,0,1,1,1,2,5.33,1.5,12,0,4,0.67,0.67,1,3,1,3,2,0
3,1,188,2,1,1,553,2755.34,30.29,2528719.24,27.82,8712,0.03,140484.39,3807,4905,754,12,554,1
69,1,355,35,33,1,428,1419.95,39.29,2192161.64,18.6,6120,0.03,121786.76,2829,3291,540,15,429,1
3,1,64,2,1,1,138,566.04,32.79,608439.24,6.19,2410,0.03,33802.18,1071,1339,196,12,139,0
11,4,3,6,5,3,20,18.8,13.33,3341.7,0.08,59,0.08,185.65,24,35,9,10,24,0
43,3,0,22,2,1,479,1643.15,10.81,192184.74,5.92,2029,0.09,10676.93,1019,1010,424,9,482,0
1,0,0,1,1,1,6,25.91,3.33,287.9,0.03,26,0.3,15.99,10,16,6,4,6,0
1,0,0,1,1,1,2,7.74,1.5,17.41,0,5,0.67,0.97,2,3,2,3,2,0
1,0,0,1,1,1,1,0,0,0,0,0,0,0,0,0,0,0,1,0
1,0,0,1,1,1,1,0,0,0,0,1,0,0,0,1,0,1,1,0
1,0,0,1,1,1,2,5.33,1.5,12,0,4,0.67,0.67,1,3,1,3,2,0
1,0,0,1,1,1,2,5.33,1.5,12,0,4,0.67,0.67,1,3,1,3,2,0
1,9,0,1,1,1,2,0,0,0,0,9,0,0,9,0,1,0,11,0
1,0,0,1,1,1,1,0,0,0,0,0,0,0,0,0,0,0,1,0
1,0,0,1,1,1,1,0,0,0,0,0,0,0,0,0,0,0,1,0
1,0,0,1,1,1,1,0,0,0,0,1,0,0,0,1,0,1,1,0
1,0,0,1,1,1,4,18.49,2.4,106.51,0.01,14,0.42,5.92,6,8,5,4,4,0
1,0,0,1,1,1,2,5.33,1.5,12,0,4,0.67,0.67,1,3,1,3,2,0
1,0,0,1,1,1,5,8.45,0.75,4.75,0,4,1.33,0.26,3,1,2,1,5,0
1,0,0,1,1,1,1,0,0,0,0,0,0,0,0,0,0,0,1,0
1,0,0,1,1,1,1,0,0,0,0,1,0,0,0,1,0,1,1,0
1,0,0,1,1,1,3,10.8,2.5,67.5,0.01,9,0.4,3.75,3,6,3,5,3,0
1,0,0,1,1,1,2,5.33,1.5,12,0,4,0.67,0.67,1,3,1,3,2,0
1,0,0,1,1,1,2,6.2,2.5,38.77,0.01,6,0.4,2.15,1,5,1,5,2,0
1,0,0,1,1,1,4,9.51,0.5,2.38,0,3,2,0.13,2,1,2,1,4,0
1,0,0,1,1,1,1,0,0,0,0,1,0,0,0,1,0,1,1,0
1,0,0,1,1,1,2,5.33,1.5,12,0,4,0.67,0.67,1,3,1,3,2,0
1,0,0,1,1,1,2,5.33,1.5,12,0,4,0.67,0.67,1,3,1,3,2,0
1,0,0,1,1,1,2,0,0,0,0,4,0,0,0,4,0,4,2,0
1,0,0,1,1,1,1,0,0,0,0,1,0,0,0,1,0,1,1,0
1,0,0,1,1,1,2,0,0,0,0,5,0,0,0,5,0,5,2,0
1,0,0,1,1,1,1,0,0,0,0,1,0,0,0,1,0,1,1,0
1,0,0,1,1,1,2,5.33,1.5,12,0,4,0.67,0.67,1,3,1,3,2,0
1,0,0,1,1,1,2,5.33,1.5,12,0,4,0.67,0.67,1,3,1,3,2,0
1,0,0,1,1,1,1,0,0,0,0,1,0,0,0,1,0,1,1,0
1,0,0,1,1,1,0,0,0,0,0,1,0,0,0,1,0,1,0,0
9,3,0,5,5,4,4,6.95,27.62,5307.06,0.06,47,0.04,294.84,17,30,4,13,7,0
1,0,0,1,1,1,2,13.18,5.25,363.24,0.02,20,0.19,20.18,6,14,4,7,2,0
1,0,0,1,1,1,2,5.33,1.5,12,0,4,0.67,0.67,1,3,1,3,2,0
1,0,0,1,1,1,2,5.33,1.5,12,0,4,0.67,0.67,1,3,1,3,2,0
1,0,0,1,1,1,2,5.33,1.5,12,0,4,0.67,0.67,1,3,1,3,2,0
1,0,0,1,1,1,2,11.3,6.13,423.78,0.02,20,0.16,23.54,7,13,4,7,2,0
1,0,0,1,1,1,0,0,0,0,0,1,0,0,0,1,0,1,0,0
1,0,0,1,1,1,2,7.49,3,67.38,0.01,8,0.33,3.74,1,7,1,6,2,0
1,0,0,1,1,1,0,0,0,0,0,0,0,0,0,0,0,0,0,0
1,0,0,1,1,1,2,7.74,1.5,17.41,0,5,0.67,0.97,2,3,2,3,2,0
1,0,0,1,1,1,2,7.74,1.5,17.41,0,5,0.67,0.97,2,3,2,3,2,0
1,0,0,1,1,1,2,7.74,1.5,17.41,0,5,0.67,0.97,2,3,2,3,2,0
1,0,0,1,1,1,0,0,0,0,0,1,0,0,0,1,0,1,0,0
9,3,0,5,5,4,4,6.95,27.62,5307.06,0.06,47,0.04,294.84,17,30,4,13,7,0
1,0,0,1,1,1,2,13.18,5.25,363.24,0.02,20,0.19,20.18,6,14,4,7,2,0
1,0,0,1,1,1,2,5.33,1.5,12,0,4,0.67,0.67,1,3,1,3,2,0
1,0,0,1,1,1,2,5.33,1.5,12,0,4,0.67,0.67,1,3,1,3,2,0
1,0,0,1,1,1,2,5.33,1.5,12,0,4,0.67,0.67,1,3,1,3,2,0
1,0,0,1,1,1,2,11.3,6.13,423.78,0.02,20,0.16,23.54,7,13,4,7,2,0
1,0,0,1,1,1,2,7.74,1.5,17.41,0,5,0.67,0.97,2,3,2,3,2,0
1,0,0,1,1,1,0,0,0,0,0,0,0,0,0,0,0,0,0,0
1,0,0,1,1,1,2,7.74,1.5,17.41,0,5,0.67,0.97,2,3,2,3,2,0
1,0,0,1,1,1,2,5.33,1.5,12,0,4,0.67,0.67,1,3,1,3,2,0
1,0,0,1,1,1,2,5.33,1.5,12,0,4,0.67,0.67,1,3,1,3,2,0
1,0,0,1,1,1,2,5.33,1.5,12,0,4,0.67,0.67,1,3,1,3,2,0
1,0,0,1,1,1,2,5.33,1.5,12,0,4,0.67,0.67,1,3,1,3,2,0
1,0,0,1,1,1,2,5.33,1.5,12,0,4,0.67,0.67,1,3,1,3,2,0
1,0,0,1,1,1,2,5.33,1.5,12,0,4,0.67,0.67,1,3,1,3,2,0
1,0,0,1,1,1,2,5.33,1.5,12,0,4,0.67,0.67,1,3,1,3,2,0
1,0,0,1,1,1,2,5.33,1.5,12,0,4,0.67,0.67,1,3,1,3,2,0
1,0,0,1,1,1,2,5.33,1.5,12,0,4,0.67,0.67,1,3,1,3,2,0
3,0,0,2,2,1,6,5.89,7,288.46,0.01,13,0.14,16.03,4,9,2,7,6,0
1,0,0,1,1,1,2,5.33,1.5,12,0,4,0.67,0.67,1,3,1,3,2,0
1,0,0,1,1,1,2,5.33,1.5,12,0,4,0.67,0.67,1,3,1,3,2,0
1,0,0,1,1,1,2,5.33,1.5,12,0,4,0.67,0.67,1,3,1,3,2,0
1,0,0,1,1,1,2,5.33,1.5,12,0,4,0.67,0.67,1,3,1,3,2,0
1,0,0,1,1,1,2,5.33,1.5,12,0,4,0.67,0.67,1,3,1,3,2,0
1,0,0,1,1,1,2,5.33,1.5,12,0,4,0.67,0.67,1,3,1,3,2,0
1,0,0,1,1,1,2,5.33,1.5,12,0,4,0.67,0.67,1,3,1,3,2,0
1,0,0,1,1,1,2,5.33,1.5,12,0,4,0.67,0.67,1,3,1,3,2,0
1,0,1,1,1,1,40,150.16,6.38,6107.83,0.32,168,0.16,339.32,82,86,45,7,40,1
61,1,2,31,2,1,162,179.25,18.67,62492.81,1.12,539,0.05,3471.82,239,300,64,10,163,0
1,0,2,1,1,1,67,306.07,5.75,10119.5,0.59,280,0.17,562.19,138,142,72,6,67,1
1,0,0,1,1,1,2,7.74,1.5,17.41,0,5,0.67,0.97,2,3,2,3,2,0
1,0,0,1,1,1,2,7.74,1.5,17.41,0,5,0.67,0.97,2,3,2,3,2,0
1,0,0,1,1,1,2,7.74,1.5,17.41,0,5,0.67,0.97,2,3,2,3,2,0
41,9,49,21,2,1,105,116.92,25.34,75085.24,0.99,445,0.04,4171.39,182,263,79,22,114,1
1,0,0,1,1,1,2,7.74,1.5,17.41,0,5,0.67,0.97,2,3,2,3,2,0
1,0,0,1,1,1,2,7.74,1.5,17.41,0,5,0.67,0.97,2,3,2,3,2,0
1,0,0,1,1,1,2,7.74,1.5,17.41,0,5,0.67,0.97,2,3,2,3,2,0
1,0,0,1,1,1,0,0,0,0,0,1,0,0,0,1,0,1,0,0
1,0,0,1,1,1,0,0,0,0,0,1,0,0,0,1,0,1,0,0
1,0,8,1,1,1,25,43.24,17.5,13243.49,0.25,161,0.06,735.75,56,105,16,10,25,0
9,3,0,5,5,4,4,6.95,27.62,5307.06,0.06,47,0.04,294.84,17,30,4,13,7,0
1,0,0,1,1,1,10,36.77,4.25,664.17,0.05,40,0.24,36.9,17,23,10,5,10,0
3,0,1,2,1,1,7,13.45,3.6,174.36,0.02,14,0.28,9.69,6,8,5,6,7,0
53,6,6,27,8,22,64,57.57,22.38,28844.61,0.43,232,0.04,1602.48,79,153,30,17,70,0
3,2,1,2,2,1,9,13.87,7.5,780,0.03,26,0.13,43.33,9,17,6,10,11,0
3,0,1,2,1,1,7,13.45,3.6,174.36,0.02,14,0.28,9.69,6,8,5,6,7,0
3,0,1,2,1,1,7,13.45,3.6,174.36,0.02,14,0.28,9.69,6,8,5,6,7,0
3,0,1,2,1,1,11,17.44,4.67,379.91,0.03,22,0.21,21.11,8,14,6,7,11,0
1,0,0,1,1,1,2,13.18,5.25,363.24,0.02,20,0.19,20.18,6,14,4,7,2,0
9,0,2,5,1,1,19,15.07,14.06,2976.61,0.07,49,0.07,165.37,23,26,9,11,19,0
1,0,0,1,1,1,2,5.33,1.5,12,0,4,0.67,0.67,1,3,1,3,2,0
1,0,0,1,1,1,2,5.33,1.5,12,0,4,0.67,0.67,1,3,1,3,2,0
1,0,0,1,1,1,2,5.33,1.5,12,0,4,0.67,0.67,1,3,1,3,2,0
1,0,0,1,1,1,4,27.47,1.5,61.81,0.01,13,0.67,3.43,6,7,6,3,4,0
1,0,14,1,1,1,62,257.79,6.1,9592.43,0.52,272,0.16,532.91,122,150,50,5,62,0
7,0,1,4,2,3,10,10.18,14.86,2247.4,0.05,35,0.07,124.86,16,19,7,13,10,0
1,0,0,1,1,1,2,11.3,6.13,423.78,0.02,20,0.16,23.54,7,13,4,7,2,0
25,3,62,13,9,4,51,100.18,13.08,17127.51,0.44,213,0.08,951.53,77,136,53,18,54,0
1,0,0,1,1,1,3,9,3.33,100,0.01,10,0.3,5.56,4,6,3,5,3,0
1,0,0,1,1,1,0,0,0,0,0,1,0,0,0,1,0,1,0,0
1,0,0,1,1,1,2,5.33,1.5,12,0,4,0.67,0.67,1,3,1,3,2,0
1,0,0,1,1,1,2,5.33,1.5,12,0,4,0.67,0.67,1,3,1,3,2,0
1,0,0,1,1,1,2,5.33,1.5,12,0,4,0.67,0.67,1,3,1,3,2,0
1,0,0,1,1,1,2,5.33,1.5,12,0,4,0.67,0.67,1,3,1,3,2,0
1,0,0,1,1,1,2,5.33,1.5,12,0,4,0.67,0.67,1,3,1,3,2,0
1,0,0,1,1,1,2,5.33,1.5,12,0,4,0.67,0.67,1,3,1,3,2,0
1,0,0,1,1,1,2,5.33,1.5,12,0,4,0.67,0.67,1,3,1,3,2,0
1,0,0,1,1,1,2,5.33,1.5,12,0,4,0.67,0.67,1,3,1,3,2,0
1,0,0,1,1,1,2,5.33,1.5,12,0,4,0.67,0.67,1,3,1,3,2,0
1,0,0,1,1,1,2,5.33,1.5,12,0,4,0.67,0.67,1,3,1,3,2,0
1,0,0,1,1,1,2,5.33,1.5,12,0,4,0.67,0.67,1,3,1,3,2,0
1,0,0,1,1,1,2,5.33,1.5,12,0,4,0.67,0.67,1,3,1,3,2,0
1,0,0,1,1,1,2,5.33,1.5,12,0,4,0.67,0.67,1,3,1,3,2,0
1,1,0,1,1,1,12,55.45,3.54,694.24,0.07,48,0.28,38.57,23,25,13,4,13,0
1,0,0,1,1,1,0,0,0,0,0,1,0,0,0,1,0,1,0,0
1,0,0,1,1,1,2,5.33,1.5,12,0,4,0.67,0.67,1,3,1,3,2,0
1,0,0,1,1,1,2,5.33,1.5,12,0,4,0.67,0.67,1,3,1,3,2,0
1,0,0,1,1,1,2,5.33,1.5,12,0,4,0.67,0.67,1,3,1,3,2,0
1,0,0,1,1,1,2,5.33,1.5,12,0,4,0.67,0.67,1,3,1,3,2,0
1,0,0,1,1,1,2,5.33,1.5,12,0,4,0.67,0.67,1,3,1,3,2,0
1,0,0,1,1,1,2,5.33,1.5,12,0,4,0.67,0.67,1,3,1,3,2,0
1,0,0,1,1,1,2,5.33,1.5,12,0,4,0.67,0.67,1,3,1,3,2,0
1,0,0,1,1,1,2,5.33,1.5,12,0,4,0.67,0.67,1,3,1,3,2,0
1,0,0,1,1,1,2,5.33,1.5,12,0,4,0.67,0.67,1,3,1,3,2,0
1,0,0,1,1,1,2,5.33,1.5,12,0,4,0.67,0.67,1,3,1,3,2,0
1,0,0,1,1,1,2,5.33,1.5,12,0,4,0.67,0.67,1,3,1,3,2,0
1,0,0,1,1,1,2,5.33,1.5,12,0,4,0.67,0.67,1,3,1,3,2,0
1,0,0,1,1,1,2,5.33,1.5,12,0,4,0.67,0.67,1,3,1,3,2,0
1,0,0,1,1,1,2,5.33,1.5,12,0,4,0.67,0.67,1,3,1,3,2,0
1,0,0,1,1,1,2,5.33,1.5,12,0,4,0.67,0.67,1,3,1,3,2,0
1,0,0,1,1,1,2,5.33,1.5,12,0,4,0.67,0.67,1,3,1,3,2,0
1,0,0,1,1,1,2,5.33,1.5,12,0,4,0.67,0.67,1,3,1,3,2,0
1,0,0,1,1,1,2,5.33,1.5,12,0,4,0.67,0.67,1,3,1,3,2,0
1,0,0,1,1,1,2,7.74,1.5,17.41,0,5,0.67,0.97,2,3,2,3,2,0
1,0,0,1,1,1,0,0,0,0,0,0,0,0,0,0,0,0,0,0
1,0,0,1,1,1,0,0,0,0,0,1,0,0,0,1,0,1,0,0
1,0,0,1,1,1,2,5.33,1.5,12,0,4,0.67,0.67,1,3,1,3,2,0
1,0,0,1,1,1,2,5.33,1.5,12,0,4,0.67,0.67,1,3,1,3,2,0
1,0,0,1,1,1,2,5.33,1.5,12,0,4,0.67,0.67,1,3,1,3,2,0
1,0,0,1,1,1,2,5.33,1.5,12,0,4,0.67,0.67,1,3,1,3,2,0
1,0,0,1,1,1,2,5.33,1.5,12,0,4,0.67,0.67,1,3,1,3,2,0
1,0,0,1,1,1,2,5.33,1.5,12,0,4,0.67,0.67,1,3,1,3,2,0
1,0,0,1,1,1,3,11.63,2,46.53,0.01,9,0.5,2.58,4,5,3,3,3,0
1,0,0,1,1,1,2,7.75,2,31.02,0.01,6,0.5,1.72,2,4,2,4,2,0
1,0,0,1,1,1,0,0,0,0,0,1,0,0,0,1,0,1,0,0
1,0,0,1,1,1,0,0,0,0,0,0,0,0,0,0,0,0,0,0
1,0,0,1,1,1,2,5.33,1.5,12,0,4,0.67,0.67,1,3,1,3,2,0
1,0,0,1,1,1,2,5.33,1.5,12,0,4,0.67,0.67,1,3,1,3,2,0
1,0,0,1,1,1,2,5.33,1.5,12,0,4,0.67,0.67,1,3,1,3,2,0
1,0,0,1,1,1,2,5.33,1.5,12,0,4,0.67,0.67,1,3,1,3,2,0
1,0,0,1,1,1,2,5.33,1.5,12,0,4,0.67,0.67,1,3,1,3,2,0
1,0,0,1,1,1,2,5.33,1.5,12,0,4,0.67,0.67,1,3,1,3,2,0
1,0,0,1,1,1,2,5.33,1.5,12,0,4,0.67,0.67,1,3,1,3,2,0
1,0,0,1,1,1,2,5.33,1.5,12,0,4,0.67,0.67,1,3,1,3,2,0
1,0,0,1,1,1,2,5.33,1.5,12,0,4,0.67,0.67,1,3,1,3,2,0
1,0,0,1,1,1,2,5.33,1.5,12,0,4,0.67,0.67,1,3,1,3,2,0
1,0,0,1,1,1,2,5.33,1.5,12,0,4,0.67,0.67,1,3,1,3,2,0
1,0,0,1,1,1,2,5.33,1.5,12,0,4,0.67,0.67,1,3,1,3,2,0
1,0,0,1,1,1,2,5.33,1.5,12,0,4,0.67,0.67,1,3,1,3,2,0
1,0,0,1,1,1,2,5.33,1.5,12,0,4,0.67,0.67,1,3,1,3,2,0
1,0,0,1,1,1,2,5.33,1.5,12,0,4,0.67,0.67,1,3,1,3,2,0
1,0,0,1,1,1,2,5.33,1.5,12,0,4,0.67,0.67,1,3,1,3,2,0
1,0,0,1,1,1,2,5.33,1.5,12,0,4,0.67,0.67,1,3,1,3,2,0
1,0,0,1,1,1,2,7.74,1.5,17.41,0,5,0.67,0.97,2,3,2,3,2,0
1,0,0,1,1,1,2,7.74,1.5,17.41,0,5,0.67,0.97,2,3,2,3,2,0
1,0,0,1,1,1,2,7.74,1.5,17.41,0,5,0.67,0.97,2,3,2,3,2,0
1,0,0,1,1,1,2,5.8,2,23.22,0,5,0.5,1.29,1,4,1,4,2,0
5,0,0,3,2,1,11,15.86,5.83,539.65,0.03,25,0.17,29.98,10,15,6,7,11,0
1,0,0,1,1,1,2,5.33,1.5,12,0,4,0.67,0.67,1,3,1,3,2,0
1,0,0,1,1,1,2,5.33,1.5,12,0,4,0.67,0.67,1,3,1,3,2,0
1,0,0,1,1,1,2,5.33,1.5,12,0,4,0.67,0.67,1,3,1,3,2,0
1,0,0,1,1,1,2,5.33,1.5,12,0,4,0.67,0.67,1,3,1,3,2,0
1,0,0,1,1,1,2,5.33,1.5,12,0,4,0.67,0.67,1,3,1,3,2,0
1,0,0,1,1,1,2,5.33,1.5,12,0,4,0.67,0.67,1,3,1,3,2,0
1,0,0,1,1,1,2,5.33,1.5,12,0,4,0.67,0.67,1,3,1,3,2,0
1,0,0,1,1,1,2,5.33,1.5,12,0,4,0.67,0.67,1,3,1,3,2,0
1,0,0,1,1,1,2,5.33,1.5,12,0,4,0.67,0.67,1,3,1,3,2,0
1,0,0,1,1,1,2,5.33,1.5,12,0,4,0.67,0.67,1,3,1,3,2,0
1,0,0,1,1,1,2,5.33,1.5,12,0,4,0.67,0.67,1,3,1,3,2,0
1,0,0,1,1,1,2,5.33,1.5,12,0,4,0.67,0.67,1,3,1,3,2,0
1,0,0,1,1,1,2,5.33,1.5,12,0,4,0.67,0.67,1,3,1,3,2,0
1,0,0,1,1,1,2,5.33,1.5,12,0,4,0.67,0.67,1,3,1,3,2,0
1,0,0,1,1,1,2,5.33,1.5,12,0,4,0.67,0.67,1,3,1,3,2,0
1,0,0,1,1,1,2,5.33,1.5,12,0,4,0.67,0.67,1,3,1,3,2,0
1,0,0,1,1,1,2,5.33,1.5,12,0,4,0.67,0.67,1,3,1,3,2,0
1,0,0,1,1,1,2,5.33,1.5,12,0,4,0.67,0.67,1,3,1,3,2,0
1,0,0,1,1,1,2,5.33,1.5,12,0,4,0.67,0.67,1,3,1,3,2,0
1,0,0,1,1,1,2,5.33,1.5,12,0,4,0.67,0.67,1,3,1,3,2,0
1,0,0,1,1,1,2,5.33,1.5,12,0,4,0.67,0.67,1,3,1,3,2,0
1,0,0,1,1,1,2,5.33,1.5,12,0,4,0.67,0.67,1,3,1,3,2,0
1,0,0,1,1,1,2,5.33,1.5,12,0,4,0.67,0.67,1,3,1,3,2,0
1,0,0,1,1,1,2,5.33,1.5,12,0,4,0.67,0.67,1,3,1,3,2,0
1,0,0,1,1,1,2,5.33,1.5,12,0,4,0.67,0.67,1,3,1,3,2,0
1,0,0,1,1,1,2,5.33,1.5,12,0,4,0.67,0.67,1,3,1,3,2,0
1,0,0,1,1,1,2,5.33,1.5,12,0,4,0.67,0.67,1,3,1,3,2,0
1,0,0,1,1,1,2,5.33,1.5,12,0,4,0.67,0.67,1,3,1,3,2,0
1,0,0,1,1,1,2,5.33,1.5,12,0,4,0.67,0.67,1,3,1,3,2,0
1,0,0,1,1,1,2,5.33,1.5,12,0,4,0.67,0.67,1,3,1,3,2,0
1,0,0,1,1,1,2,5.33,1.5,12,0,4,0.67,0.67,1,3,1,3,2,0
1,0,0,1,1,1,2,5.33,1.5,12,0,4,0.67,0.67,1,3,1,3,2,0
1,0,0,1,1,1,2,5.33,1.5,12,0,4,0.67,0.67,1,3,1,3,2,0
1,0,0,1,1,1,2,5.33,1.5,12,0,4,0.67,0.67,1,3,1,3,2,0
1,0,0,1,1,1,2,5.33,1.5,12,0,4,0.67,0.67,1,3,1,3,2,0
1,0,0,1,1,1,2,5.33,1.5,12,0,4,0.67,0.67,1,3,1,3,2,0
1,0,0,1,1,1,2,5.33,1.5,12,0,4,0.67,0.67,1,3,1,3,2,0
1,0,0,1,1,1,2,5.33,1.5,12,0,4,0.67,0.67,1,3,1,3,2,0
1,0,0,1,1,1,2,5.33,1.5,12,0,4,0.67,0.67,1,3,1,3,2,0
1,0,0,1,1,1,2,5.33,1.5,12,0,4,0.67,0.67,1,3,1,3,2,0
1,0,0,1,1,1,2,5.33,1.5,12,0,4,0.67,0.67,1,3,1,3,2,0
1,0,0,1,1,1,2,5.33,1.5,12,0,4,0.67,0.67,1,3,1,3,2,0
1,0,0,1,1,1,2,5.33,1.5,12,0,4,0.67,0.67,1,3,1,3,2,0
9,0,5,5,1,1,27,46.15,8.42,3272.75,0.13,80,0.12,181.82,32,48,19,10,27,0
1,1,1,1,1,1,6,16.39,3.5,200.76,0.02,16,0.29,11.15,5,11,5,7,7,0
71,1,1,36,35,1,182,197.06,18.09,64516.1,1.19,564,0.06,3584.23,227,337,69,11,183,0
1,0,2,1,1,1,39,175.2,4.49,3527.63,0.26,144,0.22,195.98,70,74,39,5,39,0
1,0,0,1,1,1,2,7.74,1.5,17.41,0,5,0.67,0.97,2,3,2,3,2,0
1,0,0,1,1,1,2,7.74,1.5,17.41,0,5,0.67,0.97,2,3,2,3,2,0
1,0,0,1,1,1,2,7.74,1.5,17.41,0,5,0.67,0.97,2,3,2,3,2,0
1,0,0,1,1,1,2,7.74,1.5,17.41,0,5,0.67,0.97,2,3,2,3,2,0
1,0,0,1,1,1,2,7.74,1.5,17.41,0,5,0.67,0.97,2,3,2,3,2,0
1,0,0,1,1,1,2,7.74,1.5,17.41,0,5,0.67,0.97,2,3,2,3,2,0
1,0,0,1,1,1,2,7.74,1.5,17.41,0,5,0.67,0.97,2,3,2,3,2,0
1,0,0,1,1,1,2,7.74,1.5,17.41,0,5,0.67,0.97,2,3,2,3,2,0
1,0,0,1,1,1,2,7.74,1.5,17.41,0,5,0.67,0.97,2,3,2,3,2,0
1,0,0,1,1,1,2,7.74,1.5,17.41,0,5,0.67,0.97,2,3,2,3,2,0
1,0,0,1,1,1,2,7.74,1.5,17.41,0,5,0.67,0.97,2,3,2,3,2,0
1,0,0,1,1,1,2,7.74,1.5,17.41,0,5,0.67,0.97,2,3,2,3,2,0
1,0,0,1,1,1,2,7.74,1.5,17.41,0,5,0.67,0.97,2,3,2,3,2,0
1,0,0,1,1,1,2,7.74,1.5,17.41,0,5,0.67,0.97,2,3,2,3,2,0
1,0,0,1,1,1,2,7.74,1.5,17.41,0,5,0.67,0.97,2,3,2,3,2,0
1,0,0,1,1,1,2,7.74,1.5,17.41,0,5,0.67,0.97,2,3,2,3,2,0
1,0,0,1,1,1,2,7.74,1.5,17.41,0,5,0.67,0.97,2,3,2,3,2,0
1,0,0,1,1,1,2,7.74,1.5,17.41,0,5,0.67,0.97,2,3,2,3,2,0
1,0,0,1,1,1,2,7.74,1.5,17.41,0,5,0.67,0.97,2,3,2,3,2,0
1,0,0,1,1,1,2,7.74,1.5,17.41,0,5,0.67,0.97,2,3,2,3,2,0
1,0,0,1,1,1,2,7.74,1.5,17.41,0,5,0.67,0.97,2,3,2,3,2,0
1,0,0,1,1,1,2,7.74,1.5,17.41,0,5,0.67,0.97,2,3,2,3,2,0
1,0,0,1,1,1,2,7.74,1.5,17.41,0,5,0.67,0.97,2,3,2,3,2,0
1,0,0,1,1,1,2,7.74,1.5,17.41,0,5,0.67,0.97,2,3,2,3,2,0
1,0,0,1,1,1,2,7.74,1.5,17.41,0,5,0.67,0.97,2,3,2,3,2,0
1,0,0,1,1,1,2,7.74,1.5,17.41,0,5,0.67,0.97,2,3,2,3,2,0
1,0,0,1,1,1,0,0,0,0,0,1,0,0,0,1,0,1,0,0
1,0,0,1,1,1,2,5.33,1.5,12,0,4,0.67,0.67,1,3,1,3,2,0
1,0,0,1,1,1,2,5.33,1.5,12,0,4,0.67,0.67,1,3,1,3,2,0
1,0,0,1,1,1,2,5.33,1.5,12,0,4,0.67,0.67,1,3,1,3,2,0
1,0,0,1,1,1,0,0,0,0,0,1,0,0,0,1,0,1,0,0
1,0,0,1,1,1,2,5.33,1.5,12,0,4,0.67,0.67,1,3,1,3,2,0
1,0,0,1,1,1,2,5.33,1.5,12,0,4,0.67,0.67,1,3,1,3,2,0
1,0,0,1,1,1,2,5.33,1.5,12,0,4,0.67,0.67,1,3,1,3,2,0
1,0,0,1,1,1,2,5.33,1.5,12,0,4,0.67,0.67,1,3,1,3,2,0
1,0,0,1,1,1,2,5.33,1.5,12,0,4,0.67,0.67,1,3,1,3,2,0
1,0,0,1,1,1,2,5.33,1.5,12,0,4,0.67,0.67,1,3,1,3,2,0
1,0,0,1,1,1,2,7.74,1.5,17.41,0,5,0.67,0.97,2,3,2,3,2,0
1,0,0,1,1,1,2,7.74,1.5,17.41,0,5,0.67,0.97,2,3,2,3,2,0
1,0,0,1,1,1,2,7.74,1.5,17.41,0,5,0.67,0.97,2,3,2,3,2,0
1,0,0,1,1,1,2,7.74,1.5,17.41,0,5,0.67,0.97,2,3,2,3,2,0
1,0,0,1,1,1,0,0,0,0,0,1,0,0,0,1,0,1,0,0
1,0,0,1,1,1,0,0,0,0,0,1,0,0,0,1,0,1,0,0
9,3,0,5,5,4,4,6.95,27.62,5307.06,0.06,47,0.04,294.84,17,30,4,13,7,0
1,0,0,1,1,1,2,13.18,5.25,363.24,0.02,20,0.19,20.18,6,14,4,7,2,0
1,0,0,1,1,1,2,5.33,1.5,12,0,4,0.67,0.67,1,3,1,3,2,0
1,0,0,1,1,1,2,5.33,1.5,12,0,4,0.67,0.67,1,3,1,3,2,0
1,0,0,1,1,1,2,5.33,1.5,12,0,4,0.67,0.67,1,3,1,3,2,0
1,0,0,1,1,1,4,27.47,1.5,61.81,0.01,13,0.67,3.43,6,7,6,3,4,0
1,0,0,1,1,1,2,11.3,6.13,423.78,0.02,20,0.16,23.54,7,13,4,7,2,0
1,0,0,1,1,1,0,0,0,0,0,1,0,0,0,1,0,1,0,0
1,0,0,1,1,1,2,5.33,1.5,12,0,4,0.67,0.67,1,3,1,3,2,0
1,0,0,1,1,1,2,5.33,1.5,12,0,4,0.67,0.67,1,3,1,3,2,0
1,0,0,1,1,1,2,5.33,1.5,12,0,4,0.67,0.67,1,3,1,3,2,0
1,0,0,1,1,1,2,5.33,1.5,12,0,4,0.67,0.67,1,3,1,3,2,0
1,0,0,1,1,1,2,5.33,1.5,12,0,4,0.67,0.67,1,3,1,3,2,0
1,0,0,1,1,1,2,5.33,1.5,12,0,4,0.67,0.67,1,3,1,3,2,0
1,0,0,1,1,1,2,5.33,1.5,12,0,4,0.67,0.67,1,3,1,3,2,0
1,0,0,1,1,1,2,5.33,1.5,12,0,4,0.67,0.67,1,3,1,3,2,0
1,0,0,1,1,1,2,5.33,1.5,12,0,4,0.67,0.67,1,3,1,3,2,0
1,0,0,1,1,1,2,5.33,1.5,12,0,4,0.67,0.67,1,3,1,3,2,0
1,0,0,1,1,1,2,5.33,1.5,12,0,4,0.67,0.67,1,3,1,3,2,0
1,0,0,1,1,1,2,5.33,1.5,12,0,4,0.67,0.67,1,3,1,3,2,0
1,0,0,1,1,1,2,5.33,1.5,12,0,4,0.67,0.67,1,3,1,3,2,0
1,1,0,1,1,1,12,55.45,3.54,694.24,0.07,48,0.28,38.57,23,25,13,4,13,0
1,0,0,1,1,1,0,0,0,0,0,1,0,0,0,1,0,1,0,0
1,0,0,1,1,1,2,5.33,1.5,12,0,4,0.67,0.67,1,3,1,3,2,0
1,0,0,1,1,1,2,5.33,1.5,12,0,4,0.67,0.67,1,3,1,3,2,0
1,0,0,1,1,1,2,5.33,1.5,12,0,4,0.67,0.67,1,3,1,3,2,0
1,0,0,1,1,1,2,5.33,1.5,12,0,4,0.67,0.67,1,3,1,3,2,0
1,0,0,1,1,1,2,5.33,1.5,12,0,4,0.67,0.67,1,3,1,3,2,0
1,0,0,1,1,1,2,5.33,1.5,12,0,4,0.67,0.67,1,3,1,3,2,0
1,0,0,1,1,1,2,5.33,1.5,12,0,4,0.67,0.67,1,3,1,3,2,0
1,0,0,1,1,1,2,5.33,1.5,12,0,4,0.67,0.67,1,3,1,3,2,0
1,0,0,1,1,1,2,5.33,1.5,12,0,4,0.67,0.67,1,3,1,3,2,0
1,0,0,1,1,1,2,5.33,1.5,12,0,4,0.67,0.67,1,3,1,3,2,0
1,0,0,1,1,1,2,5.33,1.5,12,0,4,0.67,0.67,1,3,1,3,2,0
1,0,0,1,1,1,2,5.33,1.5,12,0,4,0.67,0.67,1,3,1,3,2,0
1,0,0,1,1,1,2,5.33,1.5,12,0,4,0.67,0.67,1,3,1,3,2,0
1,0,0,1,1,1,2,5.33,1.5,12,0,4,0.67,0.67,1,3,1,3,2,0
1,0,0,1,1,1,2,5.33,1.5,12,0,4,0.67,0.67,1,3,1,3,2,0
1,0,0,1,1,1,2,5.33,1.5,12,0,4,0.67,0.67,1,3,1,3,2,0
1,0,0,1,1,1,2,5.33,1.5,12,0,4,0.67,0.67,1,3,1,3,2,0
1,0,0,1,1,1,2,5.33,1.5,12,0,4,0.67,0.67,1,3,1,3,2,0
1,0,0,1,1,1,2,7.74,1.5,17.41,0,5,0.67,0.97,2,3,2,3,2,0
1,0,0,1,1,1,0,0,0,0,0,0,0,0,0,0,0,0,0,0
1,0,0,1,1,1,0,0,0,0,0,1,0,0,0,1,0,1,0,0
1,0,0,1,1,1,2,5.33,1.5,12,0,4,0.67,0.67,1,3,1,3,2,0
1,0,0,1,1,1,2,5.33,1.5,12,0,4,0.67,0.67,1,3,1,3,2,0
1,0,0,1,1,1,2,5.33,1.5,12,0,4,0.67,0.67,1,3,1,3,2,0
1,0,0,1,1,1,2,5.33,1.5,12,0,4,0.67,0.67,1,3,1,3,2,0
1,0,0,1,1,1,2,5.33,1.5,12,0,4,0.67,0.67,1,3,1,3,2,0
1,0,0,1,1,1,2,5.33,1.5,12,0,4,0.67,0.67,1,3,1,3,2,0
1,0,0,1,1,1,3,11.63,2,46.53,0.01,9,0.5,2.58,4,5,3,3,3,0
1,0,0,1,1,1,2,7.75,2,31.02,0.01,6,0.5,1.72,2,4,2,4,2,0
1,0,0,1,1,1,0,0,0,0,0,1,0,0,0,1,0,1,0,0
1,0,0,1,1,1,0,0,0,0,0,0,0,0,0,0,0,0,0,0
1,0,0,1,1,1,2,5.33,1.5,12,0,4,0.67,0.67,1,3,1,3,2,0
1,0,0,1,1,1,2,5.33,1.5,12,0,4,0.67,0.67,1,3,1,3,2,0
1,0,0,1,1,1,2,5.33,1.5,12,0,4,0.67,0.67,1,3,1,3,2,0
1,0,0,1,1,1,2,5.33,1.5,12,0,4,0.67,0.67,1,3,1,3,2,0
1,0,0,1,1,1,2,5.33,1.5,12,0,4,0.67,0.67,1,3,1,3,2,0
1,0,0,1,1,1,2,5.33,1.5,12,0,4,0.67,0.67,1,3,1,3,2,0
1,0,0,1,1,1,2,5.33,1.5,12,0,4,0.67,0.67,1,3,1,3,2,0
1,0,0,1,1,1,2,5.33,1.5,12,0,4,0.67,0.67,1,3,1,3,2,0
1,0,0,1,1,1,2,5.33,1.5,12,0,4,0.67,0.67,1,3,1,3,2,0
1,0,0,1,1,1,2,5.33,1.5,12,0,4,0.67,0.67,1,3,1,3,2,0
1,0,0,1,1,1,2,5.33,1.5,12,0,4,0.67,0.67,1,3,1,3,2,0
1,0,0,1,1,1,2,5.33,1.5,12,0,4,0.67,0.67,1,3,1,3,2,0
1,0,0,1,1,1,2,5.33,1.5,12,0,4,0.67,0.67,1,3,1,3,2,0
1,0,0,1,1,1,2,5.33,1.5,12,0,4,0.67,0.67,1,3,1,3,2,0
1,0,0,1,1,1,2,5.33,1.5,12,0,4,0.67,0.67,1,3,1,3,2,0
1,0,0,1,1,1,2,5.33,1.5,12,0,4,0.67,0.67,1,3,1,3,2,0
1,0,0,1,1,1,2,5.33,1.5,12,0,4,0.67,0.67,1,3,1,3,2,0
1,0,0,1,1,1,2,7.74,1.5,17.41,0,5,0.67,0.97,2,3,2,3,2,0
1,0,0,1,1,1,2,7.74,1.5,17.41,0,5,0.67,0.97,2,3,2,3,2,0
1,0,0,1,1,1,2,7.74,1.5,17.41,0,5,0.67,0.97,2,3,2,3,2,0
1,0,0,1,1,1,2,5.33,1.5,12,0,4,0.67,0.67,1,3,1,3,2,0
1,0,0,1,1,1,2,5.33,1.5,12,0,4,0.67,0.67,1,3,1,3,2,0
1,0,0,1,1,1,2,5.33,1.5,12,0,4,0.67,0.67,1,3,1,3,2,0
1,0,0,1,1,1,2,5.33,1.5,12,0,4,0.67,0.67,1,3,1,3,2,0
1,0,0,1,1,1,2,5.33,1.5,12,0,4,0.67,0.67,1,3,1,3,2,0
1,0,0,1,1,1,2,5.33,1.5,12,0,4,0.67,0.67,1,3,1,3,2,0
1,0,0,1,1,1,2,5.33,1.5,12,0,4,0.67,0.67,1,3,1,3,2,0
1,0,0,1,1,1,2,5.33,1.5,12,0,4,0.67,0.67,1,3,1,3,2,0
1,0,0,1,1,1,2,5.33,1.5,12,0,4,0.67,0.67,1,3,1,3,2,0
1,0,0,1,1,1,2,5.33,1.5,12,0,4,0.67,0.67,1,3,1,3,2,0
1,0,0,1,1,1,2,5.33,1.5,12,0,4,0.67,0.67,1,3,1,3,2,0
1,0,0,1,1,1,2,5.33,1.5,12,0,4,0.67,0.67,1,3,1,3,2,0
1,0,0,1,1,1,2,5.33,1.5,12,0,4,0.67,0.67,1,3,1,3,2,0
1,0,0,1,1,1,2,5.33,1.5,12,0,4,0.67,0.67,1,3,1,3,2,0
1,0,0,1,1,1,2,5.33,1.5,12,0,4,0.67,0.67,1,3,1,3,2,0
1,0,0,1,1,1,2,5.33,1.5,12,0,4,0.67,0.67,1,3,1,3,2,0
1,0,0,1,1,1,2,5.33,1.5,12,0,4,0.67,0.67,1,3,1,3,2,0
1,0,0,1,1,1,2,5.33,1.5,12,0,4,0.67,0.67,1,3,1,3,2,0
1,0,0,1,1,1,2,5.33,1.5,12,0,4,0.67,0.67,1,3,1,3,2,0
1,0,0,1,1,1,2,5.33,1.5,12,0,4,0.67,0.67,1,3,1,3,2,0
1,0,0,1,1,1,2,5.33,1.5,12,0,4,0.67,0.67,1,3,1,3,2,0
1,0,0,1,1,1,2,5.33,1.5,12,0,4,0.67,0.67,1,3,1,3,2,0
1,0,0,1,1,1,2,5.33,1.5,12,0,4,0.67,0.67,1,3,1,3,2,0
1,0,0,1,1,1,2,5.33,1.5,12,0,4,0.67,0.67,1,3,1,3,2,0
1,0,0,1,1,1,2,5.33,1.5,12,0,4,0.67,0.67,1,3,1,3,2,0
1,0,0,1,1,1,2,5.33,1.5,12,0,4,0.67,0.67,1,3,1,3,2,0
1,0,0,1,1,1,2,5.33,1.5,12,0,4,0.67,0.67,1,3,1,3,2,0
1,0,0,1,1,1,2,5.33,1.5,12,0,4,0.67,0.67,1,3,1,3,2,0
1,0,0,1,1,1,2,5.33,1.5,12,0,4,0.67,0.67,1,3,1,3,2,0
1,0,0,1,1,1,2,5.33,1.5,12,0,4,0.67,0.67,1,3,1,3,2,0
1,0,0,1,1,1,2,5.33,1.5,12,0,4,0.67,0.67,1,3,1,3,2,0
1,0,0,1,1,1,2,5.33,1.5,12,0,4,0.67,0.67,1,3,1,3,2,0
1,0,0,1,1,1,2,5.33,1.5,12,0,4,0.67,0.67,1,3,1,3,2,0
1,0,0,1,1,1,2,5.33,1.5,12,0,4,0.67,0.67,1,3,1,3,2,0
1,0,0,1,1,1,2,5.33,1.5,12,0,4,0.67,0.67,1,3,1,3,2,0
1,0,0,1,1,1,2,5.33,1.5,12,0,4,0.67,0.67,1,3,1,3,2,0
1,0,0,1,1,1,2,5.33,1.5,12,0,4,0.67,0.67,1,3,1,3,2,0
1,0,0,1,1,1,2,5.33,1.5,12,0,4,0.67,0.67,1,3,1,3,2,0
1,0,0,1,1,1,2,5.33,1.5,12,0,4,0.67,0.67,1,3,1,3,2,0
1,0,0,1,1,1,2,5.33,1.5,12,0,4,0.67,0.67,1,3,1,3,2,0
1,0,0,1,1,1,2,5.33,1.5,12,0,4,0.67,0.67,1,3,1,3,2,0
1,0,0,1,1,1,2,5.33,1.5,12,0,4,0.67,0.67,1,3,1,3,2,0
1,0,0,1,1,1,2,5.33,1.5,12,0,4,0.67,0.67,1,3,1,3,2,0
1,0,0,1,1,1,2,7.74,1.5,17.41,0,5,0.67,0.97,2,3,2,3,2,0
1,0,0,1,1,1,2,7.74,1.5,17.41,0,5,0.67,0.97,2,3,2,3,2,0
1,0,0,1,1,1,2,7.74,1.5,17.41,0,5,0.67,0.97,2,3,2,3,2,0
1,0,0,1,1,1,2,7.74,1.5,17.41,0,5,0.67,0.97,2,3,2,3,2,0
1,0,0,1,1,1,2,7.74,1.5,17.41,0,5,0.67,0.97,2,3,2,3,2,0
1,0,0,1,1,1,2,7.74,1.5,17.41,0,5,0.67,0.97,2,3,2,3,2,0
1,0,0,1,1,1,2,7.74,1.5,17.41,0,5,0.67,0.97,2,3,2,3,2,0
1,0,0,1,1,1,2,7.74,1.5,17.41,0,5,0.67,0.97,2,3,2,3,2,0
1,0,0,1,1,1,2,7.74,1.5,17.41,0,5,0.67,0.97,2,3,2,3,2,0
1,0,0,1,1,1,2,7.74,1.5,17.41,0,5,0.67,0.97,2,3,2,3,2,0
1,0,0,1,1,1,2,7.74,1.5,17.41,0,5,0.67,0.97,2,3,2,3,2,0
1,0,0,1,1,1,2,7.74,1.5,17.41,0,5,0.67,0.97,2,3,2,3,2,0
1,0,0,1,1,1,2,7.74,1.5,17.41,0,5,0.67,0.97,2,3,2,3,2,0
1,0,0,1,1,1,2,7.74,1.5,17.41,0,5,0.67,0.97,2,3,2,3,2,0
1,0,0,1,1,1,2,7.74,1.5,17.41,0,5,0.67,0.97,2,3,2,3,2,0
1,0,0,1,1,1,2,7.74,1.5,17.41,0,5,0.67,0.97,2,3,2,3,2,0
1,0,0,1,1,1,2,7.74,1.5,17.41,0,5,0.67,0.97,2,3,2,3,2,0
1,0,0,1,1,1,2,7.74,1.5,17.41,0,5,0.67,0.97,2,3,2,3,2,0
1,0,0,1,1,1,2,7.74,1.5,17.41,0,5,0.67,0.97,2,3,2,3,2,0
1,0,0,1,1,1,2,7.74,1.5,17.41,0,5,0.67,0.97,2,3,2,3,2,0
1,0,0,1,1,1,2,7.74,1.5,17.41,0,5,0.67,0.97,2,3,2,3,2,0
1,0,0,1,1,1,2,7.74,1.5,17.41,0,5,0.67,0.97,2,3,2,3,2,0
1,0,0,1,1,1,2,7.74,1.5,17.41,0,5,0.67,0.97,2,3,2,3,2,0
1,0,0,1,1,1,2,7.74,1.5,17.41,0,5,0.67,0.97,2,3,2,3,2,0
1,0,0,1,1,1,2,7.74,1.5,17.41,0,5,0.67,0.97,2,3,2,3,2,0
1,0,0,1,1,1,2,7.74,1.5,17.41,0,5,0.67,0.97,2,3,2,3,2,0
3,0,0,2,2,1,6,7.97,5.83,271.29,0.02,14,0.17,15.07,5,9,3,7,6,0
3,0,0,2,2,1,6,5.89,7,288.46,0.01,13,0.14,16.03,4,9,2,7,6,0
1,0,0,1,1,1,8,12.27,9.75,1166,0.04,36,0.1,64.78,13,23,4,6,8,0
5,0,9,3,3,1,34,31.54,37.5,44359.51,0.39,258,0.03,2464.42,75,183,12,12,34,1
5,1,6,3,2,3,12,20.25,9.55,1844.77,0.06,44,0.1,102.49,21,23,11,10,13,0
11,1,2,6,2,3,25,20.91,14.5,4397,0.1,68,0.07,244.28,29,39,11,11,26,0
1,0,2,1,1,1,11,24.21,6.07,892.4,0.05,41,0.16,49.58,17,24,7,5,11,0
1,0,0,1,1,1,2,7.75,2,31.02,0.01,6,0.5,1.72,2,4,2,4,2,0
1,0,0,1,1,1,0,0,0,0,0,1,0,0,0,1,0,1,0,0
1,0,0,1,1,1,2,5.33,1.5,12,0,4,0.67,0.67,1,3,1,3,2,0
1,0,0,1,1,1,2,5.33,1.5,12,0,4,0.67,0.67,1,3,1,3,2,0
1,0,0,1,1,1,2,5.33,1.5,12,0,4,0.67,0.67,1,3,1,3,2,0
1,0,0,1,1,1,0,0,0,0,0,1,0,0,0,1,0,1,0,0
1,0,0,1,1,1,2,5.33,1.5,12,0,4,0.67,0.67,1,3,1,3,2,0
1,0,0,1,1,1,2,5.33,1.5,12,0,4,0.67,0.67,1,3,1,3,2,0
1,0,0,1,1,1,2,5.33,1.5,12,0,4,0.67,0.67,1,3,1,3,2,0
1,0,0,1,1,1,2,5.33,1.5,12,0,4,0.67,0.67,1,3,1,3,2,0
1,0,0,1,1,1,2,5.33,1.5,12,0,4,0.67,0.67,1,3,1,3,2,0
1,0,0,1,1,1,2,5.33,1.5,12,0,4,0.67,0.67,1,3,1,3,2,0
1,0,0,1,1,1,2,7.74,1.5,17.41,0,5,0.67,0.97,2,3,2,3,2,0
1,0,0,1,1,1,2,7.74,1.5,17.41,0,5,0.67,0.97,2,3,2,3,2,0
1,0,0,1,1,1,2,7.74,1.5,17.41,0,5,0.67,0.97,2,3,2,3,2,0
1,0,0,1,1,1,2,7.74,1.5,17.41,0,5,0.67,0.97,2,3,2,3,2,0
1,0,0,1,1,1,2,7.74,1.5,17.41,0,5,0.67,0.97,2,3,2,3,2,0
1,0,0,1,1,1,0,0,0,0,0,0,0,0,0,0,0,0,0,0
1,0,0,1,1,1,0,0,0,0,0,1,0,0,0,1,0,1,0,0
1,0,0,1,1,1,2,5.33,1.5,12,0,4,0.67,0.67,1,3,1,3,2,0
1,0,0,1,1,1,2,5.33,1.5,12,0,4,0.67,0.67,1,3,1,3,2,0
1,0,0,1,1,1,2,5.33,1.5,12,0,4,0.67,0.67,1,3,1,3,2,0
1,0,1,1,1,1,4,14.4,2.5,90,0.01,12,0.4,5,5,7,4,4,4,0
21,1,2,11,2,1,60,55.33,16.46,14987.88,0.3,179,0.06,832.66,79,100,24,10,61,0
1,0,0,1,1,1,13,6.92,2.75,52.3,0.01,12,0.36,2.91,11,1,2,1,13,0
1,0,0,1,1,1,0,0,0,0,0,1,0,0,0,1,0,1,0,0
1,0,0,1,1,1,0,0,0,0,0,1,0,0,0,1,0,1,0,0
1,0,0,1,1,1,0,0,0,0,0,1,0,0,0,1,0,1,0,0
9,3,0,5,5,4,4,6.95,27.62,5307.06,0.06,47,0.04,294.84,17,30,4,13,7,0
1,0,0,1,1,1,2,5.8,2,23.22,0,5,0.5,1.29,1,4,1,4,2,0
1,0,0,1,1,1,2,13.18,5.25,363.24,0.02,20,0.19,20.18,6,14,4,7,2,0
1,0,0,1,1,1,2,5.33,1.5,12,0,4,0.67,0.67,1,3,1,3,2,0
1,0,0,1,1,1,2,5.33,1.5,12,0,4,0.67,0.67,1,3,1,3,2,0
1,0,0,1,1,1,2,5.33,1.5,12,0,4,0.67,0.67,1,3,1,3,2,0
1,0,0,1,1,1,2,5.33,1.5,12,0,4,0.67,0.67,1,3,1,3,2,0
1,0,0,1,1,1,4,27.47,1.5,61.81,0.01,13,0.67,3.43,6,7,6,3,4,0
1,0,0,1,1,1,2,11.3,6.13,423.78,0.02,20,0.16,23.54,7,13,4,7,2,0
1,0,0,1,1,1,0,0,0,0,0,1,0,0,0,1,0,1,0,0
1,0,0,1,1,1,2,5.33,1.5,12,0,4,0.67,0.67,1,3,1,3,2,0
1,0,0,1,1,1,2,5.33,1.5,12,0,4,0.67,0.67,1,3,1,3,2,0
1,0,0,1,1,1,2,5.33,1.5,12,0,4,0.67,0.67,1,3,1,3,2,0
1,0,0,1,1,1,2,5.33,1.5,12,0,4,0.67,0.67,1,3,1,3,2,0
1,0,0,1,1,1,2,5.33,1.5,12,0,4,0.67,0.67,1,3,1,3,2,0
1,0,0,1,1,1,2,5.33,1.5,12,0,4,0.67,0.67,1,3,1,3,2,0
1,0,0,1,1,1,2,5.33,1.5,12,0,4,0.67,0.67,1,3,1,3,2,0
1,0,0,1,1,1,2,5.33,1.5,12,0,4,0.67,0.67,1,3,1,3,2,0
1,0,0,1,1,1,2,5.33,1.5,12,0,4,0.67,0.67,1,3,1,3,2,0
1,0,0,1,1,1,2,5.33,1.5,12,0,4,0.67,0.67,1,3,1,3,2,0
1,0,0,1,1,1,2,5.33,1.5,12,0,4,0.67,0.67,1,3,1,3,2,0
1,0,0,1,1,1,2,5.33,1.5,12,0,4,0.67,0.67,1,3,1,3,2,0
1,0,0,1,1,1,2,5.33,1.5,12,0,4,0.67,0.67,1,3,1,3,2,0
1,1,0,1,1,1,12,55.45,3.54,694.24,0.07,48,0.28,38.57,23,25,13,4,13,0
1,0,0,1,1,1,0,0,0,0,0,1,0,0,0,1,0,1,0,0
1,0,0,1,1,1,2,5.33,1.5,12,0,4,0.67,0.67,1,3,1,3,2,0
1,0,0,1,1,1,2,5.33,1.5,12,0,4,0.67,0.67,1,3,1,3,2,0
1,0,0,1,1,1,2,5.33,1.5,12,0,4,0.67,0.67,1,3,1,3,2,0
1,0,0,1,1,1,2,5.33,1.5,12,0,4,0.67,0.67,1,3,1,3,2,0
1,0,0,1,1,1,2,5.33,1.5,12,0,4,0.67,0.67,1,3,1,3,2,0
1,0,0,1,1,1,2,5.33,1.5,12,0,4,0.67,0.67,1,3,1,3,2,0
1,0,0,1,1,1,2,5.33,1.5,12,0,4,0.67,0.67,1,3,1,3,2,0
1,0,0,1,1,1,2,5.33,1.5,12,0,4,0.67,0.67,1,3,1,3,2,0
1,0,0,1,1,1,2,5.33,1.5,12,0,4,0.67,0.67,1,3,1,3,2,0
1,0,0,1,1,1,2,5.33,1.5,12,0,4,0.67,0.67,1,3,1,3,2,0
1,0,0,1,1,1,2,5.33,1.5,12,0,4,0.67,0.67,1,3,1,3,2,0
1,0,0,1,1,1,2,5.33,1.5,12,0,4,0.67,0.67,1,3,1,3,2,0
1,0,0,1,1,1,2,5.33,1.5,12,0,4,0.67,0.67,1,3,1,3,2,0
1,0,0,1,1,1,2,5.33,1.5,12,0,4,0.67,0.67,1,3,1,3,2,0
1,0,0,1,1,1,2,5.33,1.5,12,0,4,0.67,0.67,1,3,1,3,2,0
1,0,0,1,1,1,2,5.33,1.5,12,0,4,0.67,0.67,1,3,1,3,2,0
1,0,0,1,1,1,2,5.33,1.5,12,0,4,0.67,0.67,1,3,1,3,2,0
1,0,0,1,1,1,2,5.33,1.5,12,0,4,0.67,0.67,1,3,1,3,2,0
1,0,0,1,1,1,0,0,0,0,0,1,0,0,0,1,0,1,0,0
1,0,0,1,1,1,2,5.33,1.5,12,0,4,0.67,0.67,1,3,1,3,2,0
1,0,0,1,1,1,2,5.33,1.5,12,0,4,0.67,0.67,1,3,1,3,2,0
1,0,0,1,1,1,2,5.33,1.5,12,0,4,0.67,0.67,1,3,1,3,2,0
1,0,0,1,1,1,2,5.33,1.5,12,0,4,0.67,0.67,1,3,1,3,2,0
1,0,0,1,1,1,2,5.33,1.5,12,0,4,0.67,0.67,1,3,1,3,2,0
1,0,0,1,1,1,2,5.33,1.5,12,0,4,0.67,0.67,1,3,1,3,2,0
1,0,0,1,1,1,3,11.63,2,46.53,0.01,9,0.5,2.58,4,5,3,3,3,0
1,0,0,1,1,1,2,7.75,2,31.02,0.01,6,0.5,1.72,2,4,2,4,2,0
1,0,0,1,1,1,2,5.33,1.5,12,0,4,0.67,0.67,1,3,1,3,2,0
1,0,0,1,1,1,2,5.33,1.5,12,0,4,0.67,0.67,1,3,1,3,2,0
1,0,0,1,1,1,2,5.33,1.5,12,0,4,0.67,0.67,1,3,1,3,2,0
1,0,0,1,1,1,2,5.33,1.5,12,0,4,0.67,0.67,1,3,1,3,2,0
1,0,0,1,1,1,2,5.33,1.5,12,0,4,0.67,0.67,1,3,1,3,2,0
1,0,0,1,1,1,2,5.33,1.5,12,0,4,0.67,0.67,1,3,1,3,2,0
1,0,0,1,1,1,2,5.33,1.5,12,0,4,0.67,0.67,1,3,1,3,2,0
1,0,0,1,1,1,2,5.33,1.5,12,0,4,0.67,0.67,1,3,1,3,2,0
1,0,0,1,1,1,2,5.33,1.5,12,0,4,0.67,0.67,1,3,1,3,2,0
1,0,0,1,1,1,2,5.33,1.5,12,0,4,0.67,0.67,1,3,1,3,2,0
1,0,0,1,1,1,2,5.33,1.5,12,0,4,0.67,0.67,1,3,1,3,2,0
1,0,0,1,1,1,2,5.33,1.5,12,0,4,0.67,0.67,1,3,1,3,2,0
1,0,0,1,1,1,2,5.33,1.5,12,0,4,0.67,0.67,1,3,1,3,2,0
1,0,0,1,1,1,2,5.33,1.5,12,0,4,0.67,0.67,1,3,1,3,2,0
1,0,0,1,1,1,2,5.33,1.5,12,0,4,0.67,0.67,1,3,1,3,2,0
1,0,0,1,1,1,2,5.33,1.5,12,0,4,0.67,0.67,1,3,1,3,2,0
1,0,0,1,1,1,2,5.33,1.5,12,0,4,0.67,0.67,1,3,1,3,2,0
1,0,0,1,1,1,2,5.33,1.5,12,0,4,0.67,0.67,1,3,1,3,2,0
1,0,0,1,1,1,2,5.33,1.5,12,0,4,0.67,0.67,1,3,1,3,2,0
1,0,0,1,1,1,2,5.33,1.5,12,0,4,0.67,0.67,1,3,1,3,2,0
1,0,0,1,1,1,2,5.33,1.5,12,0,4,0.67,0.67,1,3,1,3,2,0
1,0,0,1,1,1,2,5.33,1.5,12,0,4,0.67,0.67,1,3,1,3,2,0
1,0,0,1,1,1,2,5.33,1.5,12,0,4,0.67,0.67,1,3,1,3,2,0
1,0,0,1,1,1,2,5.33,1.5,12,0,4,0.67,0.67,1,3,1,3,2,0
1,0,0,1,1,1,2,5.33,1.5,12,0,4,0.67,0.67,1,3,1,3,2,0
1,0,0,1,1,1,2,5.33,1.5,12,0,4,0.67,0.67,1,3,1,3,2,0
1,0,0,1,1,1,2,5.33,1.5,12,0,4,0.67,0.67,1,3,1,3,2,0
1,0,0,1,1,1,2,5.33,1.5,12,0,4,0.67,0.67,1,3,1,3,2,0
1,0,0,1,1,1,2,5.33,1.5,12,0,4,0.67,0.67,1,3,1,3,2,0
1,0,0,1,1,1,2,5.33,1.5,12,0,4,0.67,0.67,1,3,1,3,2,0
1,0,0,1,1,1,2,5.33,1.5,12,0,4,0.67,0.67,1,3,1,3,2,0
1,0,0,1,1,1,2,5.33,1.5,12,0,4,0.67,0.67,1,3,1,3,2,0
1,0,0,1,1,1,2,5.33,1.5,12,0,4,0.67,0.67,1,3,1,3,2,0
1,0,0,1,1,1,2,5.33,1.5,12,0,4,0.67,0.67,1,3,1,3,2,0
1,0,0,1,1,1,2,5.33,1.5,12,0,4,0.67,0.67,1,3,1,3,2,0
1,0,0,1,1,1,2,5.33,1.5,12,0,4,0.67,0.67,1,3,1,3,2,0
1,0,0,1,1,1,2,5.33,1.5,12,0,4,0.67,0.67,1,3,1,3,2,0
1,0,0,1,1,1,2,5.33,1.5,12,0,4,0.67,0.67,1,3,1,3,2,0
1,0,0,1,1,1,2,5.33,1.5,12,0,4,0.67,0.67,1,3,1,3,2,0
1,0,0,1,1,1,2,5.33,1.5,12,0,4,0.67,0.67,1,3,1,3,2,0
1,0,0,1,1,1,2,5.33,1.5,12,0,4,0.67,0.67,1,3,1,3,2,0
1,0,0,1,1,1,2,5.33,1.5,12,0,4,0.67,0.67,1,3,1,3,2,0
1,0,0,1,1,1,2,5.33,1.5,12,0,4,0.67,0.67,1,3,1,3,2,0
3,0,2,2,1,1,7,9.88,5.25,272.43,0.02,15,0.19,15.14,6,9,4,7,7,0
9,0,11,5,2,1,39,30.74,11.6,4136.75,0.12,75,0.09,229.82,29,46,15,12,39,0
1,0,0,1,1,1,2,7.74,1.5,17.41,0,5,0.67,0.97,2,3,2,3,2,0
1,0,0,1,1,1,2,7.74,1.5,17.41,0,5,0.67,0.97,2,3,2,3,2,0
1,0,0,1,1,1,2,7.74,1.5,17.41,0,5,0.67,0.97,2,3,2,3,2,0
1,0,0,1,1,1,2,7.74,1.5,17.41,0,5,0.67,0.97,2,3,2,3,2,0
1,0,0,1,1,1,2,7.74,1.5,17.41,0,5,0.67,0.97,2,3,2,3,2,0
1,0,0,1,1,1,2,7.74,1.5,17.41,0,5,0.67,0.97,2,3,2,3,2,0
1,0,0,1,1,1,2,7.74,1.5,17.41,0,5,0.67,0.97,2,3,2,3,2,0
1,0,0,1,1,1,2,7.74,1.5,17.41,0,5,0.67,0.97,2,3,2,3,2,0
1,0,0,1,1,1,2,7.74,1.5,17.41,0,5,0.67,0.97,2,3,2,3,2,0
1,0,0,1,1,1,2,7.74,1.5,17.41,0,5,0.67,0.97,2,3,2,3,2,0
1,0,0,1,1,1,2,7.74,1.5,17.41,0,5,0.67,0.97,2,3,2,3,2,0
1,0,0,1,1,1,2,7.74,1.5,17.41,0,5,0.67,0.97,2,3,2,3,2,0
1,0,0,1,1,1,2,7.74,1.5,17.41,0,5,0.67,0.97,2,3,2,3,2,0
1,0,0,1,1,1,2,7.74,1.5,17.41,0,5,0.67,0.97,2,3,2,3,2,0
1,0,0,1,1,1,2,7.74,1.5,17.41,0,5,0.67,0.97,2,3,2,3,2,0
1,0,0,1,1,1,2,7.74,1.5,17.41,0,5,0.67,0.97,2,3,2,3,2,0
1,0,0,1,1,1,2,7.74,1.5,17.41,0,5,0.67,0.97,2,3,2,3,2,0
1,0,0,1,1,1,2,7.74,1.5,17.41,0,5,0.67,0.97,2,3,2,3,2,0
1,0,0,1,1,1,2,7.74,1.5,17.41,0,5,0.67,0.97,2,3,2,3,2,0
1,0,0,1,1,1,2,7.74,1.5,17.41,0,5,0.67,0.97,2,3,2,3,2,0
1,0,0,1,1,1,2,7.74,1.5,17.41,0,5,0.67,0.97,2,3,2,3,2,0
1,0,0,1,1,1,2,7.74,1.5,17.41,0,5,0.67,0.97,2,3,2,3,2,0
1,0,0,1,1,1,2,7.74,1.5,17.41,0,5,0.67,0.97,2,3,2,3,2,0
1,0,0,1,1,1,2,7.74,1.5,17.41,0,5,0.67,0.97,2,3,2,3,2,0
1,0,0,1,1,1,2,7.74,1.5,17.41,0,5,0.67,0.97,2,3,2,3,2,0
1,0,0,1,1,1,2,7.74,1.5,17.41,0,5,0.67,0.97,2,3,2,3,2,0
1,0,0,1,1,1,0,0,0,0,0,1,0,0,0,1,0,1,0,0
1,0,0,1,1,1,2,5.33,1.5,12,0,4,0.67,0.67,1,3,1,3,2,0
1,0,0,1,1,1,2,5.33,1.5,12,0,4,0.67,0.67,1,3,1,3,2,0
1,0,0,1,1,1,2,5.33,1.5,12,0,4,0.67,0.67,1,3,1,3,2,0
17,1,9,9,1,9,18,33.85,8.64,2528.58,0.1,63,0.12,140.48,22,41,14,11,19,0
13,0,7,7,1,7,11,33.67,6,1212.28,0.07,46,0.17,67.35,16,30,12,9,11,0
1,0,1,1,1,1,4,15.85,2,63.4,0.01,10,0.5,3.52,5,5,5,4,4,0
1,0,0,1,1,1,0,0,0,0,0,1,0,0,0,1,0,1,0,0
1,0,0,1,1,1,2,5.33,1.5,12,0,4,0.67,0.67,1,3,1,3,2,0
1,0,0,1,1,1,2,5.33,1.5,12,0,4,0.67,0.67,1,3,1,3,2,0
1,0,0,1,1,1,2,5.33,1.5,12,0,4,0.67,0.67,1,3,1,3,2,0
1,0,0,1,1,1,2,5.33,1.5,12,0,4,0.67,0.67,1,3,1,3,2,0
1,0,0,1,1,1,2,5.33,1.5,12,0,4,0.67,0.67,1,3,1,3,2,0
1,0,0,1,1,1,2,5.33,1.5,12,0,4,0.67,0.67,1,3,1,3,2,0
1,0,0,1,1,1,2,7.74,1.5,17.41,0,5,0.67,0.97,2,3,2,3,2,0
1,0,0,1,1,1,0,0,0,0,0,1,0,0,0,1,0,1,0,0
1,0,0,1,1,1,2,5.33,1.5,12,0,4,0.67,0.67,1,3,1,3,2,0
1,0,0,1,1,1,2,5.33,1.5,12,0,4,0.67,0.67,1,3,1,3,2,0
1,0,0,1,1,1,2,5.33,1.5,12,0,4,0.67,0.67,1,3,1,3,2,0
1,0,0,1,1,1,2,5.33,1.5,12,0,4,0.67,0.67,1,3,1,3,2,0
1,0,0,1,1,1,2,5.33,1.5,12,0,4,0.67,0.67,1,3,1,3,2,0
1,0,0,1,1,1,2,7.74,1.5,17.41,0,5,0.67,0.97,2,3,2,3,2,0
1,0,0,1,1,1,2,7.74,1.5,17.41,0,5,0.67,0.97,2,3,2,3,2,0
1,0,0,1,1,1,2,7.74,1.5,17.41,0,5,0.67,0.97,2,3,2,3,2,0
1,0,0,1,1,1,2,7.74,1.5,17.41,0,5,0.67,0.97,2,3,2,3,2,0
1,0,0,1,1,1,2,7.74,1.5,17.41,0,5,0.67,0.97,2,3,2,3,2,0
1,0,0,1,1,1,2,7.74,1.5,17.41,0,5,0.67,0.97,2,3,2,3,2,0
1,0,0,1,1,1,0,0,0,0,0,0,0,0,0,0,0,0,0,0
1,0,0,1,1,1,2,7.74,1.5,17.41,0,5,0.67,0.97,2,3,2,3,2,0
1,0,0,1,1,1,2,7.74,1.5,17.41,0,5,0.67,0.97,2,3,2,3,2,0
1,0,0,1,1,1,2,7.74,1.5,17.41,0,5,0.67,0.97,2,3,2,3,2,0
1,0,0,1,1,1,0,0,0,0,0,1,0,0,0,1,0,1,0,0
1,0,0,1,1,1,0,0,0,0,0,1,0,0,0,1,0,1,0,0
1,0,0,1,1,1,0,0,0,0,0,1,0,0,0,1,0,1,0,0
1,0,0,1,1,1,0,0,0,0,0,1,0,0,0,1,0,1,0,0
1,0,0,1,1,1,0,0,0,0,0,1,0,0,0,1,0,1,0,0
1,0,0,1,1,1,0,0,0,0,0,1,0,0,0,1,0,1,0,0
1,0,0,1,1,1,0,0,0,0,0,1,0,0,0,1,0,1,0,0
9,3,0,5,5,4,4,6.95,27.62,5307.06,0.06,47,0.04,294.84,17,30,4,13,7,0
1,0,0,1,1,1,2,5.33,1.5,12,0,4,0.67,0.67,1,3,1,3,2,0
1,0,0,1,1,1,2,5.8,2,23.22,0,5,0.5,1.29,1,4,1,4,2,0
1,0,1,1,1,1,2,7.49,3,67.38,0.01,8,0.33,3.74,1,7,1,6,2,0
1,0,0,1,1,1,2,13.18,5.25,363.24,0.02,20,0.19,20.18,6,14,4,7,2,0
1,0,0,1,1,1,2,5.33,1.5,12,0,4,0.67,0.67,1,3,1,3,2,0
1,0,0,1,1,1,2,5.33,1.5,12,0,4,0.67,0.67,1,3,1,3,2,0
1,0,0,1,1,1,2,5.33,1.5,12,0,4,0.67,0.67,1,3,1,3,2,0
1,0,0,1,1,1,2,5.33,1.5,12,0,4,0.67,0.67,1,3,1,3,2,0
1,0,0,1,1,1,4,27.47,1.5,61.81,0.01,13,0.67,3.43,6,7,6,3,4,0
1,0,0,1,1,1,2,11.3,6.13,423.78,0.02,20,0.16,23.54,7,13,4,7,2,0
1,0,0,1,1,1,0,0,0,0,0,1,0,0,0,1,0,1,0,0
1,0,0,1,1,1,2,7.74,1.5,17.41,0,5,0.67,0.97,2,3,2,3,2,0
1,0,0,1,1,1,2,7.74,1.5,17.41,0,5,0.67,0.97,2,3,2,3,2,0
1,0,0,1,1,1,0,0,0,0,0,1,0,0,0,1,0,1,0,0
1,0,0,1,1,1,2,5.33,1.5,12,0,4,0.67,0.67,1,3,1,3,2,0
1,0,0,1,1,1,2,5.33,1.5,12,0,4,0.67,0.67,1,3,1,3,2,0
1,0,0,1,1,1,2,5.33,1.5,12,0,4,0.67,0.67,1,3,1,3,2,0
1,0,0,1,1,1,2,5.33,1.5,12,0,4,0.67,0.67,1,3,1,3,2,0
1,0,0,1,1,1,2,5.33,1.5,12,0,4,0.67,0.67,1,3,1,3,2,0
1,0,0,1,1,1,2,5.33,1.5,12,0,4,0.67,0.67,1,3,1,3,2,0
1,0,0,1,1,1,2,5.33,1.5,12,0,4,0.67,0.67,1,3,1,3,2,0
1,0,0,1,1,1,2,5.33,1.5,12,0,4,0.67,0.67,1,3,1,3,2,0
1,0,0,1,1,1,2,5.33,1.5,12,0,4,0.67,0.67,1,3,1,3,2,0
1,0,0,1,1,1,2,5.33,1.5,12,0,4,0.67,0.67,1,3,1,3,2,0
1,0,0,1,1,1,2,5.33,1.5,12,0,4,0.67,0.67,1,3,1,3,2,0
1,0,0,1,1,1,2,5.33,1.5,12,0,4,0.67,0.67,1,3,1,3,2,0
1,0,0,1,1,1,2,5.33,1.5,12,0,4,0.67,0.67,1,3,1,3,2,0
1,1,0,1,1,1,12,55.45,3.54,694.24,0.07,48,0.28,38.57,23,25,13,4,13,0
1,0,0,1,1,1,0,0,0,0,0,1,0,0,0,1,0,1,0,0
1,0,0,1,1,1,2,6.2,2.5,38.77,0.01,6,0.4,2.15,1,5,1,5,2,0
1,0,0,1,1,1,2,5.33,1.5,12,0,4,0.67,0.67,1,3,1,3,2,0
1,0,0,1,1,1,0,0,0,0,0,1,0,0,0,1,0,1,0,0
1,0,0,1,1,1,2,5.33,1.5,12,0,4,0.67,0.67,1,3,1,3,2,0
1,0,0,1,1,1,2,5.33,1.5,12,0,4,0.67,0.67,1,3,1,3,2,0
1,0,0,1,1,1,2,5.33,1.5,12,0,4,0.67,0.67,1,3,1,3,2,0
1,0,0,1,1,1,2,5.33,1.5,12,0,4,0.67,0.67,1,3,1,3,2,0
1,0,0,1,1,1,2,5.33,1.5,12,0,4,0.67,0.67,1,3,1,3,2,0
1,0,0,1,1,1,2,5.33,1.5,12,0,4,0.67,0.67,1,3,1,3,2,0
1,0,0,1,1,1,2,5.33,1.5,12,0,4,0.67,0.67,1,3,1,3,2,0
1,0,0,1,1,1,2,5.33,1.5,12,0,4,0.67,0.67,1,3,1,3,2,0
1,0,0,1,1,1,2,5.33,1.5,12,0,4,0.67,0.67,1,3,1,3,2,0
1,0,0,1,1,1,2,5.33,1.5,12,0,4,0.67,0.67,1,3,1,3,2,0
1,0,0,1,1,1,2,5.33,1.5,12,0,4,0.67,0.67,1,3,1,3,2,0
1,0,0,1,1,1,2,5.33,1.5,12,0,4,0.67,0.67,1,3,1,3,2,0
1,0,0,1,1,1,2,5.33,1.5,12,0,4,0.67,0.67,1,3,1,3,2,0
1,0,0,1,1,1,2,5.33,1.5,12,0,4,0.67,0.67,1,3,1,3,2,0
1,0,0,1,1,1,2,5.33,1.5,12,0,4,0.67,0.67,1,3,1,3,2,0
1,0,0,1,1,1,2,5.33,1.5,12,0,4,0.67,0.67,1,3,1,3,2,0
1,0,0,1,1,1,2,5.33,1.5,12,0,4,0.67,0.67,1,3,1,3,2,0
1,0,0,1,1,1,2,5.33,1.5,12,0,4,0.67,0.67,1,3,1,3,2,0
1,0,0,1,1,1,0,0,0,0,0,1,0,0,0,1,0,1,0,0
1,0,0,1,1,1,2,5.33,1.5,12,0,4,0.67,0.67,1,3,1,3,2,0
1,0,0,1,1,1,2,5.33,1.5,12,0,4,0.67,0.67,1,3,1,3,2,0
1,0,0,1,1,1,2,5.33,1.5,12,0,4,0.67,0.67,1,3,1,3,2,0
1,0,0,1,1,1,2,5.33,1.5,12,0,4,0.67,0.67,1,3,1,3,2,0
1,0,0,1,1,1,2,5.33,1.5,12,0,4,0.67,0.67,1,3,1,3,2,0
1,0,0,1,1,1,2,5.33,1.5,12,0,4,0.67,0.67,1,3,1,3,2,0
1,0,0,1,1,1,2,5.33,1.5,12,0,4,0.67,0.67,1,3,1,3,2,0
1,0,0,1,1,1,2,5.33,1.5,12,0,4,0.67,0.67,1,3,1,3,2,0
1,0,0,1,1,1,2,5.33,1.5,12,0,4,0.67,0.67,1,3,1,3,2,0
1,0,0,1,1,1,2,5.33,1.5,12,0,4,0.67,0.67,1,3,1,3,2,0
1,0,0,1,1,1,2,5.33,1.5,12,0,4,0.67,0.67,1,3,1,3,2,0
1,0,0,1,1,1,2,5.33,1.5,12,0,4,0.67,0.67,1,3,1,3,2,0
1,0,0,1,1,1,2,7.74,1.5,17.41,0,5,0.67,0.97,2,3,2,3,2,0
1,0,0,1,1,1,2,7.74,1.5,17.41,0,5,0.67,0.97,2,3,2,3,2,0
1,0,0,1,1,1,2,7.74,1.5,17.41,0,5,0.67,0.97,2,3,2,3,2,0
1,0,0,1,1,1,2,7.74,1.5,17.41,0,5,0.67,0.97,2,3,2,3,2,0
1,0,0,1,1,1,2,7.74,1.5,17.41,0,5,0.67,0.97,2,3,2,3,2,0
1,0,0,1,1,1,2,7.74,1.5,17.41,0,5,0.67,0.97,2,3,2,3,2,0
1,0,0,1,1,1,0,0,0,0,0,1,0,0,0,1,0,1,0,0
1,0,0,1,1,1,0,0,0,0,0,0,0,0,0,0,0,0,0,0
1,0,0,1,1,1,2,7.74,1.5,17.41,0,5,0.67,0.97,2,3,2,3,2,0
1,0,0,1,1,1,0,0,0,0,0,0,0,0,0,0,0,0,0,0
1,0,0,1,1,1,0,0,0,0,0,1,0,0,0,1,0,1,0,0
1,0,0,1,1,1,2,5.33,1.5,12,0,4,0.67,0.67,1,3,1,3,2,0
1,0,0,1,1,1,2,5.33,1.5,12,0,4,0.67,0.67,1,3,1,3,2,0
1,0,0,1,1,1,2,5.33,1.5,12,0,4,0.67,0.67,1,3,1,3,2,0
1,0,0,1,1,1,2,5.33,1.5,12,0,4,0.67,0.67,1,3,1,3,2,0
1,0,0,1,1,1,2,5.33,1.5,12,0,4,0.67,0.67,1,3,1,3,2,0
1,0,0,1,1,1,2,5.33,1.5,12,0,4,0.67,0.67,1,3,1,3,2,0
1,0,0,1,1,1,3,11.63,2,46.53,0.01,9,0.5,2.58,4,5,3,3,3,0
1,0,0,1,1,1,2,7.75,2,31.02,0.01,6,0.5,1.72,2,4,2,4,2,0
1,0,0,1,1,1,0,0,0,0,0,1,0,0,0,1,0,1,0,0
1,0,0,1,1,1,2,5.33,1.5,12,0,4,0.67,0.67,1,3,1,3,2,0
1,0,0,1,1,1,2,5.8,2,23.22,0,5,0.5,1.29,1,4,1,4,2,0
1,0,0,1,1,1,2,5.8,2,23.22,0,5,0.5,1.29,1,4,1,4,2,0
1,0,0,1,1,1,2,5.33,1.5,12,0,4,0.67,0.67,1,3,1,3,2,0
1,0,0,1,1,1,2,5.33,1.5,12,0,4,0.67,0.67,1,3,1,3,2,0
3,0,1,2,2,1,8,29.49,3.82,429.88,0.04,27,0.26,23.88,12,15,11,7,8,0
1,0,0,1,1,1,0,0,0,0,0,1,0,0,0,1,0,1,0,0
1,0,0,1,1,1,0,0,0,0,0,1,0,0,0,1,0,1,0,0
1,0,0,1,1,1,2,7.74,1.5,17.41,0,5,0.67,0.97,2,3,2,3,2,0
1,0,0,1,1,1,0,0,0,0,0,0,0,0,0,0,0,0,0,0
1,0,0,1,1,1,0,0,0,0,0,1,0,0,0,1,0,1,0,0
1,0,0,1,1,1,0,0,0,0,0,0,0,0,0,0,0,0,0,0
1,0,0,1,1,1,2,5.33,1.5,12,0,4,0.67,0.67,1,3,1,3,2,0
1,0,0,1,1,1,2,5.33,1.5,12,0,4,0.67,0.67,1,3,1,3,2,0
1,0,0,1,1,1,2,5.33,1.5,12,0,4,0.67,0.67,1,3,1,3,2,0
1,0,0,1,1,1,2,5.33,1.5,12,0,4,0.67,0.67,1,3,1,3,2,0
1,0,0,1,1,1,2,5.33,1.5,12,0,4,0.67,0.67,1,3,1,3,2,0
1,0,0,1,1,1,2,5.33,1.5,12,0,4,0.67,0.67,1,3,1,3,2,0
1,0,0,1,1,1,2,5.33,1.5,12,0,4,0.67,0.67,1,3,1,3,2,0
1,0,0,1,1,1,2,5.33,1.5,12,0,4,0.67,0.67,1,3,1,3,2,0
1,0,0,1,1,1,2,5.33,1.5,12,0,4,0.67,0.67,1,3,1,3,2,0
1,0,0,1,1,1,2,5.33,1.5,12,0,4,0.67,0.67,1,3,1,3,2,0
1,0,0,1,1,1,2,5.33,1.5,12,0,4,0.67,0.67,1,3,1,3,2,0
1,0,0,1,1,1,2,5.33,1.5,12,0,4,0.67,0.67,1,3,1,3,2,0
1,0,0,1,1,1,2,5.33,1.5,12,0,4,0.67,0.67,1,3,1,3,2,0
1,0,0,1,1,1,2,5.33,1.5,12,0,4,0.67,0.67,1,3,1,3,2,0
1,0,0,1,1,1,2,5.33,1.5,12,0,4,0.67,0.67,1,3,1,3,2,0
1,0,0,1,1,1,2,5.33,1.5,12,0,4,0.67,0.67,1,3,1,3,2,0
1,0,0,1,1,1,2,5.33,1.5,12,0,4,0.67,0.67,1,3,1,3,2,0
1,0,0,1,1,1,2,5.33,1.5,12,0,4,0.67,0.67,1,3,1,3,2,0
1,0,0,1,1,1,2,5.33,1.5,12,0,4,0.67,0.67,1,3,1,3,2,0
1,0,0,1,1,1,2,5.33,1.5,12,0,4,0.67,0.67,1,3,1,3,2,0
1,0,0,1,1,1,2,5.33,1.5,12,0,4,0.67,0.67,1,3,1,3,2,0
1,0,0,1,1,1,2,5.33,1.5,12,0,4,0.67,0.67,1,3,1,3,2,0
1,0,0,1,1,1,2,5.33,1.5,12,0,4,0.67,0.67,1,3,1,3,2,0
1,0,0,1,1,1,2,5.33,1.5,12,0,4,0.67,0.67,1,3,1,3,2,0
1,0,0,1,1,1,2,5.33,1.5,12,0,4,0.67,0.67,1,3,1,3,2,0
1,0,0,1,1,1,2,5.33,1.5,12,0,4,0.67,0.67,1,3,1,3,2,0
1,0,0,1,1,1,2,5.33,1.5,12,0,4,0.67,0.67,1,3,1,3,2,0
1,0,0,1,1,1,2,5.33,1.5,12,0,4,0.67,0.67,1,3,1,3,2,0
1,0,0,1,1,1,2,5.33,1.5,12,0,4,0.67,0.67,1,3,1,3,2,0
1,0,0,1,1,1,2,5.33,1.5,12,0,4,0.67,0.67,1,3,1,3,2,0
1,0,0,1,1,1,2,5.33,1.5,12,0,4,0.67,0.67,1,3,1,3,2,0
1,0,0,1,1,1,2,5.33,1.5,12,0,4,0.67,0.67,1,3,1,3,2,0
1,0,0,1,1,1,2,5.33,1.5,12,0,4,0.67,0.67,1,3,1,3,2,0
1,0,0,1,1,1,2,5.33,1.5,12,0,4,0.67,0.67,1,3,1,3,2,0
1,0,0,1,1,1,2,5.33,1.5,12,0,4,0.67,0.67,1,3,1,3,2,0
1,0,0,1,1,1,2,5.33,1.5,12,0,4,0.67,0.67,1,3,1,3,2,0
1,0,0,1,1,1,2,5.33,1.5,12,0,4,0.67,0.67,1,3,1,3,2,0
1,0,0,1,1,1,2,5.33,1.5,12,0,4,0.67,0.67,1,3,1,3,2,0
1,0,0,1,1,1,2,5.33,1.5,12,0,4,0.67,0.67,1,3,1,3,2,0
1,0,0,1,1,1,2,5.33,1.5,12,0,4,0.67,0.67,1,3,1,3,2,0
1,0,0,1,1,1,2,5.33,1.5,12,0,4,0.67,0.67,1,3,1,3,2,0
1,0,0,1,1,1,2,5.33,1.5,12,0,4,0.67,0.67,1,3,1,3,2,0
1,0,0,1,1,1,2,5.33,1.5,12,0,4,0.67,0.67,1,3,1,3,2,0
1,0,0,1,1,1,2,7.74,1.5,17.41,0,5,0.67,0.97,2,3,2,3,2,0
1,0,0,1,1,1,2,7.74,1.5,17.41,0,5,0.67,0.97,2,3,2,3,2,0
1,0,0,1,1,1,2,7.74,1.5,17.41,0,5,0.67,0.97,2,3,2,3,2,0
1,0,0,1,1,1,2,7.74,1.5,17.41,0,5,0.67,0.97,2,3,2,3,2,0
1,0,0,1,1,1,2,7.74,1.5,17.41,0,5,0.67,0.97,2,3,2,3,2,0
1,0,0,1,1,1,2,7.74,1.5,17.41,0,5,0.67,0.97,2,3,2,3,2,0
1,0,0,1,1,1,2,7.74,1.5,17.41,0,5,0.67,0.97,2,3,2,3,2,0
1,0,0,1,1,1,2,7.74,1.5,17.41,0,5,0.67,0.97,2,3,2,3,2,0
1,0,0,1,1,1,2,7.74,1.5,17.41,0,5,0.67,0.97,2,3,2,3,2,0
1,0,0,1,1,1,2,7.74,1.5,17.41,0,5,0.67,0.97,2,3,2,3,2,0
1,0,0,1,1,1,2,7.74,1.5,17.41,0,5,0.67,0.97,2,3,2,3,2,0
1,0,0,1,1,1,2,7.74,1.5,17.41,0,5,0.67,0.97,2,3,2,3,2,0
1,0,0,1,1,1,2,7.74,1.5,17.41,0,5,0.67,0.97,2,3,2,3,2,0
1,0,0,1,1,1,2,7.74,1.5,17.41,0,5,0.67,0.97,2,3,2,3,2,0
1,0,0,1,1,1,2,7.74,1.5,17.41,0,5,0.67,0.97,2,3,2,3,2,0
1,0,0,1,1,1,2,7.74,1.5,17.41,0,5,0.67,0.97,2,3,2,3,2,0
1,0,0,1,1,1,2,7.74,1.5,17.41,0,5,0.67,0.97,2,3,2,3,2,0
1,0,0,1,1,1,2,7.74,1.5,17.41,0,5,0.67,0.97,2,3,2,3,2,0
1,0,0,1,1,1,2,7.74,1.5,17.41,0,5,0.67,0.97,2,3,2,3,2,0
1,0,0,1,1,1,2,7.74,1.5,17.41,0,5,0.67,0.97,2,3,2,3,2,0
1,0,0,1,1,1,2,7.74,1.5,17.41,0,5,0.67,0.97,2,3,2,3,2,0
1,0,0,1,1,1,2,7.74,1.5,17.41,0,5,0.67,0.97,2,3,2,3,2,0
1,0,0,1,1,1,2,7.74,1.5,17.41,0,5,0.67,0.97,2,3,2,3,2,0
1,0,0,1,1,1,2,7.74,1.5,17.41,0,5,0.67,0.97,2,3,2,3,2,0
1,0,0,1,1,1,2,7.74,1.5,17.41,0,5,0.67,0.97,2,3,2,3,2,0
1,0,0,1,1,1,2,7.74,1.5,17.41,0,5,0.67,0.97,2,3,2,3,2,0
1,0,0,1,1,1,0,0,0,0,0,1,0,0,0,1,0,1,0,0
1,0,0,1,1,1,2,5.33,1.5,12,0,4,0.67,0.67,1,3,1,3,2,0
1,0,0,1,1,1,2,5.33,1.5,12,0,4,0.67,0.67,1,3,1,3,2,0
1,0,0,1,1,1,2,5.33,1.5,12,0,4,0.67,0.67,1,3,1,3,2,0
49,0,0,25,20,1,98,109.38,9.96,10853.98,0.36,216,0.1,603,74,142,26,7,98,0
16,4,2,13,1,1,74,39.92,17.92,12813.74,0.24,131,0.06,711.87,43,88,24,20,78,0
3,0,0,2,2,1,6,5.89,7,288.46,0.01,13,0.14,16.03,4,9,2,7,6,0
11,0,6,6,2,3,39,66.25,11.89,9359.76,0.26,141,0.08,519.99,64,77,35,13,39,0
85,7,76,43,30,28,166,117.38,36.44,155844.09,1.43,641,0.03,8658,265,376,80,22,173,1
67,0,2,34,2,1,191,157.26,22.18,77379.02,1.16,555,0.05,4298.83,244,311,66,12,191,0
1,2,45,1,1,1,117,177.34,14.78,38737.03,0.87,417,0.07,2152.06,201,216,68,10,119,0
5,0,1,3,1,3,11,15.39,7.86,950.15,0.04,29,0.13,52.79,10,19,7,11,11,0
15,1,1,8,1,6,18,22.5,11.82,3142.78,0.09,58,0.08,174.6,20,38,11,13,19,1
161,21,64,81,51,53,350,108.67,79.68,689843.31,2.89,1337,0.01,38324.63,516,821,68,21,371,0
9,1,2,5,2,1,27,28.36,10.15,2923.49,0.1,62,0.1,162.42,22,40,13,12,28,0
1,0,0,1,1,1,0,0,0,0,0,1,0,0,0,1,0,1,0,0
1,0,0,1,1,1,0,0,0,0,0,0,0,0,0,0,0,0,0,0
1,0,0,1,1,1,0,0,0,0,0,1,0,0,0,1,0,1,0,0
1,0,0,1,1,1,2,5.33,1.5,12,0,4,0.67,0.67,1,3,1,3,2,0
1,0,0,1,1,1,2,5.33,1.5,12,0,4,0.67,0.67,1,3,1,3,2,0
1,0,0,1,1,1,2,5.8,2,23.22,0,5,0.5,1.29,1,4,1,4,2,0
1,0,0,1,1,1,2,5.33,1.5,12,0,4,0.67,0.67,1,3,1,3,2,0
5,0,1,3,3,3,9,29.17,5.33,829.81,0.05,36,0.19,46.1,16,20,12,8,9,0
1,0,0,1,1,1,0,0,0,0,0,1,0,0,0,1,0,1,0,0
1,0,0,1,1,1,2,5.33,1.5,12,0,4,0.67,0.67,1,3,1,3,2,0
1,0,0,1,1,1,2,5.33,1.5,12,0,4,0.67,0.67,1,3,1,3,2,0
1,0,0,1,1,1,2,5.33,1.5,12,0,4,0.67,0.67,1,3,1,3,2,0
1,0,0,1,1,1,2,5.33,1.5,12,0,4,0.67,0.67,1,3,1,3,2,0
1,0,0,1,1,1,2,5.33,1.5,12,0,4,0.67,0.67,1,3,1,3,2,0
1,0,0,1,1,1,2,5.33,1.5,12,0,4,0.67,0.67,1,3,1,3,2,0
1,0,0,1,1,1,2,7.74,1.5,17.41,0,5,0.67,0.97,2,3,2,3,2,0
1,0,0,1,1,1,0,0,0,0,0,1,0,0,0,1,0,1,0,0
1,0,0,1,1,1,2,5.33,1.5,12,0,4,0.67,0.67,1,3,1,3,2,0
1,0,0,1,1,1,2,5.33,1.5,12,0,4,0.67,0.67,1,3,1,3,2,0
1,0,0,1,1,1,2,5.33,1.5,12,0,4,0.67,0.67,1,3,1,3,2,0
1,0,0,1,1,1,2,5.33,1.5,12,0,4,0.67,0.67,1,3,1,3,2,0
1,0,0,1,1,1,2,5.33,1.5,12,0,4,0.67,0.67,1,3,1,3,2,0
1,0,0,1,1,1,2,7.74,1.5,17.41,0,5,0.67,0.97,2,3,2,3,2,0
1,0,0,1,1,1,2,7.74,1.5,17.41,0,5,0.67,0.97,2,3,2,3,2,0
1,0,0,1,1,1,2,7.74,1.5,17.41,0,5,0.67,0.97,2,3,2,3,2,0
1,0,0,1,1,1,2,7.74,1.5,17.41,0,5,0.67,0.97,2,3,2,3,2,0
1,0,0,1,1,1,2,7.74,1.5,17.41,0,5,0.67,0.97,2,3,2,3,2,0
1,0,0,1,1,1,2,7.74,1.5,17.41,0,5,0.67,0.97,2,3,2,3,2,0
1,0,0,1,1,1,0,0,0,0,0,0,0,0,0,0,0,0,0,0
9,0,1,5,1,3,11,20.8,5,520,0.03,26,0.2,28.89,10,16,8,8,11,0
11,0,2,6,1,1,20,26.69,7.77,1612.47,0.07,48,0.13,89.58,19,29,11,9,20,0
1,0,0,1,1,1,2,7.74,1.5,17.41,0,5,0.67,0.97,2,3,2,3,2,0
1,0,0,1,1,1,2,7.74,1.5,17.41,0,5,0.67,0.97,2,3,2,3,2,0
1,0,0,1,1,1,2,7.74,1.5,17.41,0,5,0.67,0.97,2,3,2,3,2,0
1,0,0,1,1,1,0,0,0,0,0,1,0,0,0,1,0,1,0,0
1,0,0,1,1,1,2,7.49,3,67.38,0.01,8,0.33,3.74,1,7,1,6,2,0
1,0,0,1,1,1,0,0,0,0,0,0,0,0,0,0,0,0,0,0
1,0,0,1,1,1,0,0,0,0,0,1,0,0,0,1,0,1,0,0
1,0,0,1,1,1,2,5.33,1.5,12,0,4,0.67,0.67,1,3,1,3,2,0
1,0,0,1,1,1,2,5.33,1.5,12,0,4,0.67,0.67,1,3,1,3,2,0
1,0,0,1,1,1,2,5.33,1.5,12,0,4,0.67,0.67,1,3,1,3,2,0
1,0,0,1,1,1,2,5.33,1.5,12,0,4,0.67,0.67,1,3,1,3,2,0
1,0,0,1,1,1,2,5.33,1.5,12,0,4,0.67,0.67,1,3,1,3,2,0
1,0,0,1,1,1,2,7.74,1.5,17.41,0,5,0.67,0.97,2,3,2,3,2,0
1,0,0,1,1,1,2,7.74,1.5,17.41,0,5,0.67,0.97,2,3,2,3,2,0
1,0,0,1,1,1,2,7.74,1.5,17.41,0,5,0.67,0.97,2,3,2,3,2,0
1,0,0,1,1,1,2,7.74,1.5,17.41,0,5,0.67,0.97,2,3,2,3,2,0
1,0,0,1,1,1,2,7.74,1.5,17.41,0,5,0.67,0.97,2,3,2,3,2,0
1,0,0,1,1,1,0,0,0,0,0,1,0,0,0,1,0,1,0,0
1,0,0,1,1,1,0,0,0,0,0,1,0,0,0,1,0,1,0,0
9,3,0,5,5,4,4,6.95,27.62,5307.06,0.06,47,0.04,294.84,17,30,4,13,7,0
1,0,0,1,1,1,2,13.18,5.25,363.24,0.02,20,0.19,20.18,6,14,4,7,2,0
1,0,0,1,1,1,2,5.33,1.5,12,0,4,0.67,0.67,1,3,1,3,2,0
1,0,0,1,1,1,2,5.33,1.5,12,0,4,0.67,0.67,1,3,1,3,2,0
1,0,0,1,1,1,2,5.33,1.5,12,0,4,0.67,0.67,1,3,1,3,2,0
1,0,0,1,1,1,4,27.47,1.5,61.81,0.01,13,0.67,3.43,6,7,6,3,4,0
1,0,0,1,1,1,2,11.3,6.13,423.78,0.02,20,0.16,23.54,7,13,4,7,2,0
1,0,0,1,1,1,0,0,0,0,0,1,0,0,0,1,0,1,0,0
1,0,0,1,1,1,2,5.33,1.5,12,0,4,0.67,0.67,1,3,1,3,2,0
1,0,0,1,1,1,2,5.33,1.5,12,0,4,0.67,0.67,1,3,1,3,2,0
1,0,0,1,1,1,2,5.33,1.5,12,0,4,0.67,0.67,1,3,1,3,2,0
1,0,0,1,1,1,2,5.33,1.5,12,0,4,0.67,0.67,1,3,1,3,2,0
1,0,0,1,1,1,2,5.33,1.5,12,0,4,0.67,0.67,1,3,1,3,2,0
1,0,0,1,1,1,2,5.33,1.5,12,0,4,0.67,0.67,1,3,1,3,2,0
1,0,0,1,1,1,2,5.33,1.5,12,0,4,0.67,0.67,1,3,1,3,2,0
1,0,0,1,1,1,2,5.33,1.5,12,0,4,0.67,0.67,1,3,1,3,2,0
1,0,0,1,1,1,2,5.33,1.5,12,0,4,0.67,0.67,1,3,1,3,2,0
1,0,0,1,1,1,2,5.33,1.5,12,0,4,0.67,0.67,1,3,1,3,2,0
1,0,0,1,1,1,2,5.33,1.5,12,0,4,0.67,0.67,1,3,1,3,2,0
1,0,0,1,1,1,2,5.33,1.5,12,0,4,0.67,0.67,1,3,1,3,2,0
1,0,0,1,1,1,2,5.33,1.5,12,0,4,0.67,0.67,1,3,1,3,2,0
1,1,0,1,1,1,12,55.45,3.54,694.24,0.07,48,0.28,38.57,23,25,13,4,13,0
1,0,0,1,1,1,0,0,0,0,0,1,0,0,0,1,0,1,0,0
1,0,0,1,1,1,2,5.33,1.5,12,0,4,0.67,0.67,1,3,1,3,2,0
1,0,0,1,1,1,2,5.33,1.5,12,0,4,0.67,0.67,1,3,1,3,2,0
1,0,0,1,1,1,2,5.33,1.5,12,0,4,0.67,0.67,1,3,1,3,2,0
1,0,0,1,1,1,2,5.33,1.5,12,0,4,0.67,0.67,1,3,1,3,2,0
1,0,0,1,1,1,2,5.33,1.5,12,0,4,0.67,0.67,1,3,1,3,2,0
1,0,0,1,1,1,2,5.33,1.5,12,0,4,0.67,0.67,1,3,1,3,2,0
1,0,0,1,1,1,2,5.33,1.5,12,0,4,0.67,0.67,1,3,1,3,2,0
1,0,0,1,1,1,2,5.33,1.5,12,0,4,0.67,0.67,1,3,1,3,2,0
1,0,0,1,1,1,2,5.33,1.5,12,0,4,0.67,0.67,1,3,1,3,2,0
1,0,0,1,1,1,2,5.33,1.5,12,0,4,0.67,0.67,1,3,1,3,2,0
1,0,0,1,1,1,2,5.33,1.5,12,0,4,0.67,0.67,1,3,1,3,2,0
1,0,0,1,1,1,2,5.33,1.5,12,0,4,0.67,0.67,1,3,1,3,2,0
1,0,0,1,1,1,2,5.33,1.5,12,0,4,0.67,0.67,1,3,1,3,2,0
1,0,0,1,1,1,2,5.33,1.5,12,0,4,0.67,0.67,1,3,1,3,2,0
1,0,0,1,1,1,2,5.33,1.5,12,0,4,0.67,0.67,1,3,1,3,2,0
1,0,0,1,1,1,2,5.33,1.5,12,0,4,0.67,0.67,1,3,1,3,2,0
1,0,0,1,1,1,2,5.33,1.5,12,0,4,0.67,0.67,1,3,1,3,2,0
1,0,0,1,1,1,2,5.33,1.5,12,0,4,0.67,0.67,1,3,1,3,2,0
1,0,0,1,1,1,2,7.74,1.5,17.41,0,5,0.67,0.97,2,3,2,3,2,0
1,0,0,1,1,1,0,0,0,0,0,0,0,0,0,0,0,0,0,0
1,0,0,1,1,1,0,0,0,0,0,1,0,0,0,1,0,1,0,0
1,0,0,1,1,1,2,5.33,1.5,12,0,4,0.67,0.67,1,3,1,3,2,0
1,0,0,1,1,1,2,5.33,1.5,12,0,4,0.67,0.67,1,3,1,3,2,0
1,0,0,1,1,1,2,5.33,1.5,12,0,4,0.67,0.67,1,3,1,3,2,0
1,0,0,1,1,1,2,5.33,1.5,12,0,4,0.67,0.67,1,3,1,3,2,0
1,0,0,1,1,1,2,5.33,1.5,12,0,4,0.67,0.67,1,3,1,3,2,0
1,0,0,1,1,1,2,5.33,1.5,12,0,4,0.67,0.67,1,3,1,3,2,0
1,0,0,1,1,1,3,11.63,2,46.53,0.01,9,0.5,2.58,4,5,3,3,3,0
1,0,0,1,1,1,2,7.75,2,31.02,0.01,6,0.5,1.72,2,4,2,4,2,0
1,0,0,1,1,1,2,5.33,1.5,12,0,4,0.67,0.67,1,3,1,3,2,0
1,0,0,1,1,1,2,5.33,1.5,12,0,4,0.67,0.67,1,3,1,3,2,0
1,0,0,1,1,1,2,5.33,1.5,12,0,4,0.67,0.67,1,3,1,3,2,0
1,0,0,1,1,1,2,5.33,1.5,12,0,4,0.67,0.67,1,3,1,3,2,0
1,0,0,1,1,1,2,5.33,1.5,12,0,4,0.67,0.67,1,3,1,3,2,0
1,0,0,1,1,1,2,5.33,1.5,12,0,4,0.67,0.67,1,3,1,3,2,0
1,0,0,1,1,1,2,5.33,1.5,12,0,4,0.67,0.67,1,3,1,3,2,0
1,0,0,1,1,1,2,5.33,1.5,12,0,4,0.67,0.67,1,3,1,3,2,0
1,0,0,1,1,1,2,5.33,1.5,12,0,4,0.67,0.67,1,3,1,3,2,0
1,0,0,1,1,1,2,5.33,1.5,12,0,4,0.67,0.67,1,3,1,3,2,0
1,0,0,1,1,1,2,5.33,1.5,12,0,4,0.67,0.67,1,3,1,3,2,0
1,0,0,1,1,1,2,5.33,1.5,12,0,4,0.67,0.67,1,3,1,3,2,0
1,0,0,1,1,1,2,5.33,1.5,12,0,4,0.67,0.67,1,3,1,3,2,0
1,0,0,1,1,1,2,5.33,1.5,12,0,4,0.67,0.67,1,3,1,3,2,0
1,0,0,1,1,1,2,5.33,1.5,12,0,4,0.67,0.67,1,3,1,3,2,0
1,0,0,1,1,1,2,5.33,1.5,12,0,4,0.67,0.67,1,3,1,3,2,0
1,0,0,1,1,1,2,5.33,1.5,12,0,4,0.67,0.67,1,3,1,3,2,0
1,0,0,1,1,1,2,5.33,1.5,12,0,4,0.67,0.67,1,3,1,3,2,0
1,0,0,1,1,1,2,5.33,1.5,12,0,4,0.67,0.67,1,3,1,3,2,0
1,0,0,1,1,1,2,5.33,1.5,12,0,4,0.67,0.67,1,3,1,3,2,0
1,0,0,1,1,1,2,5.33,1.5,12,0,4,0.67,0.67,1,3,1,3,2,0
1,0,0,1,1,1,2,5.33,1.5,12,0,4,0.67,0.67,1,3,1,3,2,0
1,0,0,1,1,1,2,5.33,1.5,12,0,4,0.67,0.67,1,3,1,3,2,0
1,0,0,1,1,1,2,5.33,1.5,12,0,4,0.67,0.67,1,3,1,3,2,0
1,0,0,1,1,1,2,5.33,1.5,12,0,4,0.67,0.67,1,3,1,3,2,0
1,0,0,1,1,1,2,5.33,1.5,12,0,4,0.67,0.67,1,3,1,3,2,0
1,0,0,1,1,1,2,5.33,1.5,12,0,4,0.67,0.67,1,3,1,3,2,0
1,0,0,1,1,1,2,5.33,1.5,12,0,4,0.67,0.67,1,3,1,3,2,0
1,0,0,1,1,1,2,5.33,1.5,12,0,4,0.67,0.67,1,3,1,3,2,0
1,0,0,1,1,1,2,5.33,1.5,12,0,4,0.67,0.67,1,3,1,3,2,0
1,0,0,1,1,1,2,5.33,1.5,12,0,4,0.67,0.67,1,3,1,3,2,0
1,0,0,1,1,1,2,5.33,1.5,12,0,4,0.67,0.67,1,3,1,3,2,0
1,0,0,1,1,1,2,5.33,1.5,12,0,4,0.67,0.67,1,3,1,3,2,0
1,0,0,1,1,1,2,5.33,1.5,12,0,4,0.67,0.67,1,3,1,3,2,0
1,0,0,1,1,1,2,5.33,1.5,12,0,4,0.67,0.67,1,3,1,3,2,0
1,0,0,1,1,1,2,5.33,1.5,12,0,4,0.67,0.67,1,3,1,3,2,0
1,0,0,1,1,1,2,5.33,1.5,12,0,4,0.67,0.67,1,3,1,3,2,0
1,0,0,1,1,1,2,5.33,1.5,12,0,4,0.67,0.67,1,3,1,3,2,0
1,0,0,1,1,1,2,5.33,1.5,12,0,4,0.67,0.67,1,3,1,3,2,0
1,0,0,1,1,1,2,5.33,1.5,12,0,4,0.67,0.67,1,3,1,3,2,0
1,0,0,1,1,1,2,5.33,1.5,12,0,4,0.67,0.67,1,3,1,3,2,0
1,0,0,1,1,1,2,5.33,1.5,12,0,4,0.67,0.67,1,3,1,3,2,0
1,0,0,1,1,1,2,5.33,1.5,12,0,4,0.67,0.67,1,3,1,3,2,0
1,0,0,1,1,1,2,7.74,1.5,17.41,0,5,0.67,0.97,2,3,2,3,2,0
1,0,0,1,1,1,2,7.74,1.5,17.41,0,5,0.67,0.97,2,3,2,3,2,0
1,0,0,1,1,1,2,7.74,1.5,17.41,0,5,0.67,0.97,2,3,2,3,2,0
1,0,0,1,1,1,2,7.74,1.5,17.41,0,5,0.67,0.97,2,3,2,3,2,0
1,0,0,1,1,1,2,7.74,1.5,17.41,0,5,0.67,0.97,2,3,2,3,2,0
1,0,0,1,1,1,2,7.74,1.5,17.41,0,5,0.67,0.97,2,3,2,3,2,0
1,0,0,1,1,1,2,7.74,1.5,17.41,0,5,0.67,0.97,2,3,2,3,2,0
1,0,0,1,1,1,2,7.74,1.5,17.41,0,5,0.67,0.97,2,3,2,3,2,0
1,0,0,1,1,1,2,7.74,1.5,17.41,0,5,0.67,0.97,2,3,2,3,2,0
1,0,0,1,1,1,2,7.74,1.5,17.41,0,5,0.67,0.97,2,3,2,3,2,0
1,0,0,1,1,1,2,7.74,1.5,17.41,0,5,0.67,0.97,2,3,2,3,2,0
1,0,0,1,1,1,2,7.74,1.5,17.41,0,5,0.67,0.97,2,3,2,3,2,0
1,0,0,1,1,1,2,7.74,1.5,17.41,0,5,0.67,0.97,2,3,2,3,2,0
1,0,0,1,1,1,2,7.74,1.5,17.41,0,5,0.67,0.97,2,3,2,3,2,0
1,0,0,1,1,1,2,7.74,1.5,17.41,0,5,0.67,0.97,2,3,2,3,2,0
1,0,0,1,1,1,2,7.74,1.5,17.41,0,5,0.67,0.97,2,3,2,3,2,0
1,0,0,1,1,1,2,7.74,1.5,17.41,0,5,0.67,0.97,2,3,2,3,2,0
1,0,0,1,1,1,2,7.74,1.5,17.41,0,5,0.67,0.97,2,3,2,3,2,0
1,0,0,1,1,1,2,7.74,1.5,17.41,0,5,0.67,0.97,2,3,2,3,2,0
1,0,0,1,1,1,2,7.74,1.5,17.41,0,5,0.67,0.97,2,3,2,3,2,0
1,0,0,1,1,1,2,7.74,1.5,17.41,0,5,0.67,0.97,2,3,2,3,2,0
1,0,0,1,1,1,2,7.74,1.5,17.41,0,5,0.67,0.97,2,3,2,3,2,0
1,0,0,1,1,1,2,7.74,1.5,17.41,0,5,0.67,0.97,2,3,2,3,2,0
1,0,0,1,1,1,2,7.74,1.5,17.41,0,5,0.67,0.97,2,3,2,3,2,0
1,0,0,1,1,1,2,7.74,1.5,17.41,0,5,0.67,0.97,2,3,2,3,2,0
1,0,0,1,1,1,2,7.74,1.5,17.41,0,5,0.67,0.97,2,3,2,3,2,0
1,0,0,1,1,1,0,0,0,0,0,1,0,0,0,1,0,1,0,0
1,0,0,1,1,1,2,5.33,1.5,12,0,4,0.67,0.67,1,3,1,3,2,0
1,0,0,1,1,1,2,5.33,1.5,12,0,4,0.67,0.67,1,3,1,3,2,0
1,0,0,1,1,1,2,5.33,1.5,12,0,4,0.67,0.67,1,3,1,3,2,0
1,0,0,1,1,1,0,0,0,0,0,1,0,0,0,1,0,1,0,0
1,0,0,1,1,1,2,5.33,1.5,12,0,4,0.67,0.67,1,3,1,3,2,0
21,2,4,11,7,9,31,22.26,23.57,12367.03,0.17,108,0.04,687.06,44,64,14,15,33,0
1,0,0,1,1,1,2,5.33,1.5,12,0,4,0.67,0.67,1,3,1,3,2,0
1,0,0,1,1,1,2,5.8,2,23.22,0,5,0.5,1.29,1,4,1,4,2,0
1,0,0,1,1,1,2,5.33,1.5,12,0,4,0.67,0.67,1,3,1,3,2,0
3,0,3,2,1,1,8,15.07,4.67,328.11,0.02,19,0.21,18.23,8,11,6,7,8,0
29,4,22,15,4,15,30,46.87,13.23,8204.62,0.21,115,0.08,455.81,43,72,26,16,34,0
13,4,10,7,5,6,32,41.24,9.69,3870.52,0.13,85,0.1,215.03,31,54,16,10,36,0
5,0,1,3,3,3,9,29.17,5.33,829.81,0.05,36,0.19,46.1,16,20,12,8,9,0
13,0,7,7,1,7,11,32.94,6,1185.93,0.07,45,0.17,65.88,16,29,12,9,11,0
1,1,0,1,1,1,6,19.03,2,76.11,0.01,11,0.5,4.23,7,4,7,4,7,0
1,0,0,1,1,1,0,0,0,0,0,1,0,0,0,1,0,1,0,0
1,0,0,1,1,1,2,5.33,1.5,12,0,4,0.67,0.67,1,3,1,3,2,0
1,0,0,1,1,1,2,5.33,1.5,12,0,4,0.67,0.67,1,3,1,3,2,0
1,0,0,1,1,1,2,5.33,1.5,12,0,4,0.67,0.67,1,3,1,3,2,0
1,0,0,1,1,1,2,5.33,1.5,12,0,4,0.67,0.67,1,3,1,3,2,0
1,0,0,1,1,1,2,5.33,1.5,12,0,4,0.67,0.67,1,3,1,3,2,0
1,0,0,1,1,1,2,5.33,1.5,12,0,4,0.67,0.67,1,3,1,3,2,0
1,0,0,1,1,1,2,7.74,1.5,17.41,0,5,0.67,0.97,2,3,2,3,2,0
1,0,0,1,1,1,0,0,0,0,0,1,0,0,0,1,0,1,0,0
1,0,0,1,1,1,2,5.33,1.5,12,0,4,0.67,0.67,1,3,1,3,2,0
1,0,0,1,1,1,2,5.33,1.5,12,0,4,0.67,0.67,1,3,1,3,2,0
1,0,0,1,1,1,2,5.33,1.5,12,0,4,0.67,0.67,1,3,1,3,2,0
1,0,0,1,1,1,2,5.33,1.5,12,0,4,0.67,0.67,1,3,1,3,2,0
1,0,0,1,1,1,2,5.33,1.5,12,0,4,0.67,0.67,1,3,1,3,2,0
1,0,0,1,1,1,2,7.74,1.5,17.41,0,5,0.67,0.97,2,3,2,3,2,0
1,0,0,1,1,1,2,7.74,1.5,17.41,0,5,0.67,0.97,2,3,2,3,2,0
1,0,0,1,1,1,2,7.74,1.5,17.41,0,5,0.67,0.97,2,3,2,3,2,0
1,0,0,1,1,1,2,7.74,1.5,17.41,0,5,0.67,0.97,2,3,2,3,2,0
1,0,0,1,1,1,2,7.74,1.5,17.41,0,5,0.67,0.97,2,3,2,3,2,0
1,0,0,1,1,1,2,7.74,1.5,17.41,0,5,0.67,0.97,2,3,2,3,2,0
1,0,0,1,1,1,0,0,0,0,0,0,0,0,0,0,0,0,0,0
1,0,0,1,1,1,2,7.74,1.5,17.41,0,5,0.67,0.97,2,3,2,3,2,0
1,0,0,1,1,1,2,7.74,1.5,17.41,0,5,0.67,0.97,2,3,2,3,2,0
1,0,0,1,1,1,2,7.74,1.5,17.41,0,5,0.67,0.97,2,3,2,3,2,0
1,0,0,1,1,1,0,0,0,0,0,1,0,0,0,1,0,1,0,0
1,0,0,1,1,1,0,0,0,0,0,1,0,0,0,1,0,1,0,0
9,3,0,5,5,4,4,6.95,27.62,5307.06,0.06,47,0.04,294.84,17,30,4,13,7,0
1,0,0,1,1,1,2,13.18,5.25,363.24,0.02,20,0.19,20.18,6,14,4,7,2,0
1,0,0,1,1,1,2,5.33,1.5,12,0,4,0.67,0.67,1,3,1,3,2,0
1,0,0,1,1,1,2,5.33,1.5,12,0,4,0.67,0.67,1,3,1,3,2,0
1,0,0,1,1,1,2,5.33,1.5,12,0,4,0.67,0.67,1,3,1,3,2,0
1,0,0,1,1,1,4,27.47,1.5,61.81,0.01,13,0.67,3.43,6,7,6,3,4,0
1,0,0,1,1,1,2,11.3,6.13,423.78,0.02,20,0.16,23.54,7,13,4,7,2,0
11,8,28,6,2,5,82,121.28,18.06,39539.11,0.73,361,0.06,2196.62,150,211,54,13,90,0
7,1,11,4,4,1,32,56.08,10.43,6105.91,0.2,116,0.1,339.22,48,68,23,10,33,0
1,0,0,1,1,1,0,0,0,0,0,1,0,0,0,1,0,1,0,0
1,0,0,1,1,1,2,5.33,1.5,12,0,4,0.67,0.67,1,3,1,3,2,0
1,0,0,1,1,1,2,5.33,1.5,12,0,4,0.67,0.67,1,3,1,3,2,0
1,0,0,1,1,1,2,5.33,1.5,12,0,4,0.67,0.67,1,3,1,3,2,0
1,0,0,1,1,1,2,5.33,1.5,12,0,4,0.67,0.67,1,3,1,3,2,0
1,0,0,1,1,1,2,5.33,1.5,12,0,4,0.67,0.67,1,3,1,3,2,0
1,0,0,1,1,1,2,5.33,1.5,12,0,4,0.67,0.67,1,3,1,3,2,0
1,0,0,1,1,1,2,5.33,1.5,12,0,4,0.67,0.67,1,3,1,3,2,0
1,0,0,1,1,1,2,5.33,1.5,12,0,4,0.67,0.67,1,3,1,3,2,0
1,0,0,1,1,1,2,5.33,1.5,12,0,4,0.67,0.67,1,3,1,3,2,0
1,0,0,1,1,1,2,5.33,1.5,12,0,4,0.67,0.67,1,3,1,3,2,0
1,0,0,1,1,1,2,5.33,1.5,12,0,4,0.67,0.67,1,3,1,3,2,0
1,0,0,1,1,1,2,5.33,1.5,12,0,4,0.67,0.67,1,3,1,3,2,0
1,0,0,1,1,1,2,5.33,1.5,12,0,4,0.67,0.67,1,3,1,3,2,0
1,1,0,1,1,1,12,55.45,3.54,694.24,0.07,48,0.28,38.57,23,25,13,4,13,0
1,0,0,1,1,1,0,0,0,0,0,1,0,0,0,1,0,1,0,0
1,0,0,1,1,1,2,5.33,1.5,12,0,4,0.67,0.67,1,3,1,3,2,0
1,0,0,1,1,1,2,5.33,1.5,12,0,4,0.67,0.67,1,3,1,3,2,0
1,0,0,1,1,1,2,5.33,1.5,12,0,4,0.67,0.67,1,3,1,3,2,0
1,0,0,1,1,1,2,5.33,1.5,12,0,4,0.67,0.67,1,3,1,3,2,0
1,0,0,1,1,1,2,5.33,1.5,12,0,4,0.67,0.67,1,3,1,3,2,0
1,0,0,1,1,1,2,5.33,1.5,12,0,4,0.67,0.67,1,3,1,3,2,0
1,0,0,1,1,1,2,5.33,1.5,12,0,4,0.67,0.67,1,3,1,3,2,0
1,0,0,1,1,1,2,5.33,1.5,12,0,4,0.67,0.67,1,3,1,3,2,0
1,0,0,1,1,1,2,5.33,1.5,12,0,4,0.67,0.67,1,3,1,3,2,0
1,0,0,1,1,1,2,5.33,1.5,12,0,4,0.67,0.67,1,3,1,3,2,0
1,0,0,1,1,1,2,5.33,1.5,12,0,4,0.67,0.67,1,3,1,3,2,0
1,0,0,1,1,1,2,5.33,1.5,12,0,4,0.67,0.67,1,3,1,3,2,0
1,0,0,1,1,1,2,5.33,1.5,12,0,4,0.67,0.67,1,3,1,3,2,0
1,0,0,1,1,1,2,5.33,1.5,12,0,4,0.67,0.67,1,3,1,3,2,0
1,0,0,1,1,1,2,5.33,1.5,12,0,4,0.67,0.67,1,3,1,3,2,0
1,0,0,1,1,1,2,5.33,1.5,12,0,4,0.67,0.67,1,3,1,3,2,0
1,0,0,1,1,1,2,5.33,1.5,12,0,4,0.67,0.67,1,3,1,3,2,0
1,0,0,1,1,1,2,5.33,1.5,12,0,4,0.67,0.67,1,3,1,3,2,0
1,0,0,1,1,1,2,7.74,1.5,17.41,0,5,0.67,0.97,2,3,2,3,2,0
1,0,0,1,1,1,0,0,0,0,0,0,0,0,0,0,0,0,0,0
1,0,0,1,1,1,0,0,0,0,0,1,0,0,0,1,0,1,0,0
1,0,0,1,1,1,2,5.33,1.5,12,0,4,0.67,0.67,1,3,1,3,2,0
1,0,0,1,1,1,2,5.33,1.5,12,0,4,0.67,0.67,1,3,1,3,2,0
1,0,0,1,1,1,2,5.33,1.5,12,0,4,0.67,0.67,1,3,1,3,2,0
1,0,0,1,1,1,2,5.33,1.5,12,0,4,0.67,0.67,1,3,1,3,2,0
1,0,0,1,1,1,2,5.33,1.5,12,0,4,0.67,0.67,1,3,1,3,2,0
1,0,0,1,1,1,2,5.33,1.5,12,0,4,0.67,0.67,1,3,1,3,2,0
1,0,0,1,1,1,3,11.63,2,46.53,0.01,9,0.5,2.58,4,5,3,3,3,0
1,0,0,1,1,1,2,7.75,2,31.02,0.01,6,0.5,1.72,2,4,2,4,2,0
1,0,0,1,1,1,2,5.33,1.5,12,0,4,0.67,0.67,1,3,1,3,2,0
1,0,0,1,1,1,2,5.33,1.5,12,0,4,0.67,0.67,1,3,1,3,2,0
1,0,0,1,1,1,2,5.33,1.5,12,0,4,0.67,0.67,1,3,1,3,2,0
1,0,0,1,1,1,2,5.33,1.5,12,0,4,0.67,0.67,1,3,1,3,2,0
1,0,0,1,1,1,2,5.33,1.5,12,0,4,0.67,0.67,1,3,1,3,2,0
1,0,0,1,1,1,2,5.33,1.5,12,0,4,0.67,0.67,1,3,1,3,2,0
1,0,0,1,1,1,2,5.33,1.5,12,0,4,0.67,0.67,1,3,1,3,2,0
1,0,0,1,1,1,2,5.33,1.5,12,0,4,0.67,0.67,1,3,1,3,2,0
1,0,0,1,1,1,2,5.33,1.5,12,0,4,0.67,0.67,1,3,1,3,2,0
1,0,0,1,1,1,2,5.33,1.5,12,0,4,0.67,0.67,1,3,1,3,2,0
1,0,0,1,1,1,2,5.33,1.5,12,0,4,0.67,0.67,1,3,1,3,2,0
1,0,0,1,1,1,2,5.33,1.5,12,0,4,0.67,0.67,1,3,1,3,2,0
1,0,0,1,1,1,2,5.33,1.5,12,0,4,0.67,0.67,1,3,1,3,2,0
1,0,0,1,1,1,2,5.33,1.5,12,0,4,0.67,0.67,1,3,1,3,2,0
1,0,0,1,1,1,2,5.33,1.5,12,0,4,0.67,0.67,1,3,1,3,2,0
1,0,0,1,1,1,2,5.33,1.5,12,0,4,0.67,0.67,1,3,1,3,2,0
1,0,0,1,1,1,2,5.33,1.5,12,0,4,0.67,0.67,1,3,1,3,2,0
1,0,0,1,1,1,2,7.74,1.5,17.41,0,5,0.67,0.97,2,3,2,3,2,0
1,0,0,1,1,1,2,7.74,1.5,17.41,0,5,0.67,0.97,2,3,2,3,2,0
1,0,0,1,1,1,2,7.74,1.5,17.41,0,5,0.67,0.97,2,3,2,3,2,0
1,0,0,1,1,1,2,5.33,1.5,12,0,4,0.67,0.67,1,3,1,3,2,0
1,0,0,1,1,1,2,5.33,1.5,12,0,4,0.67,0.67,1,3,1,3,2,0
1,0,0,1,1,1,2,5.33,1.5,12,0,4,0.67,0.67,1,3,1,3,2,0
1,0,0,1,1,1,2,5.33,1.5,12,0,4,0.67,0.67,1,3,1,3,2,0
1,0,0,1,1,1,2,5.33,1.5,12,0,4,0.67,0.67,1,3,1,3,2,0
1,0,0,1,1,1,2,5.33,1.5,12,0,4,0.67,0.67,1,3,1,3,2,0
1,0,0,1,1,1,2,5.33,1.5,12,0,4,0.67,0.67,1,3,1,3,2,0
1,0,0,1,1,1,2,5.33,1.5,12,0,4,0.67,0.67,1,3,1,3,2,0
1,0,0,1,1,1,2,5.33,1.5,12,0,4,0.67,0.67,1,3,1,3,2,0
1,0,0,1,1,1,2,5.33,1.5,12,0,4,0.67,0.67,1,3,1,3,2,0
1,0,0,1,1,1,2,5.33,1.5,12,0,4,0.67,0.67,1,3,1,3,2,0
1,0,0,1,1,1,2,5.33,1.5,12,0,4,0.67,0.67,1,3,1,3,2,0
1,0,0,1,1,1,2,5.33,1.5,12,0,4,0.67,0.67,1,3,1,3,2,0
1,0,0,1,1,1,2,5.33,1.5,12,0,4,0.67,0.67,1,3,1,3,2,0
1,0,0,1,1,1,2,5.33,1.5,12,0,4,0.67,0.67,1,3,1,3,2,0
1,0,0,1,1,1,2,5.33,1.5,12,0,4,0.67,0.67,1,3,1,3,2,0
1,0,0,1,1,1,2,5.33,1.5,12,0,4,0.67,0.67,1,3,1,3,2,0
1,0,0,1,1,1,2,5.33,1.5,12,0,4,0.67,0.67,1,3,1,3,2,0
1,0,0,1,1,1,2,5.33,1.5,12,0,4,0.67,0.67,1,3,1,3,2,0
1,0,0,1,1,1,2,5.33,1.5,12,0,4,0.67,0.67,1,3,1,3,2,0
1,0,0,1,1,1,2,5.33,1.5,12,0,4,0.67,0.67,1,3,1,3,2,0
1,0,0,1,1,1,2,5.33,1.5,12,0,4,0.67,0.67,1,3,1,3,2,0
1,0,0,1,1,1,2,5.33,1.5,12,0,4,0.67,0.67,1,3,1,3,2,0
1,0,0,1,1,1,2,5.33,1.5,12,0,4,0.67,0.67,1,3,1,3,2,0
1,0,0,1,1,1,2,5.33,1.5,12,0,4,0.67,0.67,1,3,1,3,2,0
1,0,0,1,1,1,2,5.33,1.5,12,0,4,0.67,0.67,1,3,1,3,2,0
1,0,0,1,1,1,2,5.33,1.5,12,0,4,0.67,0.67,1,3,1,3,2,0
1,0,0,1,1,1,2,5.33,1.5,12,0,4,0.67,0.67,1,3,1,3,2,0
1,0,0,1,1,1,2,5.33,1.5,12,0,4,0.67,0.67,1,3,1,3,2,0
1,0,0,1,1,1,2,5.33,1.5,12,0,4,0.67,0.67,1,3,1,3,2,0
1,0,0,1,1,1,2,5.33,1.5,12,0,4,0.67,0.67,1,3,1,3,2,0
1,0,0,1,1,1,2,5.33,1.5,12,0,4,0.67,0.67,1,3,1,3,2,0
1,0,0,1,1,1,2,5.33,1.5,12,0,4,0.67,0.67,1,3,1,3,2,0
1,0,0,1,1,1,2,5.33,1.5,12,0,4,0.67,0.67,1,3,1,3,2,0
1,0,0,1,1,1,2,5.33,1.5,12,0,4,0.67,0.67,1,3,1,3,2,0
1,0,0,1,1,1,2,5.33,1.5,12,0,4,0.67,0.67,1,3,1,3,2,0
1,0,0,1,1,1,2,5.33,1.5,12,0,4,0.67,0.67,1,3,1,3,2,0
1,0,0,1,1,1,2,5.33,1.5,12,0,4,0.67,0.67,1,3,1,3,2,0
1,0,0,1,1,1,2,5.33,1.5,12,0,4,0.67,0.67,1,3,1,3,2,0
1,0,0,1,1,1,2,5.33,1.5,12,0,4,0.67,0.67,1,3,1,3,2,0
1,0,0,1,1,1,2,5.33,1.5,12,0,4,0.67,0.67,1,3,1,3,2,0
1,0,0,1,1,1,2,5.33,1.5,12,0,4,0.67,0.67,1,3,1,3,2,0
1,0,0,1,1,1,2,5.33,1.5,12,0,4,0.67,0.67,1,3,1,3,2,0
1,0,0,1,1,1,2,7.74,1.5,17.41,0,5,0.67,0.97,2,3,2,3,2,0
1,0,0,1,1,1,2,7.74,1.5,17.41,0,5,0.67,0.97,2,3,2,3,2,0
1,0,0,1,1,1,2,7.74,1.5,17.41,0,5,0.67,0.97,2,3,2,3,2,0
1,0,0,1,1,1,2,7.74,1.5,17.41,0,5,0.67,0.97,2,3,2,3,2,0
1,0,0,1,1,1,2,7.74,1.5,17.41,0,5,0.67,0.97,2,3,2,3,2,0
1,0,0,1,1,1,2,7.74,1.5,17.41,0,5,0.67,0.97,2,3,2,3,2,0
1,0,0,1,1,1,2,7.74,1.5,17.41,0,5,0.67,0.97,2,3,2,3,2,0
1,0,0,1,1,1,2,7.74,1.5,17.41,0,5,0.67,0.97,2,3,2,3,2,0
1,0,0,1,1,1,2,7.74,1.5,17.41,0,5,0.67,0.97,2,3,2,3,2,0
1,0,0,1,1,1,2,7.74,1.5,17.41,0,5,0.67,0.97,2,3,2,3,2,0
1,0,0,1,1,1,2,7.74,1.5,17.41,0,5,0.67,0.97,2,3,2,3,2,0
1,0,0,1,1,1,2,7.74,1.5,17.41,0,5,0.67,0.97,2,3,2,3,2,0
1,0,0,1,1,1,2,7.74,1.5,17.41,0,5,0.67,0.97,2,3,2,3,2,0
1,0,0,1,1,1,2,7.74,1.5,17.41,0,5,0.67,0.97,2,3,2,3,2,0
1,0,0,1,1,1,2,7.74,1.5,17.41,0,5,0.67,0.97,2,3,2,3,2,0
1,0,0,1,1,1,2,7.74,1.5,17.41,0,5,0.67,0.97,2,3,2,3,2,0
1,0,0,1,1,1,2,7.74,1.5,17.41,0,5,0.67,0.97,2,3,2,3,2,0
1,0,0,1,1,1,2,7.74,1.5,17.41,0,5,0.67,0.97,2,3,2,3,2,0
1,0,0,1,1,1,2,7.74,1.5,17.41,0,5,0.67,0.97,2,3,2,3,2,0
1,0,0,1,1,1,2,7.74,1.5,17.41,0,5,0.67,0.97,2,3,2,3,2,0
1,0,0,1,1,1,2,7.74,1.5,17.41,0,5,0.67,0.97,2,3,2,3,2,0
1,0,0,1,1,1,2,7.74,1.5,17.41,0,5,0.67,0.97,2,3,2,3,2,0
1,0,0,1,1,1,2,7.74,1.5,17.41,0,5,0.67,0.97,2,3,2,3,2,0
1,0,0,1,1,1,2,7.74,1.5,17.41,0,5,0.67,0.97,2,3,2,3,2,0
1,0,0,1,1,1,2,7.74,1.5,17.41,0,5,0.67,0.97,2,3,2,3,2,0
1,0,0,1,1,1,2,7.74,1.5,17.41,0,5,0.67,0.97,2,3,2,3,2,0
1,0,0,1,1,1,0,0,0,0,0,1,0,0,0,1,0,1,0,0
1,0,0,1,1,1,2,5.33,1.5,12,0,4,0.67,0.67,1,3,1,3,2,0
1,0,0,1,1,1,2,5.33,1.5,12,0,4,0.67,0.67,1,3,1,3,2,0
1,0,0,1,1,1,2,5.33,1.5,12,0,4,0.67,0.67,1,3,1,3,2,0
1,0,0,1,1,1,0,0,0,0,0,1,0,0,0,1,0,1,0,0
1,0,0,1,1,1,2,5.33,1.5,12,0,4,0.67,0.67,1,3,1,3,2,0
1,0,0,1,1,1,2,5.33,1.5,12,0,4,0.67,0.67,1,3,1,3,2,0
1,0,0,1,1,1,2,5.33,1.5,12,0,4,0.67,0.67,1,3,1,3,2,0
1,0,0,1,1,1,2,5.33,1.5,12,0,4,0.67,0.67,1,3,1,3,2,0
1,0,0,1,1,1,2,5.33,1.5,12,0,4,0.67,0.67,1,3,1,3,2,0
1,0,0,1,1,1,2,5.33,1.5,12,0,4,0.67,0.67,1,3,1,3,2,0
3,0,3,2,1,1,53,186.16,7.23,9723.75,0.45,216,0.14,540.21,106,110,66,9,53,0
1,0,0,1,1,1,2,7.74,1.5,17.41,0,5,0.67,0.97,2,3,2,3,2,0
5,1,6,3,3,1,42,69.78,10.55,7760.49,0.25,134,0.09,431.14,58,76,33,12,43,0
69,4,28,35,17,6,155,96.83,50.83,250206.08,1.64,762,0.02,13900.34,305,457,66,22,159,0
1,1,11,1,1,1,44,57.93,11.24,7315.66,0.22,134,0.09,406.43,59,75,21,8,45,0
17,1,2,9,2,1,46,38.9,17.66,12130.35,0.23,140,0.06,673.91,61,79,19,11,47,0
1,0,3,1,1,1,48,290.5,4.21,5144.86,0.41,203,0.24,285.83,101,102,60,5,48,0
1,0,0,1,1,1,2,7.74,1.5,17.41,0,5,0.67,0.97,2,3,2,3,2,0
1,0,0,1,1,1,2,7.74,1.5,17.41,0,5,0.67,0.97,2,3,2,3,2,0
1,0,0,1,1,1,2,7.74,1.5,17.41,0,5,0.67,0.97,2,3,2,3,2,0
1,0,0,1,1,1,0,0,0,0,0,1,0,0,0,1,0,1,0,0
1,0,0,1,1,1,0,0,0,0,0,1,0,0,0,1,0,1,0,0
1,0,0,1,1,1,0,0,0,0,0,1,0,0,0,1,0,1,0,0
9,3,0,5,5,4,4,6.95,27.62,5307.06,0.06,47,0.04,294.84,17,30,4,13,7,0
1,0,0,1,1,1,2,5.33,1.5,12,0,4,0.67,0.67,1,3,1,3,2,0
1,0,0,1,1,1,2,5.8,2,23.22,0,5,0.5,1.29,1,4,1,4,2,0
1,0,0,1,1,1,2,13.18,5.25,363.24,0.02,20,0.19,20.18,6,14,4,7,2,0
1,0,0,1,1,1,2,5.33,1.5,12,0,4,0.67,0.67,1,3,1,3,2,0
1,0,0,1,1,1,2,5.33,1.5,12,0,4,0.67,0.67,1,3,1,3,2,0
1,0,0,1,1,1,2,5.33,1.5,12,0,4,0.67,0.67,1,3,1,3,2,0
1,0,0,1,1,1,2,5.33,1.5,12,0,4,0.67,0.67,1,3,1,3,2,0
1,0,0,1,1,1,4,27.47,1.5,61.81,0.01,13,0.67,3.43,6,7,6,3,4,0
1,0,0,1,1,1,2,11.3,6.13,423.78,0.02,20,0.16,23.54,7,13,4,7,2,0
1,0,0,1,1,1,0,0,0,0,0,1,0,0,0,1,0,1,0,0
1,0,0,1,1,1,2,5.33,1.5,12,0,4,0.67,0.67,1,3,1,3,2,0
1,0,0,1,1,1,2,5.33,1.5,12,0,4,0.67,0.67,1,3,1,3,2,0
1,0,0,1,1,1,2,5.33,1.5,12,0,4,0.67,0.67,1,3,1,3,2,0
1,0,0,1,1,1,2,5.33,1.5,12,0,4,0.67,0.67,1,3,1,3,2,0
1,0,0,1,1,1,2,5.33,1.5,12,0,4,0.67,0.67,1,3,1,3,2,0
1,0,0,1,1,1,2,5.33,1.5,12,0,4,0.67,0.67,1,3,1,3,2,0
1,0,0,1,1,1,2,5.33,1.5,12,0,4,0.67,0.67,1,3,1,3,2,0
1,0,0,1,1,1,2,5.33,1.5,12,0,4,0.67,0.67,1,3,1,3,2,0
1,0,0,1,1,1,2,5.33,1.5,12,0,4,0.67,0.67,1,3,1,3,2,0
1,0,0,1,1,1,2,5.33,1.5,12,0,4,0.67,0.67,1,3,1,3,2,0
1,0,0,1,1,1,2,5.33,1.5,12,0,4,0.67,0.67,1,3,1,3,2,0
1,0,0,1,1,1,2,5.33,1.5,12,0,4,0.67,0.67,1,3,1,3,2,0
1,0,0,1,1,1,2,5.33,1.5,12,0,4,0.67,0.67,1,3,1,3,2,0
1,1,0,1,1,1,12,55.45,3.54,694.24,0.07,48,0.28,38.57,23,25,13,4,13,0
1,0,0,1,1,1,0,0,0,0,0,1,0,0,0,1,0,1,0,0
1,0,0,1,1,1,2,5.33,1.5,12,0,4,0.67,0.67,1,3,1,3,2,0
1,0,0,1,1,1,2,5.33,1.5,12,0,4,0.67,0.67,1,3,1,3,2,0
1,0,0,1,1,1,2,5.33,1.5,12,0,4,0.67,0.67,1,3,1,3,2,0
1,0,0,1,1,1,2,5.33,1.5,12,0,4,0.67,0.67,1,3,1,3,2,0
1,0,0,1,1,1,2,5.33,1.5,12,0,4,0.67,0.67,1,3,1,3,2,0
1,0,0,1,1,1,2,5.33,1.5,12,0,4,0.67,0.67,1,3,1,3,2,0
1,0,0,1,1,1,2,5.33,1.5,12,0,4,0.67,0.67,1,3,1,3,2,0
1,0,0,1,1,1,2,5.33,1.5,12,0,4,0.67,0.67,1,3,1,3,2,0
1,0,0,1,1,1,2,5.33,1.5,12,0,4,0.67,0.67,1,3,1,3,2,0
1,0,0,1,1,1,2,5.33,1.5,12,0,4,0.67,0.67,1,3,1,3,2,0
1,0,0,1,1,1,2,5.33,1.5,12,0,4,0.67,0.67,1,3,1,3,2,0
1,0,0,1,1,1,2,5.33,1.5,12,0,4,0.67,0.67,1,3,1,3,2,0
1,0,0,1,1,1,2,5.33,1.5,12,0,4,0.67,0.67,1,3,1,3,2,0
1,0,0,1,1,1,2,5.33,1.5,12,0,4,0.67,0.67,1,3,1,3,2,0
1,0,0,1,1,1,2,5.33,1.5,12,0,4,0.67,0.67,1,3,1,3,2,0
1,0,0,1,1,1,2,5.33,1.5,12,0,4,0.67,0.67,1,3,1,3,2,0
1,0,0,1,1,1,2,5.33,1.5,12,0,4,0.67,0.67,1,3,1,3,2,0
1,0,0,1,1,1,2,5.33,1.5,12,0,4,0.67,0.67,1,3,1,3,2,0
1,0,0,1,1,1,2,7.74,1.5,17.41,0,5,0.67,0.97,2,3,2,3,2,0
1,0,0,1,1,1,0,0,0,0,0,0,0,0,0,0,0,0,0,0
1,0,0,1,1,1,0,0,0,0,0,1,0,0,0,1,0,1,0,0
1,0,0,1,1,1,2,5.33,1.5,12,0,4,0.67,0.67,1,3,1,3,2,0
1,0,0,1,1,1,2,5.33,1.5,12,0,4,0.67,0.67,1,3,1,3,2,0
1,0,0,1,1,1,2,5.33,1.5,12,0,4,0.67,0.67,1,3,1,3,2,0
1,0,0,1,1,1,2,5.33,1.5,12,0,4,0.67,0.67,1,3,1,3,2,0
1,0,0,1,1,1,2,5.33,1.5,12,0,4,0.67,0.67,1,3,1,3,2,0
1,0,0,1,1,1,2,5.33,1.5,12,0,4,0.67,0.67,1,3,1,3,2,0
1,0,0,1,1,1,3,11.63,2,46.53,0.01,9,0.5,2.58,4,5,3,3,3,0
1,0,0,1,1,1,2,7.75,2,31.02,0.01,6,0.5,1.72,2,4,2,4,2,0
1,0,0,1,1,1,2,7.74,1.5,17.41,0,5,0.67,0.97,2,3,2,3,2,0
1,0,0,1,1,1,0,0,0,0,0,0,0,0,0,0,0,0,0,0
1,0,0,1,1,1,2,5.33,1.5,12,0,4,0.67,0.67,1,3,1,3,2,0
1,0,0,1,1,1,2,5.33,1.5,12,0,4,0.67,0.67,1,3,1,3,2,0
1,0,0,1,1,1,2,5.33,1.5,12,0,4,0.67,0.67,1,3,1,3,2,0
1,0,0,1,1,1,2,5.33,1.5,12,0,4,0.67,0.67,1,3,1,3,2,0
1,0,0,1,1,1,2,5.33,1.5,12,0,4,0.67,0.67,1,3,1,3,2,0
1,0,0,1,1,1,2,5.33,1.5,12,0,4,0.67,0.67,1,3,1,3,2,0
1,0,0,1,1,1,2,5.33,1.5,12,0,4,0.67,0.67,1,3,1,3,2,0
1,0,0,1,1,1,2,5.33,1.5,12,0,4,0.67,0.67,1,3,1,3,2,0
1,0,0,1,1,1,2,5.33,1.5,12,0,4,0.67,0.67,1,3,1,3,2,0
1,0,0,1,1,1,2,5.33,1.5,12,0,4,0.67,0.67,1,3,1,3,2,0
1,0,0,1,1,1,2,5.33,1.5,12,0,4,0.67,0.67,1,3,1,3,2,0
1,0,0,1,1,1,2,5.33,1.5,12,0,4,0.67,0.67,1,3,1,3,2,0
1,0,0,1,1,1,2,5.33,1.5,12,0,4,0.67,0.67,1,3,1,3,2,0
1,0,0,1,1,1,2,5.33,1.5,12,0,4,0.67,0.67,1,3,1,3,2,0
1,0,0,1,1,1,2,5.33,1.5,12,0,4,0.67,0.67,1,3,1,3,2,0
1,0,0,1,1,1,2,5.33,1.5,12,0,4,0.67,0.67,1,3,1,3,2,0
1,0,0,1,1,1,2,5.33,1.5,12,0,4,0.67,0.67,1,3,1,3,2,0
1,0,0,1,1,1,2,7.74,1.5,17.41,0,5,0.67,0.97,2,3,2,3,2,0
1,0,0,1,1,1,2,7.74,1.5,17.41,0,5,0.67,0.97,2,3,2,3,2,0
1,0,0,1,1,1,2,7.74,1.5,17.41,0,5,0.67,0.97,2,3,2,3,2,0
1,0,0,1,1,1,2,5.33,1.5,12,0,4,0.67,0.67,1,3,1,3,2,0
1,0,0,1,1,1,2,5.33,1.5,12,0,4,0.67,0.67,1,3,1,3,2,0
1,0,0,1,1,1,2,5.33,1.5,12,0,4,0.67,0.67,1,3,1,3,2,0
1,0,0,1,1,1,2,5.33,1.5,12,0,4,0.67,0.67,1,3,1,3,2,0
1,0,0,1,1,1,2,5.33,1.5,12,0,4,0.67,0.67,1,3,1,3,2,0
1,0,0,1,1,1,2,5.33,1.5,12,0,4,0.67,0.67,1,3,1,3,2,0
1,0,0,1,1,1,2,5.33,1.5,12,0,4,0.67,0.67,1,3,1,3,2,0
1,0,0,1,1,1,2,5.33,1.5,12,0,4,0.67,0.67,1,3,1,3,2,0
1,0,0,1,1,1,2,5.33,1.5,12,0,4,0.67,0.67,1,3,1,3,2,0
1,0,0,1,1,1,2,5.33,1.5,12,0,4,0.67,0.67,1,3,1,3,2,0
1,0,0,1,1,1,2,5.33,1.5,12,0,4,0.67,0.67,1,3,1,3,2,0
1,0,0,1,1,1,2,5.33,1.5,12,0,4,0.67,0.67,1,3,1,3,2,0
1,0,0,1,1,1,2,5.33,1.5,12,0,4,0.67,0.67,1,3,1,3,2,0
1,0,0,1,1,1,2,5.33,1.5,12,0,4,0.67,0.67,1,3,1,3,2,0
1,0,0,1,1,1,2,5.33,1.5,12,0,4,0.67,0.67,1,3,1,3,2,0
1,0,0,1,1,1,2,5.33,1.5,12,0,4,0.67,0.67,1,3,1,3,2,0
1,0,0,1,1,1,2,5.33,1.5,12,0,4,0.67,0.67,1,3,1,3,2,0
1,0,0,1,1,1,2,5.33,1.5,12,0,4,0.67,0.67,1,3,1,3,2,0
1,0,0,1,1,1,2,5.33,1.5,12,0,4,0.67,0.67,1,3,1,3,2,0
1,0,0,1,1,1,2,5.33,1.5,12,0,4,0.67,0.67,1,3,1,3,2,0
1,0,0,1,1,1,2,5.33,1.5,12,0,4,0.67,0.67,1,3,1,3,2,0
1,0,0,1,1,1,2,5.33,1.5,12,0,4,0.67,0.67,1,3,1,3,2,0
1,0,0,1,1,1,2,5.33,1.5,12,0,4,0.67,0.67,1,3,1,3,2,0
1,0,0,1,1,1,2,5.33,1.5,12,0,4,0.67,0.67,1,3,1,3,2,0
1,0,0,1,1,1,2,5.33,1.5,12,0,4,0.67,0.67,1,3,1,3,2,0
1,0,0,1,1,1,2,5.33,1.5,12,0,4,0.67,0.67,1,3,1,3,2,0
1,0,0,1,1,1,2,5.33,1.5,12,0,4,0.67,0.67,1,3,1,3,2,0
1,0,0,1,1,1,2,5.33,1.5,12,0,4,0.67,0.67,1,3,1,3,2,0
1,0,0,1,1,1,2,5.33,1.5,12,0,4,0.67,0.67,1,3,1,3,2,0
1,0,0,1,1,1,2,5.33,1.5,12,0,4,0.67,0.67,1,3,1,3,2,0
1,0,0,1,1,1,2,5.33,1.5,12,0,4,0.67,0.67,1,3,1,3,2,0
1,0,0,1,1,1,2,5.33,1.5,12,0,4,0.67,0.67,1,3,1,3,2,0
1,0,0,1,1,1,2,5.33,1.5,12,0,4,0.67,0.67,1,3,1,3,2,0
1,0,0,1,1,1,2,5.33,1.5,12,0,4,0.67,0.67,1,3,1,3,2,0
1,0,0,1,1,1,2,5.33,1.5,12,0,4,0.67,0.67,1,3,1,3,2,0
1,0,0,1,1,1,2,5.33,1.5,12,0,4,0.67,0.67,1,3,1,3,2,0
1,0,0,1,1,1,2,5.33,1.5,12,0,4,0.67,0.67,1,3,1,3,2,0
1,0,0,1,1,1,2,5.33,1.5,12,0,4,0.67,0.67,1,3,1,3,2,0
1,0,0,1,1,1,2,5.33,1.5,12,0,4,0.67,0.67,1,3,1,3,2,0
1,0,0,1,1,1,2,5.33,1.5,12,0,4,0.67,0.67,1,3,1,3,2,0
1,0,0,1,1,1,2,5.33,1.5,12,0,4,0.67,0.67,1,3,1,3,2,0
1,0,0,1,1,1,2,5.33,1.5,12,0,4,0.67,0.67,1,3,1,3,2,0
1,0,0,1,1,1,2,5.33,1.5,12,0,4,0.67,0.67,1,3,1,3,2,0
3,0,2,2,1,1,14,54.22,4.42,1059.83,0.08,51,0.23,58.88,24,27,19,7,14,1
29,1,13,15,12,8,62,50.83,23.28,27538.31,0.39,213,0.04,1529.91,75,138,29,18,63,1
15,0,2,8,1,1,41,31.08,21.88,14882.57,0.23,140,0.05,826.81,62,78,17,12,41,1
1,0,0,1,1,1,2,7.74,1.5,17.41,0,5,0.67,0.97,2,3,2,3,2,0
1,0,0,1,1,1,2,7.74,1.5,17.41,0,5,0.67,0.97,2,3,2,3,2,0
1,0,0,1,1,1,2,7.74,1.5,17.41,0,5,0.67,0.97,2,3,2,3,2,0
1,0,0,1,1,1,2,7.74,1.5,17.41,0,5,0.67,0.97,2,3,2,3,2,0
1,0,0,1,1,1,2,7.74,1.5,17.41,0,5,0.67,0.97,2,3,2,3,2,0
1,0,0,1,1,1,2,7.74,1.5,17.41,0,5,0.67,0.97,2,3,2,3,2,0
1,0,0,1,1,1,2,7.74,1.5,17.41,0,5,0.67,0.97,2,3,2,3,2,0
1,0,0,1,1,1,2,7.74,1.5,17.41,0,5,0.67,0.97,2,3,2,3,2,0
1,0,0,1,1,1,2,7.74,1.5,17.41,0,5,0.67,0.97,2,3,2,3,2,0
1,0,0,1,1,1,2,7.74,1.5,17.41,0,5,0.67,0.97,2,3,2,3,2,0
1,0,0,1,1,1,2,7.74,1.5,17.41,0,5,0.67,0.97,2,3,2,3,2,0
1,0,0,1,1,1,2,7.74,1.5,17.41,0,5,0.67,0.97,2,3,2,3,2,0
1,0,0,1,1,1,2,7.74,1.5,17.41,0,5,0.67,0.97,2,3,2,3,2,0
1,0,0,1,1,1,2,7.74,1.5,17.41,0,5,0.67,0.97,2,3,2,3,2,0
1,0,0,1,1,1,2,7.74,1.5,17.41,0,5,0.67,0.97,2,3,2,3,2,0
1,0,0,1,1,1,2,7.74,1.5,17.41,0,5,0.67,0.97,2,3,2,3,2,0
1,0,0,1,1,1,2,7.74,1.5,17.41,0,5,0.67,0.97,2,3,2,3,2,0
1,0,0,1,1,1,2,7.74,1.5,17.41,0,5,0.67,0.97,2,3,2,3,2,0
1,0,0,1,1,1,2,7.74,1.5,17.41,0,5,0.67,0.97,2,3,2,3,2,0
1,0,0,1,1,1,2,7.74,1.5,17.41,0,5,0.67,0.97,2,3,2,3,2,0
1,0,0,1,1,1,2,7.74,1.5,17.41,0,5,0.67,0.97,2,3,2,3,2,0
1,0,0,1,1,1,2,7.74,1.5,17.41,0,5,0.67,0.97,2,3,2,3,2,0
1,0,0,1,1,1,2,7.74,1.5,17.41,0,5,0.67,0.97,2,3,2,3,2,0
1,0,0,1,1,1,2,7.74,1.5,17.41,0,5,0.67,0.97,2,3,2,3,2,0
1,0,0,1,1,1,2,7.74,1.5,17.41,0,5,0.67,0.97,2,3,2,3,2,0
1,0,0,1,1,1,2,7.74,1.5,17.41,0,5,0.67,0.97,2,3,2,3,2,0
1,0,0,1,1,1,0,0,0,0,0,1,0,0,0,1,0,1,0,0
1,0,0,1,1,1,2,5.33,1.5,12,0,4,0.67,0.67,1,3,1,3,2,0
1,0,0,1,1,1,2,5.33,1.5,12,0,4,0.67,0.67,1,3,1,3,2,0
1,0,0,1,1,1,2,5.33,1.5,12,0,4,0.67,0.67,1,3,1,3,2,0
15,1,8,8,1,8,17,28.13,9.17,2363.56,0.09,57,0.11,131.31,20,37,12,11,18,0
11,0,7,6,2,6,12,24.28,9,1966.61,0.07,49,0.11,109.26,18,31,11,11,12,1
1,0,0,1,1,1,0,0,0,0,0,1,0,0,0,1,0,1,0,0
1,0,0,1,1,1,2,5.33,1.5,12,0,4,0.67,0.67,1,3,1,3,2,0
1,0,0,1,1,1,2,5.33,1.5,12,0,4,0.67,0.67,1,3,1,3,2,0
1,0,0,1,1,1,2,5.33,1.5,12,0,4,0.67,0.67,1,3,1,3,2,0
1,0,0,1,1,1,2,5.33,1.5,12,0,4,0.67,0.67,1,3,1,3,2,0
1,0,0,1,1,1,2,5.33,1.5,12,0,4,0.67,0.67,1,3,1,3,2,0
1,0,0,1,1,1,2,5.33,1.5,12,0,4,0.67,0.67,1,3,1,3,2,0
1,0,0,1,1,1,2,7.74,1.5,17.41,0,5,0.67,0.97,2,3,2,3,2,0
3,0,1,2,1,1,18,20.37,7,998.37,0.05,33,0.14,55.46,21,12,12,8,18,1
1,0,0,1,1,1,0,0,0,0,0,1,0,0,0,1,0,1,0,0
1,0,0,1,1,1,2,5.33,1.5,12,0,4,0.67,0.67,1,3,1,3,2,0
1,0,0,1,1,1,2,5.33,1.5,12,0,4,0.67,0.67,1,3,1,3,2,0
1,0,0,1,1,1,2,5.33,1.5,12,0,4,0.67,0.67,1,3,1,3,2,0
1,0,0,1,1,1,2,5.33,1.5,12,0,4,0.67,0.67,1,3,1,3,2,0
1,0,0,1,1,1,2,5.33,1.5,12,0,4,0.67,0.67,1,3,1,3,2,0
1,0,0,1,1,1,2,7.74,1.5,17.41,0,5,0.67,0.97,2,3,2,3,2,0
1,0,0,1,1,1,2,7.74,1.5,17.41,0,5,0.67,0.97,2,3,2,3,2,0
1,0,0,1,1,1,2,7.74,1.5,17.41,0,5,0.67,0.97,2,3,2,3,2,0
1,0,0,1,1,1,2,7.74,1.5,17.41,0,5,0.67,0.97,2,3,2,3,2,0
1,0,0,1,1,1,2,7.74,1.5,17.41,0,5,0.67,0.97,2,3,2,3,2,0
1,0,0,1,1,1,2,7.74,1.5,17.41,0,5,0.67,0.97,2,3,2,3,2,0
1,0,0,1,1,1,0,0,0,0,0,0,0,0,0,0,0,0,0,0
1,0,0,1,1,1,2,7.74,1.5,17.41,0,5,0.67,0.97,2,3,2,3,2,0
1,0,0,1,1,1,2,7.74,1.5,17.41,0,5,0.67,0.97,2,3,2,3,2,0
1,0,0,1,1,1,2,7.74,1.5,17.41,0,5,0.67,0.97,2,3,2,3,2,0
1,0,0,1,1,1,0,0,0,0,0,1,0,0,0,1,0,1,0,0
1,0,0,1,1,1,2,5.33,1.5,12,0,4,0.67,0.67,1,3,1,3,2,0
1,0,0,1,1,1,2,5.33,1.5,12,0,4,0.67,0.67,1,3,1,3,2,0
1,0,0,1,1,1,2,5.33,1.5,12,0,4,0.67,0.67,1,3,1,3,2,0
1,0,0,1,1,1,2,5.33,1.5,12,0,4,0.67,0.67,1,3,1,3,2,0
1,0,0,1,1,1,6,51.81,1.5,116.56,0.03,21,0.67,6.48,10,11,10,3,6,0
1,0,0,1,1,1,2,5.33,1.5,12,0,4,0.67,0.67,1,3,1,3,2,0
3,0,0,2,1,1,10,15,10.08,1524.96,0.05,37,0.1,84.72,11,26,6,11,10,0
23,1,45,12,1,9,25,14.1,25.14,8911.73,0.12,85,0.04,495.1,32,53,7,11,26,0
1,0,0,1,1,1,7,14.48,1.25,22.62,0.01,7,0.8,1.26,5,2,4,2,7,0
1,0,0,1,1,1,2,7.74,1.5,17.41,0,5,0.67,0.97,2,3,2,3,2,0
1,0,0,1,1,1,2,7.74,1.5,17.41,0,5,0.67,0.97,2,3,2,3,2,0
1,0,0,1,1,1,2,7.74,1.5,17.41,0,5,0.67,0.97,2,3,2,3,2,0
1,0,0,1,1,1,2,7.74,1.5,17.41,0,5,0.67,0.97,2,3,2,3,2,0
1,0,0,1,1,1,6,51.81,1.5,116.56,0.03,21,0.67,6.48,10,11,10,3,6,0
1,0,0,1,1,1,2,7.74,1.5,17.41,0,5,0.67,0.97,2,3,2,3,2,0
1,0,1,1,1,1,13,30.27,6.29,1195.97,0.06,55,0.16,66.44,22,33,7,4,13,0
1,0,0,1,1,1,2,7.74,1.5,17.41,0,5,0.67,0.97,2,3,2,3,2,0
1,0,0,1,1,1,0,0,0,0,0,0,0,0,0,0,0,0,0,0
1,0,0,1,1,1,0,0,0,0,0,1,0,0,0,1,0,1,0,0
1,0,0,1,1,1,2,5.33,1.5,12,0,4,0.67,0.67,1,3,1,3,2,0
1,0,0,1,1,1,2,5.33,1.5,12,0,4,0.67,0.67,1,3,1,3,2,0
1,0,0,1,1,1,2,5.33,1.5,12,0,4,0.67,0.67,1,3,1,3,2,0
1,0,0,1,1,1,2,5.33,1.5,12,0,4,0.67,0.67,1,3,1,3,2,0
1,0,0,1,1,1,2,5.33,1.5,12,0,4,0.67,0.67,1,3,1,3,2,0
1,0,0,1,1,1,2,7.74,1.5,17.41,0,5,0.67,0.97,2,3,2,3,2,0
1,0,0,1,1,1,2,7.74,1.5,17.41,0,5,0.67,0.97,2,3,2,3,2,0
1,0,0,1,1,1,2,7.74,1.5,17.41,0,5,0.67,0.97,2,3,2,3,2,0
1,0,0,1,1,1,2,7.74,1.5,17.41,0,5,0.67,0.97,2,3,2,3,2,0
1,0,0,1,1,1,2,7.74,1.5,17.41,0,5,0.67,0.97,2,3,2,3,2,0
1,0,0,1,1,1,2,7.74,1.5,17.41,0,5,0.67,0.97,2,3,2,3,2,0
13,2,14,7,7,6,24,26.99,18.92,9666.37,0.17,110,0.05,537.02,41,69,13,12,26,0
3,0,0,2,2,1,6,5.89,7,288.46,0.01,13,0.14,16.03,4,9,2,7,6,0
9,6,10,5,1,1,14,10.12,23,5354.23,0.08,53,0.04,297.46,23,30,7,14,20,0
19,11,4,10,1,4,31,17.21,48.23,40031.54,0.28,166,0.02,2223.97,66,100,13,19,42,0
97,0,4,49,1,1,291,303.55,25.59,198748.74,2.59,1141,0.04,11041.6,522,619,102,10,291,0
3,0,0,2,1,1,6,7.75,6,279.04,0.02,14,0.17,15.5,8,6,4,6,6,0
19,4,8,10,6,1,43,16.18,70,79296.42,0.38,241,0.01,4405.36,120,121,12,14,47,0
1,0,0,1,1,1,2,7.74,1.5,17.41,0,5,0.67,0.97,2,3,2,3,2,0
1,0,0,1,1,1,0,0,0,0,0,0,0,0,0,0,0,0,0,0
1,0,0,1,1,1,0,0,0,0,0,1,0,0,0,1,0,1,0,0
1,0,0,1,1,1,2,5.33,1.5,12,0,4,0.67,0.67,1,3,1,3,2,0
1,0,0,1,1,1,2,5.33,1.5,12,0,4,0.67,0.67,1,3,1,3,2,0
1,0,0,1,1,1,2,5.33,1.5,12,0,4,0.67,0.67,1,3,1,3,2,0
1,0,0,1,1,1,2,5.33,1.5,12,0,4,0.67,0.67,1,3,1,3,2,0
1,0,0,1,1,1,2,5.33,1.5,12,0,4,0.67,0.67,1,3,1,3,2,0
1,0,0,1,1,1,2,7.74,1.5,17.41,0,5,0.67,0.97,2,3,2,3,2,0
1,0,0,1,1,1,2,7.74,1.5,17.41,0,5,0.67,0.97,2,3,2,3,2,0
1,0,0,1,1,1,2,7.74,1.5,17.41,0,5,0.67,0.97,2,3,2,3,2,0
1,0,0,1,1,1,2,7.74,1.5,17.41,0,5,0.67,0.97,2,3,2,3,2,0
1,0,0,1,1,1,2,7.74,1.5,17.41,0,5,0.67,0.97,2,3,2,3,2,0
1,0,0,1,1,1,2,7.74,1.5,17.41,0,5,0.67,0.97,2,3,2,3,2,0
3,0,0,2,1,1,6,7.75,6,279.04,0.02,14,0.17,15.5,8,6,4,6,6,0
1,0,0,1,1,1,2,7.74,1.5,17.41,0,5,0.67,0.97,2,3,2,3,2,0
3,0,0,2,2,1,7,7.65,7.5,430.2,0.02,16,0.13,23.9,5,11,3,9,7,0
1,0,0,1,1,1,0,0,0,0,0,0,0,0,0,0,0,0,0,0
1,0,0,1,1,1,0,0,0,0,0,1,0,0,0,1,0,1,0,0
1,0,0,1,1,1,0,0,0,0,0,1,0,0,0,1,0,1,0,0
1,0,0,1,1,1,0,0,0,0,0,1,0,0,0,1,0,1,0,0
9,3,0,5,5,4,4,6.95,27.62,5307.06,0.06,47,0.04,294.84,17,30,4,13,7,0
1,0,0,1,1,1,2,5.33,1.5,12,0,4,0.67,0.67,1,3,1,3,2,0
1,0,0,1,1,1,4,10.44,3.5,127.89,0.01,11,0.29,7.11,3,8,3,7,4,0
1,0,1,1,1,1,2,7.49,3,67.38,0.01,8,0.33,3.74,1,7,1,6,2,0
1,0,0,1,1,1,2,13.18,5.25,363.24,0.02,20,0.19,20.18,6,14,4,7,2,0
1,0,0,1,1,1,2,5.33,1.5,12,0,4,0.67,0.67,1,3,1,3,2,0
1,0,0,1,1,1,2,5.33,1.5,12,0,4,0.67,0.67,1,3,1,3,2,0
1,0,0,1,1,1,2,5.33,1.5,12,0,4,0.67,0.67,1,3,1,3,2,0
1,0,0,1,1,1,4,27.47,1.5,61.81,0.01,13,0.67,3.43,6,7,6,3,4,0
1,0,0,1,1,1,2,11.3,6.13,423.78,0.02,20,0.16,23.54,7,13,4,7,2,0
1,0,0,1,1,1,0,0,0,0,0,1,0,0,0,1,0,1,0,0
1,0,0,1,1,1,2,5.33,1.5,12,0,4,0.67,0.67,1,3,1,3,2,0
1,0,0,1,1,1,2,5.33,1.5,12,0,4,0.67,0.67,1,3,1,3,2,0
1,0,0,1,1,1,2,5.33,1.5,12,0,4,0.67,0.67,1,3,1,3,2,0
1,0,0,1,1,1,2,5.33,1.5,12,0,4,0.67,0.67,1,3,1,3,2,0
1,0,0,1,1,1,2,5.33,1.5,12,0,4,0.67,0.67,1,3,1,3,2,0
1,0,0,1,1,1,2,5.33,1.5,12,0,4,0.67,0.67,1,3,1,3,2,0
1,0,0,1,1,1,2,5.33,1.5,12,0,4,0.67,0.67,1,3,1,3,2,0
1,0,0,1,1,1,2,5.33,1.5,12,0,4,0.67,0.67,1,3,1,3,2,0
1,0,0,1,1,1,2,5.33,1.5,12,0,4,0.67,0.67,1,3,1,3,2,0
1,0,0,1,1,1,2,5.33,1.5,12,0,4,0.67,0.67,1,3,1,3,2,0
1,0,0,1,1,1,2,5.33,1.5,12,0,4,0.67,0.67,1,3,1,3,2,0
1,0,0,1,1,1,2,5.33,1.5,12,0,4,0.67,0.67,1,3,1,3,2,0
1,0,0,1,1,1,2,5.33,1.5,12,0,4,0.67,0.67,1,3,1,3,2,0
1,1,0,1,1,1,12,55.45,3.54,694.24,0.07,48,0.28,38.57,23,25,13,4,13,0
1,0,0,1,1,1,0,0,0,0,0,1,0,0,0,1,0,1,0,0
1,0,0,1,1,1,2,5.33,1.5,12,0,4,0.67,0.67,1,3,1,3,2,0
1,0,0,1,1,1,2,5.33,1.5,12,0,4,0.67,0.67,1,3,1,3,2,0
1,0,0,1,1,1,2,5.33,1.5,12,0,4,0.67,0.67,1,3,1,3,2,0
1,0,0,1,1,1,2,5.33,1.5,12,0,4,0.67,0.67,1,3,1,3,2,0
1,0,0,1,1,1,2,5.33,1.5,12,0,4,0.67,0.67,1,3,1,3,2,0
1,0,0,1,1,1,2,5.33,1.5,12,0,4,0.67,0.67,1,3,1,3,2,0
1,0,0,1,1,1,2,5.33,1.5,12,0,4,0.67,0.67,1,3,1,3,2,0
1,0,0,1,1,1,2,5.33,1.5,12,0,4,0.67,0.67,1,3,1,3,2,0
1,0,0,1,1,1,2,5.33,1.5,12,0,4,0.67,0.67,1,3,1,3,2,0
1,0,0,1,1,1,2,5.33,1.5,12,0,4,0.67,0.67,1,3,1,3,2,0
1,0,0,1,1,1,2,5.33,1.5,12,0,4,0.67,0.67,1,3,1,3,2,0
1,0,0,1,1,1,2,5.33,1.5,12,0,4,0.67,0.67,1,3,1,3,2,0
1,0,0,1,1,1,2,5.33,1.5,12,0,4,0.67,0.67,1,3,1,3,2,0
1,0,0,1,1,1,2,5.33,1.5,12,0,4,0.67,0.67,1,3,1,3,2,0
1,0,0,1,1,1,2,5.33,1.5,12,0,4,0.67,0.67,1,3,1,3,2,0
1,0,0,1,1,1,2,5.33,1.5,12,0,4,0.67,0.67,1,3,1,3,2,0
1,0,0,1,1,1,2,5.33,1.5,12,0,4,0.67,0.67,1,3,1,3,2,0
1,0,0,1,1,1,2,5.33,1.5,12,0,4,0.67,0.67,1,3,1,3,2,0
1,0,0,1,1,1,0,0,0,0,0,1,0,0,0,1,0,1,0,0
1,0,0,1,1,1,2,5.33,1.5,12,0,4,0.67,0.67,1,3,1,3,2,0
1,0,0,1,1,1,2,5.33,1.5,12,0,4,0.67,0.67,1,3,1,3,2,0
1,0,0,1,1,1,2,5.33,1.5,12,0,4,0.67,0.67,1,3,1,3,2,0
1,0,0,1,1,1,2,5.33,1.5,12,0,4,0.67,0.67,1,3,1,3,2,0
1,0,0,1,1,1,2,5.33,1.5,12,0,4,0.67,0.67,1,3,1,3,2,0
1,0,0,1,1,1,2,5.33,1.5,12,0,4,0.67,0.67,1,3,1,3,2,0
1,0,0,1,1,1,3,11.63,2,46.53,0.01,9,0.5,2.58,4,5,3,3,3,0
1,0,0,1,1,1,2,7.75,2,31.02,0.01,6,0.5,1.72,2,4,2,4,2,0
1,0,0,1,1,1,2,5.33,1.5,12,0,4,0.67,0.67,1,3,1,3,2,0
1,0,0,1,1,1,2,5.33,1.5,12,0,4,0.67,0.67,1,3,1,3,2,0
1,0,0,1,1,1,2,5.33,1.5,12,0,4,0.67,0.67,1,3,1,3,2,0
1,0,0,1,1,1,2,5.33,1.5,12,0,4,0.67,0.67,1,3,1,3,2,0
1,0,0,1,1,1,2,5.33,1.5,12,0,4,0.67,0.67,1,3,1,3,2,0
1,0,0,1,1,1,2,5.33,1.5,12,0,4,0.67,0.67,1,3,1,3,2,0
1,0,0,1,1,1,2,5.33,1.5,12,0,4,0.67,0.67,1,3,1,3,2,0
1,0,0,1,1,1,2,5.33,1.5,12,0,4,0.67,0.67,1,3,1,3,2,0
1,0,0,1,1,1,2,5.33,1.5,12,0,4,0.67,0.67,1,3,1,3,2,0
1,0,0,1,1,1,2,5.33,1.5,12,0,4,0.67,0.67,1,3,1,3,2,0
1,0,0,1,1,1,2,5.33,1.5,12,0,4,0.67,0.67,1,3,1,3,2,0
1,0,0,1,1,1,2,5.33,1.5,12,0,4,0.67,0.67,1,3,1,3,2,0
1,0,0,1,1,1,2,5.33,1.5,12,0,4,0.67,0.67,1,3,1,3,2,0
1,0,0,1,1,1,2,5.33,1.5,12,0,4,0.67,0.67,1,3,1,3,2,0
1,0,0,1,1,1,2,5.33,1.5,12,0,4,0.67,0.67,1,3,1,3,2,0
1,0,0,1,1,1,2,5.33,1.5,12,0,4,0.67,0.67,1,3,1,3,2,0
1,0,0,1,1,1,2,5.33,1.5,12,0,4,0.67,0.67,1,3,1,3,2,0
1,0,0,1,1,1,2,5.33,1.5,12,0,4,0.67,0.67,1,3,1,3,2,0
1,0,0,1,1,1,2,5.33,1.5,12,0,4,0.67,0.67,1,3,1,3,2,0
1,0,0,1,1,1,2,5.33,1.5,12,0,4,0.67,0.67,1,3,1,3,2,0
1,0,0,1,1,1,2,5.33,1.5,12,0,4,0.67,0.67,1,3,1,3,2,0
1,0,0,1,1,1,2,5.33,1.5,12,0,4,0.67,0.67,1,3,1,3,2,0
1,0,0,1,1,1,2,5.33,1.5,12,0,4,0.67,0.67,1,3,1,3,2,0
1,0,0,1,1,1,2,5.33,1.5,12,0,4,0.67,0.67,1,3,1,3,2,0
1,0,0,1,1,1,2,5.33,1.5,12,0,4,0.67,0.67,1,3,1,3,2,0
1,0,0,1,1,1,2,5.33,1.5,12,0,4,0.67,0.67,1,3,1,3,2,0
1,0,0,1,1,1,2,5.33,1.5,12,0,4,0.67,0.67,1,3,1,3,2,0
1,0,0,1,1,1,2,5.33,1.5,12,0,4,0.67,0.67,1,3,1,3,2,0
1,0,0,1,1,1,2,5.33,1.5,12,0,4,0.67,0.67,1,3,1,3,2,0
1,0,0,1,1,1,2,5.33,1.5,12,0,4,0.67,0.67,1,3,1,3,2,0
1,0,0,1,1,1,2,5.33,1.5,12,0,4,0.67,0.67,1,3,1,3,2,0
1,0,0,1,1,1,2,5.33,1.5,12,0,4,0.67,0.67,1,3,1,3,2,0
1,0,0,1,1,1,2,5.33,1.5,12,0,4,0.67,0.67,1,3,1,3,2,0
1,0,0,1,1,1,2,5.33,1.5,12,0,4,0.67,0.67,1,3,1,3,2,0
1,0,0,1,1,1,2,5.33,1.5,12,0,4,0.67,0.67,1,3,1,3,2,0
1,0,0,1,1,1,2,5.33,1.5,12,0,4,0.67,0.67,1,3,1,3,2,0
1,0,0,1,1,1,2,5.33,1.5,12,0,4,0.67,0.67,1,3,1,3,2,0
1,0,0,1,1,1,2,5.33,1.5,12,0,4,0.67,0.67,1,3,1,3,2,0
1,0,0,1,1,1,2,5.33,1.5,12,0,4,0.67,0.67,1,3,1,3,2,0
1,0,0,1,1,1,2,5.33,1.5,12,0,4,0.67,0.67,1,3,1,3,2,0
1,0,0,1,1,1,2,5.33,1.5,12,0,4,0.67,0.67,1,3,1,3,2,0
1,0,0,1,1,1,2,5.33,1.5,12,0,4,0.67,0.67,1,3,1,3,2,0
1,0,0,1,1,1,2,5.33,1.5,12,0,4,0.67,0.67,1,3,1,3,2,0
9,0,9,5,2,1,39,31.15,11.6,4191.91,0.12,76,0.09,232.88,29,47,15,12,39,0
1,0,0,1,1,1,2,7.74,1.5,17.41,0,5,0.67,0.97,2,3,2,3,2,0
1,0,0,1,1,1,2,7.74,1.5,17.41,0,5,0.67,0.97,2,3,2,3,2,0
1,0,0,1,1,1,2,7.74,1.5,17.41,0,5,0.67,0.97,2,3,2,3,2,0
1,0,0,1,1,1,2,7.74,1.5,17.41,0,5,0.67,0.97,2,3,2,3,2,0
1,0,0,1,1,1,2,7.74,1.5,17.41,0,5,0.67,0.97,2,3,2,3,2,0
1,0,0,1,1,1,2,7.74,1.5,17.41,0,5,0.67,0.97,2,3,2,3,2,0
1,0,0,1,1,1,2,7.74,1.5,17.41,0,5,0.67,0.97,2,3,2,3,2,0
1,0,0,1,1,1,2,7.74,1.5,17.41,0,5,0.67,0.97,2,3,2,3,2,0
1,0,0,1,1,1,2,7.74,1.5,17.41,0,5,0.67,0.97,2,3,2,3,2,0
1,0,0,1,1,1,2,7.74,1.5,17.41,0,5,0.67,0.97,2,3,2,3,2,0
1,0,0,1,1,1,2,7.74,1.5,17.41,0,5,0.67,0.97,2,3,2,3,2,0
1,0,0,1,1,1,2,7.74,1.5,17.41,0,5,0.67,0.97,2,3,2,3,2,0
1,0,0,1,1,1,2,7.74,1.5,17.41,0,5,0.67,0.97,2,3,2,3,2,0
1,0,0,1,1,1,2,7.74,1.5,17.41,0,5,0.67,0.97,2,3,2,3,2,0
1,0,0,1,1,1,2,7.74,1.5,17.41,0,5,0.67,0.97,2,3,2,3,2,0
1,0,0,1,1,1,2,7.74,1.5,17.41,0,5,0.67,0.97,2,3,2,3,2,0
1,0,0,1,1,1,2,7.74,1.5,17.41,0,5,0.67,0.97,2,3,2,3,2,0
1,0,0,1,1,1,2,7.74,1.5,17.41,0,5,0.67,0.97,2,3,2,3,2,0
1,0,0,1,1,1,2,7.74,1.5,17.41,0,5,0.67,0.97,2,3,2,3,2,0
1,0,0,1,1,1,2,7.74,1.5,17.41,0,5,0.67,0.97,2,3,2,3,2,0
1,0,0,1,1,1,2,7.74,1.5,17.41,0,5,0.67,0.97,2,3,2,3,2,0
1,0,0,1,1,1,2,7.74,1.5,17.41,0,5,0.67,0.97,2,3,2,3,2,0
1,0,0,1,1,1,2,7.74,1.5,17.41,0,5,0.67,0.97,2,3,2,3,2,0
1,0,0,1,1,1,2,7.74,1.5,17.41,0,5,0.67,0.97,2,3,2,3,2,0
1,0,0,1,1,1,2,7.74,1.5,17.41,0,5,0.67,0.97,2,3,2,3,2,0
1,0,0,1,1,1,2,7.74,1.5,17.41,0,5,0.67,0.97,2,3,2,3,2,0
1,0,0,1,1,1,0,0,0,0,0,1,0,0,0,1,0,1,0,0
1,0,0,1,1,1,2,5.33,1.5,12,0,4,0.67,0.67,1,3,1,3,2,0
1,0,0,1,1,1,2,5.33,1.5,12,0,4,0.67,0.67,1,3,1,3,2,0
1,0,0,1,1,1,2,5.33,1.5,12,0,4,0.67,0.67,1,3,1,3,2,0
15,2,8,8,1,8,16,30.5,8.33,2118.23,0.08,57,0.12,117.68,20,37,12,10,18,0
9,0,5,5,1,5,9,23.63,6,850.66,0.05,34,0.17,47.26,12,22,9,9,9,0
1,0,0,1,1,1,0,0,0,0,0,1,0,0,0,1,0,1,0,0
1,0,0,1,1,1,2,5.33,1.5,12,0,4,0.67,0.67,1,3,1,3,2,0
1,0,0,1,1,1,2,5.33,1.5,12,0,4,0.67,0.67,1,3,1,3,2,0
1,0,0,1,1,1,2,5.33,1.5,12,0,4,0.67,0.67,1,3,1,3,2,0
1,0,0,1,1,1,2,5.33,1.5,12,0,4,0.67,0.67,1,3,1,3,2,0
1,0,0,1,1,1,2,5.33,1.5,12,0,4,0.67,0.67,1,3,1,3,2,0
1,0,0,1,1,1,2,5.33,1.5,12,0,4,0.67,0.67,1,3,1,3,2,0
1,0,0,1,1,1,2,7.74,1.5,17.41,0,5,0.67,0.97,2,3,2,3,2,0
1,0,0,1,1,1,0,0,0,0,0,1,0,0,0,1,0,1,0,0
1,0,0,1,1,1,2,5.33,1.5,12,0,4,0.67,0.67,1,3,1,3,2,0
1,0,0,1,1,1,2,5.33,1.5,12,0,4,0.67,0.67,1,3,1,3,2,0
1,0,0,1,1,1,2,5.33,1.5,12,0,4,0.67,0.67,1,3,1,3,2,0
1,0,0,1,1,1,2,5.33,1.5,12,0,4,0.67,0.67,1,3,1,3,2,0
1,0,0,1,1,1,2,5.33,1.5,12,0,4,0.67,0.67,1,3,1,3,2,0
1,0,0,1,1,1,2,7.74,1.5,17.41,0,5,0.67,0.97,2,3,2,3,2,0
1,0,0,1,1,1,2,7.74,1.5,17.41,0,5,0.67,0.97,2,3,2,3,2,0
1,0,0,1,1,1,2,7.74,1.5,17.41,0,5,0.67,0.97,2,3,2,3,2,0
1,0,0,1,1,1,2,7.74,1.5,17.41,0,5,0.67,0.97,2,3,2,3,2,0
1,0,0,1,1,1,2,7.74,1.5,17.41,0,5,0.67,0.97,2,3,2,3,2,0
1,0,0,1,1,1,4,15.85,2,63.4,0.01,10,0.5,3.52,5,5,5,4,4,0
1,0,0,1,1,1,2,7.74,1.5,17.41,0,5,0.67,0.97,2,3,2,3,2,0
1,0,0,1,1,1,0,0,0,0,0,0,0,0,0,0,0,0,0,0
1,0,0,1,1,1,2,7.74,1.5,17.41,0,5,0.67,0.97,2,3,2,3,2,0
1,0,0,1,1,1,2,7.74,1.5,17.41,0,5,0.67,0.97,2,3,2,3,2,0
1,0,0,1,1,1,2,7.74,1.5,17.41,0,5,0.67,0.97,2,3,2,3,2,0
1,0,0,1,1,1,0,0,0,0,0,1,0,0,0,1,0,1,0,0
1,0,0,1,1,1,2,5.33,1.5,12,0,4,0.67,0.67,1,3,1,3,2,0
1,0,0,1,1,1,2,5.33,1.5,12,0,4,0.67,0.67,1,3,1,3,2,0
1,0,0,1,1,1,2,5.33,1.5,12,0,4,0.67,0.67,1,3,1,3,2,0
1,0,0,1,1,1,2,5.33,1.5,12,0,4,0.67,0.67,1,3,1,3,2,0
1,0,0,1,1,1,2,5.33,1.5,12,0,4,0.67,0.67,1,3,1,3,2,0
1,0,0,1,1,1,2,7.74,1.5,17.41,0,5,0.67,0.97,2,3,2,3,2,0
1,0,0,1,1,1,2,7.74,1.5,17.41,0,5,0.67,0.97,2,3,2,3,2,0
1,0,0,1,1,1,2,7.74,1.5,17.41,0,5,0.67,0.97,2,3,2,3,2,0
1,0,0,1,1,1,2,7.74,1.5,17.41,0,5,0.67,0.97,2,3,2,3,2,0
1,0,0,1,1,1,2,7.74,1.5,17.41,0,5,0.67,0.97,2,3,2,3,2,0
1,0,0,1,1,1,2,7.74,1.5,17.41,0,5,0.67,0.97,2,3,2,3,2,0
3,0,0,2,2,1,7,7.65,7.5,430.2,0.02,16,0.13,23.9,5,11,3,9,7,0
1,0,0,1,1,1,0,0,0,0,0,0,0,0,0,0,0,0,0,0
1,0,0,1,1,1,2,7.74,1.5,17.41,0,5,0.67,0.97,2,3,2,3,2,0
1,0,0,1,1,1,2,7.74,1.5,17.41,0,5,0.67,0.97,2,3,2,3,2,0
1,0,0,1,1,1,0,0,0,0,0,0,0,0,0,0,0,0,0,0
1,0,0,1,1,1,0,0,0,0,0,1,0,0,0,1,0,1,0,0
1,0,0,1,1,1,2,5.33,1.5,12,0,4,0.67,0.67,1,3,1,3,2,0
1,0,0,1,1,1,2,5.33,1.5,12,0,4,0.67,0.67,1,3,1,3,2,0
1,0,0,1,1,1,2,5.33,1.5,12,0,4,0.67,0.67,1,3,1,3,2,0
1,0,0,1,1,1,2,5.33,1.5,12,0,4,0.67,0.67,1,3,1,3,2,0
1,0,0,1,1,1,2,5.33,1.5,12,0,4,0.67,0.67,1,3,1,3,2,0
1,0,0,1,1,1,2,7.74,1.5,17.41,0,5,0.67,0.97,2,3,2,3,2,0
1,0,0,1,1,1,2,7.74,1.5,17.41,0,5,0.67,0.97,2,3,2,3,2,0
1,0,0,1,1,1,2,7.74,1.5,17.41,0,5,0.67,0.97,2,3,2,3,2,0
1,0,0,1,1,1,2,7.74,1.5,17.41,0,5,0.67,0.97,2,3,2,3,2,0
1,0,0,1,1,1,2,7.74,1.5,17.41,0,5,0.67,0.97,2,3,2,3,2,0
1,0,0,1,1,1,2,7.74,1.5,17.41,0,5,0.67,0.97,2,3,2,3,2,0
1,0,0,1,1,1,0,0,0,0,0,0,0,0,0,0,0,0,0,0
1,0,0,1,1,1,2,7.74,1.5,17.41,0,5,0.67,0.97,2,3,2,3,2,0
1,3,0,1,1,1,2,27.1,6,975.76,0.05,39,0.17,54.21,15,24,10,8,5,0
3,0,0,2,2,1,6,5.89,7,288.46,0.01,13,0.14,16.03,4,9,2,7,6,0
9,5,1,5,1,4,11,11.26,16.88,3206.07,0.06,42,0.06,178.12,18,24,8,15,16,0
109,0,4,55,2,1,320,289.79,30,260810.72,2.9,1246,0.03,14489.48,570,676,114,12,320,0
5,0,3,3,1,1,17,11.61,10.5,1279.83,0.04,34,0.1,71.1,21,13,6,6,17,0
49,9,52,25,13,6,61,18.7,91.25,155679.37,0.57,330,0.01,8648.85,146,184,16,20,70,0
5,3,0,3,2,1,17,26.97,12.79,4413.97,0.12,69,0.08,245.22,29,40,17,15,20,0
1,0,0,1,1,1,0,0,0,0,0,1,0,0,0,1,0,1,0,0
1,0,0,1,1,1,0,0,0,0,0,1,0,0,0,1,0,1,0,0
15,10,6,9,8,4,47,34.55,38.32,50736.47,0.44,229,0.03,2818.69,99,130,31,24,57,1
13,4,6,7,5,1,36,38.99,24.64,23674.61,0.32,164,0.04,1315.26,75,89,35,23,40,1
5,0,0,3,1,1,2,13.29,4.5,269.08,0.02,18,0.22,14.95,6,12,4,6,2,0
1,0,1,1,1,1,2,16.92,3.5,207.22,0.02,16,0.29,11.51,6,10,6,7,2,0
7,4,1,4,1,1,11,20.36,5.5,616,0.04,28,0.18,34.22,11,17,8,8,15,0
11,2,0,6,2,5,17,21.67,17.6,6713.93,0.13,77,0.06,373,33,44,15,16,19,1
11,1,0,7,2,1,28,26.23,23.82,14889.71,0.21,125,0.04,827.21,54,71,17,15,29,1
11,1,0,6,2,5,12,17.18,19.73,6687.58,0.11,73,0.05,371.53,31,42,11,14,13,1
1,0,0,1,1,1,2,13.88,4,222.03,0.02,15,0.25,12.33,5,10,5,8,2,0
51,22,27,27,14,11,100,55.58,67.06,249946.2,1.24,554,0.01,13885.9,240,314,68,38,122,1
1,0,0,1,1,1,2,0,0,0,0,5,0,0,0,5,0,5,2,0
1,0,0,1,1,1,0,0,0,0,0,5,0,0,0,5,0,5,0,0
1,0,0,1,1,1,0,0,0,0,0,5,0,0,0,5,0,5,0,0
1,0,0,1,1,1,0,0,0,0,0,1,0,0,0,1,0,1,0,0
1,0,0,1,1,1,2,0,0,0,0.01,6,0,0,0,6,0,6,2,0
1,0,0,1,1,1,2,0,0,0,0.01,6,0,0,0,6,0,6,2,0
3,0,0,2,1,1,6,9.71,8,621.67,0.03,21,0.13,34.54,10,11,5,8,6,1
13,13,8,1,1,1,33,45.4,25.58,29694.32,0.39,195,0.04,1649.68,93,102,40,22,46,1
1,0,0,1,1,1,0,0,0,0,0,1,0,0,0,1,0,1,0,0
1,1,0,1,1,1,1,6.2,2.5,38.77,0.01,6,0.4,2.15,1,5,1,5,2,0
1,0,0,1,1,1,2,5.33,1.5,12,0,4,0.67,0.67,1,3,1,3,2,0
1,0,1,1,1,1,2,5.33,1.5,12,0,4,0.67,0.67,1,3,1,3,2,0
9,7,6,5,1,1,28,71.4,13.3,12629.1,0.32,165,0.08,701.62,76,89,40,14,35,1
1,0,0,1,1,1,2,5.33,1.5,12,0,4,0.67,0.67,1,3,1,3,2,0
1,2,0,1,1,1,3,12.6,3.33,140,0.01,14,0.3,7.78,4,10,3,5,5,0
5,3,0,3,3,1,10,15.04,9.43,1336.76,0.05,34,0.11,74.26,12,22,7,11,13,1
1,0,0,1,1,1,2,9.05,2,36.19,0.01,7,0.5,2,2,5,2,4,2,0
1,2,0,1,1,1,2,10.8,2.5,67.5,0.01,9,0.4,3.75,3,6,3,5,4,1
1,0,0,1,1,1,2,20.97,3,188.72,0.02,17,0.33,10.48,7,10,7,6,2,0
1,0,0,1,1,1,2,20.97,3,188.72,0.02,17,0.33,10.48,7,10,7,6,2,0
1,0,0,1,1,1,2,27.35,3,246.13,0.03,21,0.33,13.67,9,12,9,6,2,0
1,0,0,1,1,1,3,30.67,3,276,0.03,23,0.33,15.33,10,13,10,6,3,0
1,0,0,1,1,1,3,30.67,3,276,0.03,23,0.33,15.33,10,13,10,6,3,0
1,0,0,1,1,1,3,30.67,3,276,0.03,23,0.33,15.33,10,13,10,6,3,0
1,0,0,1,1,1,2,27.35,3,246.13,0.03,21,0.33,13.67,9,12,9,6,2,0
1,0,0,1,1,1,3,27.35,3,246.13,0.03,21,0.33,13.67,9,12,9,6,3,0
1,0,0,1,1,1,2,20.97,3,188.72,0.02,17,0.33,10.48,7,10,7,6,2,0
1,0,0,1,1,1,2,20.97,3,188.72,0.02,17,0.33,10.48,7,10,7,6,2,0
1,0,0,1,1,1,2,20.97,3,188.72,0.02,17,0.33,10.48,7,10,7,6,2,0
1,0,0,1,1,1,2,17.92,3,161.32,0.02,15,0.33,8.96,6,9,6,6,2,0
1,0,0,1,1,1,2,17.92,3,161.32,0.02,15,0.33,8.96,6,9,6,6,2,0
1,0,0,1,1,1,2,14.99,3,134.92,0.01,13,0.33,7.5,5,8,5,6,2,0
1,0,0,1,1,1,2,14.99,3,134.92,0.01,13,0.33,7.5,5,8,5,6,2,0
1,0,0,1,1,1,2,14.99,3,134.92,0.01,13,0.33,7.5,5,8,5,6,2,0
1,0,0,1,1,1,2,14.99,3,134.92,0.01,13,0.33,7.5,5,8,5,6,2,0
1,0,0,1,1,1,2,14.99,3,134.92,0.01,13,0.33,7.5,5,8,5,6,2,0
1,0,0,1,1,1,2,17.92,3,161.32,0.02,15,0.33,8.96,6,9,6,6,2,0
1,0,0,1,1,1,2,17.92,3,161.32,0.02,15,0.33,8.96,6,9,6,6,2,0
1,0,0,1,1,1,2,20.97,3,188.72,0.02,17,0.33,10.48,7,10,7,6,2,0
1,0,0,1,1,1,2,20.97,3,188.72,0.02,17,0.33,10.48,7,10,7,6,2,0
1,0,0,1,1,1,2,5.33,1.5,12,0,4,0.67,0.67,1,3,1,3,2,0
1,0,0,1,1,1,2,10.44,3.5,127.89,0.01,11,0.29,7.11,3,8,3,7,2,0
1,0,0,1,1,1,2,10.44,3.5,127.89,0.01,11,0.29,7.11,3,8,3,7,2,0
1,0,0,1,1,1,2,7.49,3,67.38,0.01,8,0.33,3.74,1,7,1,6,2,0
1,0,0,1,1,1,2,9,3,81,0.01,9,0.33,4.5,2,7,2,6,2,0
1,0,0,1,1,1,2,9,3,81,0.01,9,0.33,4.5,2,7,2,6,2,0
1,0,0,1,1,1,2,9,3,81,0.01,9,0.33,4.5,2,7,2,6,2,0
1,0,0,1,1,1,2,10.44,3.5,127.89,0.01,11,0.29,7.11,3,8,3,7,2,0
1,0,0,1,1,1,2,9,3,81,0.01,9,0.33,4.5,2,7,2,6,2,0
1,0,0,1,1,1,2,9,3,81,0.01,9,0.33,4.5,2,7,2,6,2,0
1,0,0,1,1,1,2,7.49,3,67.38,0.01,8,0.33,3.74,1,7,1,6,2,0
1,0,0,1,1,1,2,7.49,3,67.38,0.01,8,0.33,3.74,1,7,1,6,2,0
1,0,0,1,1,1,2,10,3,90,0.01,10,0.33,5,2,8,2,6,2,0
1,0,0,1,1,1,3,10.44,3.5,127.89,0.01,11,0.29,7.11,3,8,3,7,3,0
1,0,0,1,1,1,3,11.39,3.5,139.52,0.01,12,0.29,7.75,3,9,3,7,3,0
1,0,0,1,1,1,2,9,3,81,0.01,9,0.33,4.5,2,7,2,6,2,0
1,0,0,1,1,1,2,10.44,3.5,127.89,0.01,11,0.29,7.11,3,8,3,7,2,0
1,0,0,1,1,1,2,9,3,81,0.01,9,0.33,4.5,2,7,2,6,2,0
1,0,0,1,1,1,2,9,3,81,0.01,9,0.33,4.5,2,7,2,6,2,0
1,0,0,1,1,1,2,10.44,3.5,127.89,0.01,11,0.29,7.11,3,8,3,7,2,0
1,0,0,1,1,1,2,9,3,81,0.01,9,0.33,4.5,2,7,2,6,2,0
1,0,0,1,1,1,2,9,3,81,0.01,9,0.33,4.5,2,7,2,6,2,0
1,0,0,1,1,1,2,9,3,81,0.01,9,0.33,4.5,2,7,2,6,2,0
1,0,0,1,1,1,2,7.49,3,67.38,0.01,8,0.33,3.74,1,7,1,6,2,0
1,0,0,1,1,1,2,9,3,81,0.01,9,0.33,4.5,2,7,2,6,2,0
1,0,0,1,1,1,2,9,3,81,0.01,9,0.33,4.5,2,7,2,6,2,0
1,0,0,1,1,1,2,10.44,3.5,127.89,0.01,11,0.29,7.11,3,8,3,7,2,0
1,0,0,1,1,1,2,9.05,2,36.19,0.01,7,0.5,2,2,5,2,4,2,0
1,0,0,1,1,1,2,9.05,2,36.19,0.01,7,0.5,2,2,5,2,4,2,0
1,0,0,1,1,1,2,9.05,2,36.19,0.01,7,0.5,2,2,5,2,4,2,0
1,0,0,1,1,1,2,9.05,2,36.19,0.01,7,0.5,2,2,5,2,4,2,0
1,0,0,1,1,1,2,9.05,2,36.19,0.01,7,0.5,2,2,5,2,4,2,0
1,0,0,1,1,1,2,9.05,2,36.19,0.01,7,0.5,2,2,5,2,4,2,0
1,0,0,1,1,1,2,9.05,2,36.19,0.01,7,0.5,2,2,5,2,4,2,0
1,0,0,1,1,1,2,9.05,2,36.19,0.01,7,0.5,2,2,5,2,4,2,0
1,0,0,1,1,1,2,9.05,2,36.19,0.01,7,0.5,2,2,5,2,4,2,0
1,0,0,1,1,1,2,9.05,2,36.19,0.01,7,0.5,2,2,5,2,4,2,0
1,0,0,1,1,1,2,9.05,2,36.19,0.01,7,0.5,2,2,5,2,4,2,0
1,0,0,1,1,1,2,9.05,2,36.19,0.01,7,0.5,2,2,5,2,4,2,0
1,0,0,1,1,1,2,9.05,2,36.19,0.01,7,0.5,2,2,5,2,4,2,0
1,0,0,1,1,1,2,10.44,3.5,127.89,0.01,11,0.29,7.11,3,8,3,7,2,0
1,0,0,1,1,1,2,10.44,3.5,127.89,0.01,11,0.29,7.11,3,8,3,7,2,0
1,0,0,1,1,1,2,9.05,2,36.19,0.01,7,0.5,2,2,5,2,4,2,0
1,0,0,1,1,1,0,0,0,0,0,1,0,0,0,1,0,1,0,0
1,0,0,1,1,1,2,5.33,1.5,12,0,4,0.67,0.67,1,3,1,3,2,0
3,0,0,2,1,1,6,11.86,4.38,227.03,0.02,15,0.23,12.61,5,10,4,7,6,0
3,2,0,2,1,1,6,14.43,5.14,381.76,0.02,19,0.19,21.21,9,10,7,8,8,0
5,1,0,3,1,1,10,12.67,10,1267.11,0.04,31,0.1,70.4,14,17,7,10,11,0
3,1,0,2,1,1,6,11.71,4.9,281.06,0.02,16,0.2,15.61,7,9,5,7,7,0
3,1,0,2,1,1,6,11.71,4.9,281.06,0.02,16,0.2,15.61,7,9,5,7,7,0
1,0,0,1,1,1,2,5.33,1.5,12,0,4,0.67,0.67,1,3,1,3,2,0
1,0,0,1,1,1,2,5.33,1.5,12,0,4,0.67,0.67,1,3,1,3,2,0
3,1,0,2,1,1,6,11.23,5.6,352.28,0.02,17,0.18,19.57,7,10,5,8,7,0
7,1,1,4,1,3,13,18.91,10.45,2065.48,0.07,45,0.1,114.75,19,26,10,11,14,0
5,1,0,3,1,1,10,13.33,9,1080,0.04,30,0.11,60,14,16,7,9,11,0
3,1,0,2,1,1,6,11.71,4.9,281.06,0.02,16,0.2,15.61,7,9,5,7,7,0
7,1,1,4,1,3,13,18.91,10.45,2065.48,0.07,45,0.1,114.75,19,26,10,11,14,0
3,1,0,2,1,1,6,11.71,4.9,281.06,0.02,16,0.2,15.61,7,9,5,7,7,0
3,0,0,2,1,1,6,11.86,4.38,227.03,0.02,15,0.23,12.61,5,10,4,7,6,0
3,2,0,2,1,1,7,16.73,5.5,506,0.03,23,0.18,28.11,11,12,8,8,9,0
1,0,0,1,1,1,2,5.33,1.5,12,0,4,0.67,0.67,1,3,1,3,2,0
9,6,0,5,1,1,14,23.12,11.15,2875.94,0.09,57,0.09,159.77,29,28,13,10,20,0
3,1,0,2,1,1,7,14.43,5.14,381.76,0.02,19,0.19,21.21,9,10,7,8,8,0
7,1,1,4,1,3,13,19.62,10,1962.15,0.07,44,0.1,109.01,20,24,11,11,14,0
1,0,0,1,1,1,2,5.33,1.5,12,0,4,0.67,0.67,1,3,1,3,2,0
1,0,0,1,1,1,2,5.33,1.5,12,0,4,0.67,0.67,1,3,1,3,2,0
1,0,0,1,1,1,2,5.33,1.5,12,0,4,0.67,0.67,1,3,1,3,2,0
1,0,0,1,1,1,2,5.33,1.5,12,0,4,0.67,0.67,1,3,1,3,2,0
1,0,0,1,1,1,2,5.33,1.5,12,0,4,0.67,0.67,1,3,1,3,2,0
1,0,0,1,1,1,2,5.33,1.5,12,0,4,0.67,0.67,1,3,1,3,2,0
3,1,0,2,1,1,5,10.95,6,394.38,0.02,19,0.17,21.91,10,9,5,6,6,0
3,1,0,2,1,1,5,10.95,6,394.38,0.02,19,0.17,21.91,10,9,5,6,6,0
3,1,0,2,1,1,5,10.95,6,394.38,0.02,19,0.17,21.91,10,9,5,6,6,0
3,1,0,2,1,1,5,10.95,6,394.38,0.02,19,0.17,21.91,10,9,5,6,6,0
3,1,1,2,1,1,5,10.95,6,394.38,0.02,19,0.17,21.91,10,9,5,6,6,0
1,0,0,1,1,1,3,13,3,117,0.01,13,0.33,6.5,6,7,4,4,3,0
1,0,0,1,1,1,2,11.07,3,99.66,0.01,10,0.33,5.54,4,6,4,6,2,0
1,0,0,1,1,1,2,7.74,1.5,17.41,0,5,0.67,0.97,2,3,2,3,2,0
3,0,1,2,1,1,8,16.92,4.5,342.66,0.03,20,0.22,19.04,9,11,7,7,8,0
3,1,0,2,1,1,7,16.92,4.5,342.66,0.03,20,0.22,19.04,9,11,7,7,8,0
1,0,0,1,1,1,2,11.41,2.5,71.32,0.01,9,0.4,3.96,4,5,4,5,2,0
3,1,0,2,1,1,5,10.95,6,394.38,0.02,19,0.17,21.91,10,9,5,6,6,0
1,0,0,1,1,1,4,16.51,4.8,380.39,0.03,25,0.21,21.13,12,13,5,4,4,0
1,0,0,1,1,1,2,7.74,1.5,17.41,0,5,0.67,0.97,2,3,2,3,2,0
3,1,0,2,1,1,5,10.95,6,394.38,0.02,19,0.17,21.91,10,9,5,6,6,0
3,1,0,2,1,1,5,10.95,6,394.38,0.02,19,0.17,21.91,10,9,5,6,6,0
1,0,0,1,1,1,2,9.83,2,39.3,0.01,7,0.5,2.18,3,4,3,4,2,0
1,0,0,1,1,1,2,7.86,2.5,49.13,0.01,7,0.4,2.73,2,5,2,5,2,0
1,0,0,1,1,1,2,10.57,3,95.1,0.01,10,0.33,5.28,3,7,3,6,2,0
1,0,0,1,1,1,2,5.33,1.5,12,0,4,0.67,0.67,1,3,1,3,2,0
1,0,0,1,1,1,2,5.33,1.5,12,0,4,0.67,0.67,1,3,1,3,2,0
1,0,0,1,1,1,2,5.33,1.5,12,0,4,0.67,0.67,1,3,1,3,2,0
1,0,0,1,1,1,2,5.33,1.5,12,0,4,0.67,0.67,1,3,1,3,2,0
1,0,0,1,1,1,0,0,0,0,0,1,0,0,0,1,0,1,0,0
3,2,2,2,2,1,7,14.2,3.12,138.68,0.01,14,0.32,7.7,5,9,4,5,9,0
5,0,0,3,1,1,2,13.29,4.5,269.08,0.02,18,0.22,14.95,6,12,4,6,2,0
1,0,1,1,1,1,2,16.92,3.5,207.22,0.02,16,0.29,11.51,6,10,6,7,2,0
61,22,39,31,16,21,102,60.13,59.54,213151.41,1.19,573,0.02,11841.75,258,315,52,24,124,0
15,0,3,8,2,7,18,20.23,23.23,10919.67,0.16,94,0.04,606.65,41,53,15,17,18,1
11,3,9,6,1,1,26,25.97,14.31,5315.43,0.12,80,0.07,295.3,31,49,13,12,29,1
5,4,1,4,4,1,13,29.72,9.6,2738.82,0.1,60,0.1,152.16,24,36,15,12,17,1
49,15,20,25,12,21,97,69.75,43.78,133683.98,1.02,483,0.02,7426.89,217,266,57,23,112,1
7,1,0,4,1,1,7,16.59,7.71,987.43,0.04,32,0.13,54.86,12,20,7,9,8,1
1,0,0,1,1,1,2,0,0,0,0,5,0,0,0,5,0,5,2,0
1,0,0,1,1,1,0,0,0,0,0,5,0,0,0,5,0,5,0,0
1,0,0,1,1,1,0,0,0,0,0,5,0,0,0,5,0,5,0,0
1,0,0,1,1,1,0,0,0,0,0,1,0,0,0,1,0,1,0,0
1,0,0,1,1,1,2,0,0,0,0.01,6,0,0,0,6,0,6,2,0
1,0,0,1,1,1,2,0,0,0,0.01,6,0,0,0,6,0,6,2,0
1,0,0,1,1,1,2,0,0,0,0.01,6,0,0,0,6,0,6,2,0
37,15,24,19,11,9,71,49.82,40.73,82664.9,0.68,330,0.02,4592.49,141,189,45,26,86,1
21,8,25,11,8,5,54,55.12,25.72,36461.36,0.47,240,0.04,2025.63,111,129,41,19,62,1
5,0,0,3,2,3,11,22.17,7.73,1323.68,0.06,39,0.13,73.54,17,22,11,10,11,1
1,0,0,1,1,1,2,9.05,2,36.19,0.01,7,0.5,2,2,5,2,4,2,1
1,0,0,1,1,1,0,0,0,0,0,1,0,0,0,1,0,1,0,0
1,0,3,1,1,1,2,5.33,1.5,12,0,4,0.67,0.67,1,3,1,3,2,0
1,0,0,1,1,1,2,5.33,1.5,12,0,4,0.67,0.67,1,3,1,3,2,0
3,1,0,2,1,1,6,11.71,4.9,281.06,0.02,16,0.2,15.61,7,9,5,7,7,0
1,0,1,1,1,1,2,5.33,1.5,12,0,4,0.67,0.67,1,3,1,3,2,0
1,0,0,1,1,1,2,5.33,1.5,12,0,4,0.67,0.67,1,3,1,3,2,0
1,0,0,1,1,1,2,6.97,2,27.86,0,6,0.5,1.55,1,5,1,4,2,0
1,0,1,1,1,1,2,10.8,2.5,67.5,0.01,9,0.4,3.75,3,6,3,5,2,0
9,9,7,5,1,1,22,47.85,9.2,4046.09,0.15,88,0.11,224.78,47,41,23,9,31,1
1,0,0,1,1,1,2,7.49,3,67.38,0.01,8,0.33,3.74,1,7,1,6,2,0
1,0,0,1,1,1,2,9.05,2,36.19,0.01,7,0.5,2,2,5,2,4,2,0
1,0,0,1,1,1,2,7.49,3,67.38,0.01,8,0.33,3.74,1,7,1,6,2,0
1,0,0,1,1,1,2,9,3,81,0.01,9,0.33,4.5,2,7,2,6,2,0
1,0,0,1,1,1,2,9,3,81,0.01,9,0.33,4.5,2,7,2,6,2,0
1,0,0,1,1,1,2,7.49,3,67.38,0.01,8,0.33,3.74,1,7,1,6,2,0
1,0,0,1,1,1,2,10.8,2.5,67.5,0.01,9,0.4,3.75,3,6,3,5,2,0
1,0,1,1,1,1,2,6.2,2.5,38.77,0.01,6,0.4,2.15,1,5,1,5,2,1
1,0,0,1,1,1,2,9,3,81,0.01,9,0.33,4.5,2,7,2,6,2,0
3,1,1,2,2,1,12,17.35,9.38,1524.63,0.05,39,0.11,84.7,15,24,8,10,13,1
1,0,0,1,1,1,2,9.05,2,36.19,0.01,7,0.5,2,2,5,2,4,2,0
1,0,0,1,1,1,2,9.05,2,36.19,0.01,7,0.5,2,2,5,2,4,2,0
1,0,0,1,1,1,6,16.68,7.5,938.23,0.04,30,0.13,52.12,12,18,8,10,6,0
1,0,0,1,1,1,0,0,0,0,0,1,0,0,0,1,0,1,0,0
3,1,0,2,1,1,6,11.71,4.9,281.06,0.02,16,0.2,15.61,7,9,5,7,7,0
3,1,0,2,1,1,6,11.71,4.9,281.06,0.02,16,0.2,15.61,7,9,5,7,7,0
1,0,0,1,1,1,2,5.33,1.5,12,0,4,0.67,0.67,1,3,1,3,2,0
3,1,0,2,1,1,6,11.71,4.9,281.06,0.02,16,0.2,15.61,7,9,5,7,7,0
1,0,0,1,1,1,2,6.97,2,27.86,0,6,0.5,1.55,1,5,1,4,2,0
1,0,0,1,1,1,2,9,3,81,0.01,9,0.33,4.5,2,7,2,6,2,0
1,0,0,1,1,1,2,9,3,81,0.01,9,0.33,4.5,2,7,2,6,2,0
1,0,0,1,1,1,2,5.33,1.5,12,0,4,0.67,0.67,1,3,1,3,2,0
1,0,0,1,1,1,2,10.44,3.5,127.89,0.01,11,0.29,7.11,3,8,3,7,2,0
1,0,0,1,1,1,2,6.97,2,27.86,0,6,0.5,1.55,1,5,1,4,2,0
1,0,0,1,1,1,0,0,0,0,0,1,0,0,0,1,0,1,0,0
1,0,0,1,1,1,2,5.33,1.5,12,0,4,0.67,0.67,1,3,1,3,2,0
1,0,0,1,1,1,2,8,3,72,0.01,8,0.33,4,2,6,2,6,2,0
1,0,0,1,1,1,2,0,0,0,0,5,0,0,0,5,0,5,2,0
1,0,0,1,1,1,0,0,0,0,0,1,0,0,0,1,0,1,0,0
1,0,0,1,1,1,2,0,0,0,0.01,6,0,0,0,6,0,6,2,0
1,0,0,1,1,1,2,7.75,2,31.02,0.01,6,0.5,1.72,2,4,2,4,2,0
1,0,0,1,1,1,2,7.74,1.5,17.41,0,5,0.67,0.97,2,3,2,3,2,0
1,1,1,1,1,1,1,0,0,0,0,1,0,0,1,0,1,0,2,0
3,1,0,2,1,1,7,12.44,4.9,298.63,0.02,17,0.2,16.59,7,10,5,7,8,0
1,0,0,1,1,1,0,0,0,0,0,1,0,0,0,1,0,1,0,0
3,1,0,2,2,1,6,10.88,6.3,431.75,0.02,18,0.16,23.99,7,11,5,9,7,0
1,0,0,1,1,1,2,5.33,1.5,12,0,4,0.67,0.67,1,3,1,3,2,0
1,0,0,1,1,1,2,0,0,0,0,5,0,0,0,5,0,5,2,0
1,0,0,1,1,1,0,0,0,0,0,1,0,0,0,1,0,1,0,0
1,0,0,1,1,1,2,0,0,0,0.01,6,0,0,0,6,0,6,2,0
1,0,3,1,1,1,4,0,0,0,0,3,0,0,3,0,3,0,4,0
1,0,0,1,1,1,0,0,0,0,0,1,0,0,0,1,0,1,0,0
3,2,1,2,1,1,5,10.33,4.5,209.28,0.02,14,0.22,11.63,6,8,4,6,7,0
3,1,0,2,1,1,6,13.45,3.6,174.36,0.02,14,0.28,9.69,6,8,5,6,7,0
1,0,0,1,1,1,2,0,0,0,0,5,0,0,0,5,0,5,2,0
1,0,0,1,1,1,0,0,0,0,0,1,0,0,0,1,0,1,0,0
1,0,0,1,1,1,2,0,0,0,0.01,6,0,0,0,6,0,6,2,0
1,0,0,1,1,1,0,0,0,0,0,1,0,0,0,1,0,1,0,0
1,0,0,1,1,1,2,6.55,3,58.95,0.01,7,0.33,3.28,1,6,1,6,2,0
1,0,0,1,1,1,2,5.33,1.5,12,0,4,0.67,0.67,1,3,1,3,2,0
1,0,0,1,1,1,2,8,3,72,0.01,8,0.33,4,2,6,2,6,2,0
1,0,0,1,1,1,2,9,3,81,0.01,9,0.33,4.5,2,7,2,6,2,0
1,0,0,1,1,1,2,8,3,72,0.01,8,0.33,4,2,6,2,6,2,0
1,0,0,1,1,1,2,9.49,3.5,116.27,0.01,10,0.29,6.46,3,7,3,7,2,0
1,0,0,1,1,1,2,11.86,3.5,145.3,0.01,12,0.29,8.07,4,8,4,7,2,0
1,0,0,1,1,1,2,0,0,0,0,5,0,0,0,5,0,5,2,0
1,0,0,1,1,1,0,0,0,0,0,1,0,0,0,1,0,1,0,0
1,0,0,1,1,1,2,0,0,0,0.01,6,0,0,0,6,0,6,2,0
1,0,0,1,1,1,2,7.75,2,31.02,0.01,6,0.5,1.72,2,4,2,4,2,0
1,0,0,1,1,1,3,10.8,3.33,120,0.01,12,0.3,6.67,4,8,3,5,3,0
1,0,0,1,1,1,2,7.75,2,31.02,0.01,6,0.5,1.72,2,4,2,4,2,0
1,0,0,1,1,1,3,12.68,2.5,79.25,0.01,10,0.4,4.4,4,6,4,5,3,0
1,3,1,1,1,1,1,0,0,0,0,1,0,0,1,0,1,0,4,0
1,0,0,1,1,1,2,6.55,3,58.95,0.01,7,0.33,3.28,1,6,1,6,2,0
1,0,0,1,1,1,0,0,0,0,0,1,0,0,0,1,0,1,0,0
1,0,0,1,1,1,2,8,3,72,0.01,8,0.33,4,2,6,2,6,2,0
1,0,0,1,1,1,2,9,3,81,0.01,9,0.33,4.5,2,7,2,6,2,0
1,0,0,1,1,1,2,5.33,1.5,12,0,4,0.67,0.67,1,3,1,3,2,0
1,0,0,1,1,1,2,5.33,1.5,12,0,4,0.67,0.67,1,3,1,3,2,0
1,0,0,1,1,1,2,6.55,3,58.95,0.01,7,0.33,3.28,1,6,1,6,2,0
1,0,0,1,1,1,2,5.33,1.5,12,0,4,0.67,0.67,1,3,1,3,2,0
1,0,0,1,1,1,2,5.33,1.5,12,0,4,0.67,0.67,1,3,1,3,2,0
1,0,0,1,1,1,2,6.55,3,58.95,0.01,7,0.33,3.28,1,6,1,6,2,0
1,0,0,1,1,1,2,0,0,0,0,5,0,0,0,5,0,5,2,0
1,0,0,1,1,1,0,0,0,0,0,1,0,0,0,1,0,1,0,0
1,0,0,1,1,1,2,0,0,0,0.01,6,0,0,0,6,0,6,2,0
1,0,0,1,1,1,0,0,0,0,0,1,0,0,0,1,0,1,0,0
1,0,1,1,1,1,2,9.51,3,85.59,0.01,9,0.33,4.75,3,6,3,6,2,0
1,0,0,1,1,1,2,0,0,0,0,5,0,0,0,5,0,5,2,0
1,0,0,1,1,1,0,0,0,0,0,1,0,0,0,1,0,1,0,0
1,0,0,1,1,1,2,0,0,0,0.01,6,0,0,0,6,0,6,2,0
1,0,0,1,1,1,2,10.44,3.5,127.89,0.01,11,0.29,7.11,3,8,3,7,2,0
1,0,0,1,1,1,2,7.49,3,67.38,0.01,8,0.33,3.74,1,7,1,6,2,0
1,0,0,1,1,1,2,9,3,81,0.01,9,0.33,4.5,2,7,2,6,2,0
1,0,0,1,1,1,2,9,3,81,0.01,9,0.33,4.5,2,7,2,6,2,0
1,0,0,1,1,1,2,9,3,81,0.01,9,0.33,4.5,2,7,2,6,2,0
1,0,0,1,1,1,2,10.44,3.5,127.89,0.01,11,0.29,7.11,3,8,3,7,2,0
1,0,0,1,1,1,2,9,3,81,0.01,9,0.33,4.5,2,7,2,6,2,0
1,0,0,1,1,1,2,9,3,81,0.01,9,0.33,4.5,2,7,2,6,2,0
1,0,0,1,1,1,2,7.49,3,67.38,0.01,8,0.33,3.74,1,7,1,6,2,0
1,0,0,1,1,1,2,7.49,3,67.38,0.01,8,0.33,3.74,1,7,1,6,2,0
1,0,0,1,1,1,2,10,3,90,0.01,10,0.33,5,2,8,2,6,2,0
1,0,0,1,1,1,3,10.44,3.5,127.89,0.01,11,0.29,7.11,3,8,3,7,3,0
1,0,0,1,1,1,3,11.39,3.5,139.52,0.01,12,0.29,7.75,3,9,3,7,3,0
1,0,0,1,1,1,2,9,3,81,0.01,9,0.33,4.5,2,7,2,6,2,0
1,0,0,1,1,1,2,10.44,3.5,127.89,0.01,11,0.29,7.11,3,8,3,7,2,0
1,0,0,1,1,1,2,9,3,81,0.01,9,0.33,4.5,2,7,2,6,2,0
1,0,0,1,1,1,2,9,3,81,0.01,9,0.33,4.5,2,7,2,6,2,0
1,0,0,1,1,1,2,10.44,3.5,127.89,0.01,11,0.29,7.11,3,8,3,7,2,0
1,0,0,1,1,1,2,9,3,81,0.01,9,0.33,4.5,2,7,2,6,2,0
1,0,0,1,1,1,2,9,3,81,0.01,9,0.33,4.5,2,7,2,6,2,0
1,0,0,1,1,1,2,9,3,81,0.01,9,0.33,4.5,2,7,2,6,2,0
1,0,0,1,1,1,2,7.49,3,67.38,0.01,8,0.33,3.74,1,7,1,6,2,0
1,0,0,1,1,1,2,9,3,81,0.01,9,0.33,4.5,2,7,2,6,2,0
1,0,0,1,1,1,2,9,3,81,0.01,9,0.33,4.5,2,7,2,6,2,0
1,0,0,1,1,1,2,10.44,3.5,127.89,0.01,11,0.29,7.11,3,8,3,7,2,0
1,0,0,1,1,1,2,9.05,2,36.19,0.01,7,0.5,2,2,5,2,4,2,0
1,0,0,1,1,1,2,9.05,2,36.19,0.01,7,0.5,2,2,5,2,4,2,0
1,0,0,1,1,1,2,9.05,2,36.19,0.01,7,0.5,2,2,5,2,4,2,0
1,0,0,1,1,1,2,9.05,2,36.19,0.01,7,0.5,2,2,5,2,4,2,0
1,0,0,1,1,1,2,9.05,2,36.19,0.01,7,0.5,2,2,5,2,4,2,0
1,0,0,1,1,1,2,9.05,2,36.19,0.01,7,0.5,2,2,5,2,4,2,0
1,0,0,1,1,1,2,9.05,2,36.19,0.01,7,0.5,2,2,5,2,4,2,0
1,0,0,1,1,1,2,9.05,2,36.19,0.01,7,0.5,2,2,5,2,4,2,0
1,0,0,1,1,1,2,9.05,2,36.19,0.01,7,0.5,2,2,5,2,4,2,0
1,0,0,1,1,1,2,9.05,2,36.19,0.01,7,0.5,2,2,5,2,4,2,0
1,0,0,1,1,1,2,9.05,2,36.19,0.01,7,0.5,2,2,5,2,4,2,0
1,0,0,1,1,1,2,9.05,2,36.19,0.01,7,0.5,2,2,5,2,4,2,0
1,0,0,1,1,1,2,9.05,2,36.19,0.01,7,0.5,2,2,5,2,4,2,0
1,0,0,1,1,1,2,10.44,3.5,127.89,0.01,11,0.29,7.11,3,8,3,7,2,0
1,0,0,1,1,1,2,10.44,3.5,127.89,0.01,11,0.29,7.11,3,8,3,7,2,0
1,0,0,1,1,1,2,9.05,2,36.19,0.01,7,0.5,2,2,5,2,4,2,0
1,0,0,1,1,1,0,0,0,0,0,1,0,0,0,1,0,1,0,0
1,0,0,1,1,1,2,5.33,1.5,12,0,4,0.67,0.67,1,3,1,3,2,0
3,0,0,2,1,1,6,11.86,4.38,227.03,0.02,15,0.23,12.61,5,10,4,7,6,0
3,2,0,2,1,1,6,14.43,5.14,381.76,0.02,19,0.19,21.21,9,10,7,8,8,0
5,1,0,3,1,1,10,12.67,10,1267.11,0.04,31,0.1,70.4,14,17,7,10,11,0
3,1,0,2,1,1,6,11.71,4.9,281.06,0.02,16,0.2,15.61,7,9,5,7,7,0
3,1,0,2,1,1,6,11.71,4.9,281.06,0.02,16,0.2,15.61,7,9,5,7,7,0
1,0,0,1,1,1,2,5.33,1.5,12,0,4,0.67,0.67,1,3,1,3,2,0
1,0,0,1,1,1,2,5.33,1.5,12,0,4,0.67,0.67,1,3,1,3,2,0
3,1,0,2,1,1,6,11.23,5.6,352.28,0.02,17,0.18,19.57,7,10,5,8,7,0
7,1,1,4,1,3,13,18.91,10.45,2065.48,0.07,45,0.1,114.75,19,26,10,11,14,0
5,1,0,3,1,1,10,13.33,9,1080,0.04,30,0.11,60,14,16,7,9,11,0
3,1,0,2,1,1,6,11.71,4.9,281.06,0.02,16,0.2,15.61,7,9,5,7,7,0
7,1,1,4,1,3,13,18.91,10.45,2065.48,0.07,45,0.1,114.75,19,26,10,11,14,0
3,1,0,2,1,1,6,11.71,4.9,281.06,0.02,16,0.2,15.61,7,9,5,7,7,0
3,0,0,2,1,1,6,11.86,4.38,227.03,0.02,15,0.23,12.61,5,10,4,7,6,0
3,2,0,2,1,1,7,16.73,5.5,506,0.03,23,0.18,28.11,11,12,8,8,9,0
1,0,0,1,1,1,2,5.33,1.5,12,0,4,0.67,0.67,1,3,1,3,2,0
9,6,0,5,1,1,14,23.12,11.15,2875.94,0.09,57,0.09,159.77,29,28,13,10,20,0
3,1,0,2,1,1,7,14.43,5.14,381.76,0.02,19,0.19,21.21,9,10,7,8,8,0
7,1,1,4,1,3,13,19.62,10,1962.15,0.07,44,0.1,109.01,20,24,11,11,14,0
1,0,0,1,1,1,2,5.33,1.5,12,0,4,0.67,0.67,1,3,1,3,2,0
1,0,0,1,1,1,2,5.33,1.5,12,0,4,0.67,0.67,1,3,1,3,2,0
1,0,0,1,1,1,2,5.33,1.5,12,0,4,0.67,0.67,1,3,1,3,2,0
1,0,0,1,1,1,2,5.33,1.5,12,0,4,0.67,0.67,1,3,1,3,2,0
1,0,0,1,1,1,2,5.33,1.5,12,0,4,0.67,0.67,1,3,1,3,2,0
1,0,0,1,1,1,2,5.33,1.5,12,0,4,0.67,0.67,1,3,1,3,2,0
1,0,0,1,1,1,2,5.33,1.5,12,0,4,0.67,0.67,1,3,1,3,2,0
3,1,0,2,1,1,5,10.95,6,394.38,0.02,19,0.17,21.91,10,9,5,6,6,0
3,1,0,2,1,1,5,10.95,6,394.38,0.02,19,0.17,21.91,10,9,5,6,6,0
3,1,0,2,1,1,5,10.95,6,394.38,0.02,19,0.17,21.91,10,9,5,6,6,0
3,1,0,2,1,1,5,10.95,6,394.38,0.02,19,0.17,21.91,10,9,5,6,6,0
3,1,1,2,1,1,5,10.95,6,394.38,0.02,19,0.17,21.91,10,9,5,6,6,0
1,0,0,1,1,1,3,13,3,117,0.01,13,0.33,6.5,6,7,4,4,3,0
1,0,0,1,1,1,2,11.07,3,99.66,0.01,10,0.33,5.54,4,6,4,6,2,0
1,0,0,1,1,1,2,7.74,1.5,17.41,0,5,0.67,0.97,2,3,2,3,2,0
3,0,1,2,1,1,8,16.92,4.5,342.66,0.03,20,0.22,19.04,9,11,7,7,8,0
3,1,0,2,1,1,7,16.92,4.5,342.66,0.03,20,0.22,19.04,9,11,7,7,8,0
1,0,0,1,1,1,2,11.41,2.5,71.32,0.01,9,0.4,3.96,4,5,4,5,2,0
3,1,0,2,1,1,5,10.95,6,394.38,0.02,19,0.17,21.91,10,9,5,6,6,0
1,0,0,1,1,1,4,16.51,4.8,380.39,0.03,25,0.21,21.13,12,13,5,4,4,0
1,0,0,1,1,1,2,7.74,1.5,17.41,0,5,0.67,0.97,2,3,2,3,2,0
3,1,0,2,1,1,5,10.95,6,394.38,0.02,19,0.17,21.91,10,9,5,6,6,0
3,1,0,2,1,1,5,10.95,6,394.38,0.02,19,0.17,21.91,10,9,5,6,6,0
1,0,0,1,1,1,2,9.83,2,39.3,0.01,7,0.5,2.18,3,4,3,4,2,0
1,0,0,1,1,1,2,7.86,2.5,49.13,0.01,7,0.4,2.73,2,5,2,5,2,0
1,0,0,1,1,1,2,7.49,3,67.38,0.01,8,0.33,3.74,1,7,1,6,2,0
1,0,0,1,1,1,2,7.49,3,67.38,0.01,8,0.33,3.74,1,7,1,6,2,0
1,0,0,1,1,1,2,7.49,3,67.38,0.01,8,0.33,3.74,1,7,1,6,2,0
1,0,0,1,1,1,2,7.49,3,67.38,0.01,8,0.33,3.74,1,7,1,6,2,0
1,0,0,1,1,1,2,7.49,3,67.38,0.01,8,0.33,3.74,1,7,1,6,2,0
1,0,0,1,1,1,2,7.49,3,67.38,0.01,8,0.33,3.74,1,7,1,6,2,0
1,0,0,1,1,1,2,7.49,3,67.38,0.01,8,0.33,3.74,1,7,1,6,2,0
1,0,0,1,1,1,2,10.57,3,95.1,0.01,10,0.33,5.28,3,7,3,6,2,0
1,0,0,1,1,1,0,0,0,0,0,1,0,0,0,1,0,1,0,0
1,0,0,1,1,1,2,5.33,1.5,12,0,4,0.67,0.67,1,3,1,3,2,0
1,0,0,1,1,1,2,5.33,1.5,12,0,4,0.67,0.67,1,3,1,3,2,0
1,0,0,1,1,1,2,5.33,1.5,12,0,4,0.67,0.67,1,3,1,3,2,0
1,0,0,1,1,1,2,5.33,1.5,12,0,4,0.67,0.67,1,3,1,3,2,0
1,0,0,1,1,1,2,5.33,1.5,12,0,4,0.67,0.67,1,3,1,3,2,0
1,0,0,1,1,1,2,5.33,1.5,12,0,4,0.67,0.67,1,3,1,3,2,0
1,0,0,1,1,1,2,5.33,1.5,12,0,4,0.67,0.67,1,3,1,3,2,0
1,0,0,1,1,1,2,13.95,2.5,87.17,0.01,11,0.4,4.84,4,7,4,5,2,0
7,6,3,4,3,1,14,31.38,11.37,4055.14,0.12,72,0.09,225.29,36,36,19,12,20,1
5,0,0,3,1,1,2,13.29,4.5,269.08,0.02,18,0.22,14.95,6,12,4,6,2,0
1,0,1,1,1,1,2,16.92,3.5,207.22,0.02,16,0.29,11.51,6,10,6,7,2,0
1,0,0,1,1,1,2,0,0,0,0,5,0,0,0,5,0,5,2,0
1,0,0,1,1,1,0,0,0,0,0,1,0,0,0,1,0,1,0,0
1,0,0,1,1,1,2,0,0,0,0.01,6,0,0,0,6,0,6,2,0
1,0,0,1,1,1,2,0,0,0,0.01,6,0,0,0,6,0,6,2,0
5,0,0,3,2,1,15,25.82,6.91,1232.67,0.06,42,0.14,68.48,19,23,11,8,15,1
1,0,0,1,1,1,0,0,0,0,0,1,0,0,0,1,0,1,0,0
1,0,3,1,1,1,2,5.33,1.5,12,0,4,0.67,0.67,1,3,1,3,2,0
1,0,0,1,1,1,2,5.33,1.5,12,0,4,0.67,0.67,1,3,1,3,2,0
3,1,0,2,1,1,6,11.71,4.9,281.06,0.02,16,0.2,15.61,7,9,5,7,7,0
1,0,1,1,1,1,2,5.33,1.5,12,0,4,0.67,0.67,1,3,1,3,2,0
1,0,0,1,1,1,2,5.33,1.5,12,0,4,0.67,0.67,1,3,1,3,2,0
1,0,0,1,1,1,2,6.97,2,27.86,0,6,0.5,1.55,1,5,1,4,2,0
1,0,1,1,1,1,2,10.8,2.5,67.5,0.01,9,0.4,3.75,3,6,3,5,2,0
1,0,0,1,1,1,0,0,0,0,0,1,0,0,0,1,0,1,0,0
1,0,0,1,1,1,2,5.33,1.5,12,0,4,0.67,0.67,1,3,1,3,2,0
1,0,0,1,1,1,2,8,3,72,0.01,8,0.33,4,2,6,2,6,2,0
1,0,0,1,1,1,2,0,0,0,0,5,0,0,0,5,0,5,2,0
1,0,0,1,1,1,0,0,0,0,0,1,0,0,0,1,0,1,0,0
1,0,0,1,1,1,2,0,0,0,0.01,6,0,0,0,6,0,6,2,0
1,0,0,1,1,1,2,7.75,2,31.02,0.01,6,0.5,1.72,2,4,2,4,2,0
1,0,0,1,1,1,2,7.74,1.5,17.41,0,5,0.67,0.97,2,3,2,3,2,0
1,1,1,1,1,1,1,0,0,0,0,1,0,0,1,0,1,0,2,0
3,1,0,2,1,1,7,12.44,4.9,298.63,0.02,17,0.2,16.59,7,10,5,7,8,0
1,0,0,1,1,1,0,0,0,0,0,1,0,0,0,1,0,1,0,0
3,1,0,2,2,1,6,10.88,6.3,431.75,0.02,18,0.16,23.99,7,11,5,9,7,0
1,0,0,1,1,1,2,5.33,1.5,12,0,4,0.67,0.67,1,3,1,3,2,0
1,0,0,1,1,1,2,0,0,0,0,5,0,0,0,5,0,5,2,0
1,0,0,1,1,1,0,0,0,0,0,1,0,0,0,1,0,1,0,0
1,0,0,1,1,1,2,0,0,0,0.01,6,0,0,0,6,0,6,2,0
1,0,3,1,1,1,4,0,0,0,0,3,0,0,3,0,3,0,4,0
5,2,2,3,2,1,12,11.81,11.25,1494.39,0.04,34,0.09,83.02,15,19,6,9,14,1
1,0,0,1,1,1,0,0,0,0,0,1,0,0,0,1,0,1,0,0
3,2,1,2,1,1,5,10.33,4.5,209.28,0.02,14,0.22,11.63,6,8,4,6,7,0
3,1,0,2,1,1,6,13.45,3.6,174.36,0.02,14,0.28,9.69,6,8,5,6,7,0
1,0,0,1,1,1,2,0,0,0,0,5,0,0,0,5,0,5,2,0
1,0,0,1,1,1,0,0,0,0,0,1,0,0,0,1,0,1,0,0
1,0,0,1,1,1,2,0,0,0,0.01,6,0,0,0,6,0,6,2,0
1,0,0,1,1,1,0,0,0,0,0,1,0,0,0,1,0,1,0,0
1,0,0,1,1,1,2,6.55,3,58.95,0.01,7,0.33,3.28,1,6,1,6,2,0
1,0,0,1,1,1,2,5.33,1.5,12,0,4,0.67,0.67,1,3,1,3,2,0
1,0,0,1,1,1,2,8,3,72,0.01,8,0.33,4,2,6,2,6,2,0
1,0,0,1,1,1,2,9,3,81,0.01,9,0.33,4.5,2,7,2,6,2,0
1,0,0,1,1,1,2,8,3,72,0.01,8,0.33,4,2,6,2,6,2,0
1,0,0,1,1,1,2,9.49,3.5,116.27,0.01,10,0.29,6.46,3,7,3,7,2,0
1,0,0,1,1,1,2,11.86,3.5,145.3,0.01,12,0.29,8.07,4,8,4,7,2,0
1,0,0,1,1,1,2,0,0,0,0,5,0,0,0,5,0,5,2,0
1,0,0,1,1,1,0,0,0,0,0,1,0,0,0,1,0,1,0,0
1,0,0,1,1,1,2,0,0,0,0.01,6,0,0,0,6,0,6,2,0
1,0,0,1,1,1,2,7.75,2,31.02,0.01,6,0.5,1.72,2,4,2,4,2,0
1,0,0,1,1,1,3,10.8,3.33,120,0.01,12,0.3,6.67,4,8,3,5,3,0
1,0,0,1,1,1,2,7.75,2,31.02,0.01,6,0.5,1.72,2,4,2,4,2,0
1,0,0,1,1,1,3,12.68,2.5,79.25,0.01,10,0.4,4.4,4,6,4,5,3,0
1,3,1,1,1,1,1,0,0,0,0,1,0,0,1,0,1,0,4,0
1,0,0,1,1,1,2,6.55,3,58.95,0.01,7,0.33,3.28,1,6,1,6,2,0
1,0,0,1,1,1,0,0,0,0,0,1,0,0,0,1,0,1,0,0
1,0,0,1,1,1,2,8,3,72,0.01,8,0.33,4,2,6,2,6,2,0
1,0,0,1,1,1,2,9,3,81,0.01,9,0.33,4.5,2,7,2,6,2,0
1,0,0,1,1,1,2,5.33,1.5,12,0,4,0.67,0.67,1,3,1,3,2,0
1,0,0,1,1,1,2,5.33,1.5,12,0,4,0.67,0.67,1,3,1,3,2,0
1,0,0,1,1,1,2,6.55,3,58.95,0.01,7,0.33,3.28,1,6,1,6,2,0
1,0,0,1,1,1,2,5.33,1.5,12,0,4,0.67,0.67,1,3,1,3,2,0
1,0,0,1,1,1,2,5.33,1.5,12,0,4,0.67,0.67,1,3,1,3,2,0
1,0,0,1,1,1,2,6.55,3,58.95,0.01,7,0.33,3.28,1,6,1,6,2,0
1,0,0,1,1,1,2,0,0,0,0,5,0,0,0,5,0,5,2,0
1,0,0,1,1,1,0,0,0,0,0,1,0,0,0,1,0,1,0,0
1,0,0,1,1,1,2,0,0,0,0.01,6,0,0,0,6,0,6,2,0
1,0,0,1,1,1,0,0,0,0,0,1,0,0,0,1,0,1,0,0
1,0,1,1,1,1,2,9.51,3,85.59,0.01,9,0.33,4.75,3,6,3,6,2,0
1,0,0,1,1,1,2,0,0,0,0,5,0,0,0,5,0,5,2,0
1,0,0,1,1,1,0,0,0,0,0,1,0,0,0,1,0,1,0,0
1,0,0,1,1,1,2,0,0,0,0.01,6,0,0,0,6,0,6,2,0
1,0,0,1,1,1,0,0,0,0,0,1,0,0,0,1,0,1,0,0
1,0,1,1,1,1,2,5.33,1.5,12,0,4,0.67,0.67,1,3,1,3,2,0
1,0,0,1,1,1,2,0,0,0,0,5,0,0,0,5,0,5,2,0
1,0,0,1,1,1,0,0,0,0,0,1,0,0,0,1,0,1,0,0
1,0,0,1,1,1,2,0,0,0,0.01,6,0,0,0,6,0,6,2,0
1,0,0,1,1,1,2,9.83,2,39.3,0.01,7,0.5,2.18,3,4,3,4,2,0
1,0,0,1,1,1,2,10.44,3.5,127.89,0.01,11,0.29,7.11,3,8,3,7,2,0
1,0,0,1,1,1,2,7.49,3,67.38,0.01,8,0.33,3.74,1,7,1,6,2,0
1,0,0,1,1,1,2,9,3,81,0.01,9,0.33,4.5,2,7,2,6,2,0
1,0,0,1,1,1,2,9,3,81,0.01,9,0.33,4.5,2,7,2,6,2,0
1,0,0,1,1,1,2,9,3,81,0.01,9,0.33,4.5,2,7,2,6,2,0
1,0,0,1,1,1,2,10.44,3.5,127.89,0.01,11,0.29,7.11,3,8,3,7,2,0
1,0,0,1,1,1,2,9,3,81,0.01,9,0.33,4.5,2,7,2,6,2,0
1,0,0,1,1,1,2,9,3,81,0.01,9,0.33,4.5,2,7,2,6,2,0
1,0,0,1,1,1,2,7.49,3,67.38,0.01,8,0.33,3.74,1,7,1,6,2,0
1,0,0,1,1,1,2,7.49,3,67.38,0.01,8,0.33,3.74,1,7,1,6,2,0
1,0,0,1,1,1,2,10,3,90,0.01,10,0.33,5,2,8,2,6,2,0
1,0,0,1,1,1,3,10.44,3.5,127.89,0.01,11,0.29,7.11,3,8,3,7,3,0
1,0,0,1,1,1,3,11.39,3.5,139.52,0.01,12,0.29,7.75,3,9,3,7,3,0
1,0,0,1,1,1,2,9,3,81,0.01,9,0.33,4.5,2,7,2,6,2,0
1,0,0,1,1,1,2,10.44,3.5,127.89,0.01,11,0.29,7.11,3,8,3,7,2,0
1,0,0,1,1,1,2,9,3,81,0.01,9,0.33,4.5,2,7,2,6,2,0
1,0,0,1,1,1,2,9,3,81,0.01,9,0.33,4.5,2,7,2,6,2,0
1,0,0,1,1,1,2,10.44,3.5,127.89,0.01,11,0.29,7.11,3,8,3,7,2,0
1,0,0,1,1,1,2,9,3,81,0.01,9,0.33,4.5,2,7,2,6,2,0
1,0,0,1,1,1,2,9,3,81,0.01,9,0.33,4.5,2,7,2,6,2,0
1,0,0,1,1,1,2,9,3,81,0.01,9,0.33,4.5,2,7,2,6,2,0
1,0,0,1,1,1,2,7.49,3,67.38,0.01,8,0.33,3.74,1,7,1,6,2,0
1,0,0,1,1,1,2,9,3,81,0.01,9,0.33,4.5,2,7,2,6,2,0
1,0,0,1,1,1,2,9,3,81,0.01,9,0.33,4.5,2,7,2,6,2,0
1,0,0,1,1,1,2,10.44,3.5,127.89,0.01,11,0.29,7.11,3,8,3,7,2,0
1,0,0,1,1,1,2,9.05,2,36.19,0.01,7,0.5,2,2,5,2,4,2,0
1,0,0,1,1,1,2,9.05,2,36.19,0.01,7,0.5,2,2,5,2,4,2,0
1,0,0,1,1,1,2,9.05,2,36.19,0.01,7,0.5,2,2,5,2,4,2,0
1,0,0,1,1,1,2,9.05,2,36.19,0.01,7,0.5,2,2,5,2,4,2,0
1,0,0,1,1,1,2,9.05,2,36.19,0.01,7,0.5,2,2,5,2,4,2,0
1,0,0,1,1,1,2,9.05,2,36.19,0.01,7,0.5,2,2,5,2,4,2,0
1,0,0,1,1,1,2,9.05,2,36.19,0.01,7,0.5,2,2,5,2,4,2,0
1,0,0,1,1,1,2,9.05,2,36.19,0.01,7,0.5,2,2,5,2,4,2,0
1,0,0,1,1,1,2,9.05,2,36.19,0.01,7,0.5,2,2,5,2,4,2,0
1,0,0,1,1,1,2,9.05,2,36.19,0.01,7,0.5,2,2,5,2,4,2,0
1,0,0,1,1,1,2,9.05,2,36.19,0.01,7,0.5,2,2,5,2,4,2,0
1,0,0,1,1,1,2,9.05,2,36.19,0.01,7,0.5,2,2,5,2,4,2,0
1,0,0,1,1,1,2,9.05,2,36.19,0.01,7,0.5,2,2,5,2,4,2,0
1,0,0,1,1,1,2,10.44,3.5,127.89,0.01,11,0.29,7.11,3,8,3,7,2,0
1,0,0,1,1,1,2,10.44,3.5,127.89,0.01,11,0.29,7.11,3,8,3,7,2,0
1,0,0,1,1,1,2,9.05,2,36.19,0.01,7,0.5,2,2,5,2,4,2,0
1,0,0,1,1,1,0,0,0,0,0,1,0,0,0,1,0,1,0,0
1,0,0,1,1,1,2,5.33,1.5,12,0,4,0.67,0.67,1,3,1,3,2,0
3,0,0,2,1,1,6,11.86,4.38,227.03,0.02,15,0.23,12.61,5,10,4,7,6,0
3,2,0,2,1,1,6,14.43,5.14,381.76,0.02,19,0.19,21.21,9,10,7,8,8,0
5,1,0,3,1,1,10,12.67,10,1267.11,0.04,31,0.1,70.4,14,17,7,10,11,0
3,1,0,2,1,1,6,11.71,4.9,281.06,0.02,16,0.2,15.61,7,9,5,7,7,0
3,1,0,2,1,1,6,11.71,4.9,281.06,0.02,16,0.2,15.61,7,9,5,7,7,0
1,0,0,1,1,1,2,5.33,1.5,12,0,4,0.67,0.67,1,3,1,3,2,0
1,0,0,1,1,1,2,5.33,1.5,12,0,4,0.67,0.67,1,3,1,3,2,0
3,1,0,2,1,1,6,11.23,5.6,352.28,0.02,17,0.18,19.57,7,10,5,8,7,0
7,1,1,4,1,3,13,18.91,10.45,2065.48,0.07,45,0.1,114.75,19,26,10,11,14,0
5,1,0,3,1,1,10,13.33,9,1080,0.04,30,0.11,60,14,16,7,9,11,0
3,1,0,2,1,1,6,11.71,4.9,281.06,0.02,16,0.2,15.61,7,9,5,7,7,0
7,1,1,4,1,3,13,18.91,10.45,2065.48,0.07,45,0.1,114.75,19,26,10,11,14,0
3,1,0,2,1,1,6,11.71,4.9,281.06,0.02,16,0.2,15.61,7,9,5,7,7,0
3,0,0,2,1,1,6,11.86,4.38,227.03,0.02,15,0.23,12.61,5,10,4,7,6,0
3,2,0,2,1,1,7,16.73,5.5,506,0.03,23,0.18,28.11,11,12,8,8,9,0
1,0,0,1,1,1,2,5.33,1.5,12,0,4,0.67,0.67,1,3,1,3,2,0
9,6,0,5,1,1,14,23.12,11.15,2875.94,0.09,57,0.09,159.77,29,28,13,10,20,0
3,1,0,2,1,1,7,14.43,5.14,381.76,0.02,19,0.19,21.21,9,10,7,8,8,0
7,1,1,4,1,3,13,19.62,10,1962.15,0.07,44,0.1,109.01,20,24,11,11,14,0
1,0,0,1,1,1,2,5.33,1.5,12,0,4,0.67,0.67,1,3,1,3,2,0
1,0,0,1,1,1,2,5.33,1.5,12,0,4,0.67,0.67,1,3,1,3,2,0
1,0,0,1,1,1,2,5.33,1.5,12,0,4,0.67,0.67,1,3,1,3,2,0
1,0,0,1,1,1,2,5.33,1.5,12,0,4,0.67,0.67,1,3,1,3,2,0
1,0,0,1,1,1,2,5.33,1.5,12,0,4,0.67,0.67,1,3,1,3,2,0
1,0,0,1,1,1,2,5.33,1.5,12,0,4,0.67,0.67,1,3,1,3,2,0
1,0,0,1,1,1,2,5.33,1.5,12,0,4,0.67,0.67,1,3,1,3,2,0
3,1,0,2,1,1,5,10.95,6,394.38,0.02,19,0.17,21.91,10,9,5,6,6,0
3,1,0,2,1,1,5,10.95,6,394.38,0.02,19,0.17,21.91,10,9,5,6,6,0
3,1,0,2,1,1,5,10.95,6,394.38,0.02,19,0.17,21.91,10,9,5,6,6,0
3,1,0,2,1,1,5,10.95,6,394.38,0.02,19,0.17,21.91,10,9,5,6,6,0
3,1,1,2,1,1,5,10.95,6,394.38,0.02,19,0.17,21.91,10,9,5,6,6,0
1,0,0,1,1,1,3,13,3,117,0.01,13,0.33,6.5,6,7,4,4,3,0
1,0,0,1,1,1,2,11.07,3,99.66,0.01,10,0.33,5.54,4,6,4,6,2,0
1,0,0,1,1,1,2,7.74,1.5,17.41,0,5,0.67,0.97,2,3,2,3,2,0
3,0,1,2,1,1,8,16.92,4.5,342.66,0.03,20,0.22,19.04,9,11,7,7,8,0
3,1,0,2,1,1,7,16.92,4.5,342.66,0.03,20,0.22,19.04,9,11,7,7,8,0
1,0,0,1,1,1,2,11.41,2.5,71.32,0.01,9,0.4,3.96,4,5,4,5,2,0
3,1,0,2,1,1,5,10.95,6,394.38,0.02,19,0.17,21.91,10,9,5,6,6,0
1,0,0,1,1,1,4,16.51,4.8,380.39,0.03,25,0.21,21.13,12,13,5,4,4,0
1,0,0,1,1,1,2,7.74,1.5,17.41,0,5,0.67,0.97,2,3,2,3,2,0
3,1,0,2,1,1,5,10.95,6,394.38,0.02,19,0.17,21.91,10,9,5,6,6,0
3,1,0,2,1,1,5,10.95,6,394.38,0.02,19,0.17,21.91,10,9,5,6,6,0
1,0,0,1,1,1,2,9.83,2,39.3,0.01,7,0.5,2.18,3,4,3,4,2,0
1,0,0,1,1,1,0,0,0,0,0,1,0,0,0,1,0,1,0,0
5,0,0,3,1,1,2,13.29,4.5,269.08,0.02,18,0.22,14.95,6,12,4,6,2,0
1,0,1,1,1,1,2,16.92,3.5,207.22,0.02,16,0.29,11.51,6,10,6,7,2,0
5,1,4,3,1,1,6,12.6,6.67,560,0.03,21,0.15,31.11,8,13,6,10,7,0
47,37,16,24,20,1,135,154.64,21.96,74563.65,1.13,510,0.05,4142.42,217,293,84,17,172,1
5,4,6,3,1,1,8,14.15,17.6,4384.57,0.08,53,0.06,243.59,22,31,10,16,12,1
1,0,0,1,1,1,2,0,0,0,0,5,0,0,0,5,0,5,2,0
1,0,0,1,1,1,0,0,0,0,0,5,0,0,0,5,0,5,0,0
1,0,0,1,1,1,0,0,0,0,0,5,0,0,0,5,0,5,0,0
1,0,0,1,1,1,0,0,0,0,0,1,0,0,0,1,0,1,0,0
1,0,0,1,1,1,2,0,0,0,0.01,6,0,0,0,6,0,6,2,0
3,6,2,1,1,1,7,30.41,6.79,1400.05,0.07,45,0.15,77.78,19,26,14,10,13,1
17,20,22,9,7,1,47,43.41,29.97,38986.01,0.43,224,0.03,2165.89,86,138,33,23,67,1
13,9,9,7,3,6,26,45.86,18.37,15468.53,0.28,150,0.05,859.36,58,92,30,19,35,1
33,23,34,17,8,8,83,66.58,39.9,106001.96,0.89,432,0.03,5889,190,242,50,21,106,1
3,3,5,2,2,1,9,13.33,7.5,750,0.03,25,0.13,41.67,9,16,6,10,12,1
1,0,0,1,1,1,2,5.33,1.5,12,0,4,0.67,0.67,1,3,1,3,2,0
1,0,1,1,1,1,2,6.97,2,27.86,0,6,0.5,1.55,1,5,1,4,2,0
1,0,1,1,1,1,2,6.97,2,27.86,0,6,0.5,1.55,1,5,1,4,2,0
1,0,0,1,1,1,0,0,0,0,0,1,0,0,0,1,0,1,0,0
1,0,2,1,1,1,3,4.14,5,103.4,0.01,8,0.2,5.74,2,6,1,5,3,0
1,0,1,1,1,1,2,5.33,1.5,12,0,4,0.67,0.67,1,3,1,3,2,0
1,0,1,1,1,1,2,6.2,2.5,38.77,0.01,6,0.4,2.15,1,5,1,5,2,0
1,0,1,1,1,1,2,7.74,1.5,17.41,0,5,0.67,0.97,2,3,2,3,2,0
1,2,10,1,1,1,45,170.92,10.64,19336.91,0.61,303,0.09,1074.27,130,173,55,9,47,1
1,0,0,1,1,1,1,0,0,0,0,1,0,0,0,1,0,1,1,0
1,0,0,1,1,1,2,5.33,1.5,12,0,4,0.67,0.67,1,3,1,3,2,0
1,0,0,1,1,1,2,10.44,3.5,127.89,0.01,11,0.29,7.11,3,8,3,7,2,0
1,0,0,1,1,1,2,10.44,3.5,127.89,0.01,11,0.29,7.11,3,8,3,7,2,0
1,0,0,1,1,1,2,7.49,3,67.38,0.01,8,0.33,3.74,1,7,1,6,2,0
1,0,0,1,1,1,2,9,3,81,0.01,9,0.33,4.5,2,7,2,6,2,0
1,0,0,1,1,1,2,9,3,81,0.01,9,0.33,4.5,2,7,2,6,2,0
1,0,0,1,1,1,2,9,3,81,0.01,9,0.33,4.5,2,7,2,6,2,0
1,0,0,1,1,1,2,10.44,3.5,127.89,0.01,11,0.29,7.11,3,8,3,7,2,0
1,0,0,1,1,1,2,9,3,81,0.01,9,0.33,4.5,2,7,2,6,2,0
1,0,0,1,1,1,2,9,3,81,0.01,9,0.33,4.5,2,7,2,6,2,0
1,0,0,1,1,1,2,7.49,3,67.38,0.01,8,0.33,3.74,1,7,1,6,2,0
1,0,0,1,1,1,2,7.49,3,67.38,0.01,8,0.33,3.74,1,7,1,6,2,0
1,0,0,1,1,1,2,10,3,90,0.01,10,0.33,5,2,8,2,6,2,0
1,0,0,1,1,1,3,10.44,3.5,127.89,0.01,11,0.29,7.11,3,8,3,7,3,0
1,0,0,1,1,1,3,11.39,3.5,139.52,0.01,12,0.29,7.75,3,9,3,7,3,0
1,0,0,1,1,1,2,9,3,81,0.01,9,0.33,4.5,2,7,2,6,2,0
1,0,0,1,1,1,2,10.44,3.5,127.89,0.01,11,0.29,7.11,3,8,3,7,2,0
1,0,0,1,1,1,2,9,3,81,0.01,9,0.33,4.5,2,7,2,6,2,0
1,0,0,1,1,1,2,9,3,81,0.01,9,0.33,4.5,2,7,2,6,2,0
1,0,0,1,1,1,2,10.44,3.5,127.89,0.01,11,0.29,7.11,3,8,3,7,2,0
1,0,0,1,1,1,2,9,3,81,0.01,9,0.33,4.5,2,7,2,6,2,0
1,0,0,1,1,1,2,9,3,81,0.01,9,0.33,4.5,2,7,2,6,2,0
1,0,0,1,1,1,2,9,3,81,0.01,9,0.33,4.5,2,7,2,6,2,0
1,0,0,1,1,1,2,7.49,3,67.38,0.01,8,0.33,3.74,1,7,1,6,2,0
1,0,0,1,1,1,2,9,3,81,0.01,9,0.33,4.5,2,7,2,6,2,0
1,0,0,1,1,1,2,9,3,81,0.01,9,0.33,4.5,2,7,2,6,2,0
1,0,0,1,1,1,2,10.44,3.5,127.89,0.01,11,0.29,7.11,3,8,3,7,2,0
1,0,0,1,1,1,2,9.05,2,36.19,0.01,7,0.5,2,2,5,2,4,2,0
1,0,0,1,1,1,2,9.05,2,36.19,0.01,7,0.5,2,2,5,2,4,2,0
1,0,0,1,1,1,2,9.05,2,36.19,0.01,7,0.5,2,2,5,2,4,2,0
1,0,0,1,1,1,2,9.05,2,36.19,0.01,7,0.5,2,2,5,2,4,2,0
1,0,0,1,1,1,2,9.05,2,36.19,0.01,7,0.5,2,2,5,2,4,2,0
1,0,0,1,1,1,2,9.05,2,36.19,0.01,7,0.5,2,2,5,2,4,2,0
1,0,0,1,1,1,2,9.05,2,36.19,0.01,7,0.5,2,2,5,2,4,2,0
1,0,0,1,1,1,2,9.05,2,36.19,0.01,7,0.5,2,2,5,2,4,2,0
1,0,0,1,1,1,2,9.05,2,36.19,0.01,7,0.5,2,2,5,2,4,2,0
1,0,0,1,1,1,2,9.05,2,36.19,0.01,7,0.5,2,2,5,2,4,2,0
1,0,0,1,1,1,2,9.05,2,36.19,0.01,7,0.5,2,2,5,2,4,2,0
1,0,0,1,1,1,2,9.05,2,36.19,0.01,7,0.5,2,2,5,2,4,2,0
1,0,0,1,1,1,2,9.05,2,36.19,0.01,7,0.5,2,2,5,2,4,2,0
1,0,0,1,1,1,2,10.44,3.5,127.89,0.01,11,0.29,7.11,3,8,3,7,2,0
1,0,0,1,1,1,2,10.44,3.5,127.89,0.01,11,0.29,7.11,3,8,3,7,2,0
1,0,0,1,1,1,2,9.05,2,36.19,0.01,7,0.5,2,2,5,2,4,2,0
1,0,0,1,1,1,0,0,0,0,0,1,0,0,0,1,0,1,0,0
1,0,0,1,1,1,2,5.33,1.5,12,0,4,0.67,0.67,1,3,1,3,2,0
3,0,0,2,1,1,6,11.86,4.38,227.03,0.02,15,0.23,12.61,5,10,4,7,6,0
3,2,0,2,1,1,6,14.43,5.14,381.76,0.02,19,0.19,21.21,9,10,7,8,8,0
5,1,0,3,1,1,10,12.67,10,1267.11,0.04,31,0.1,70.4,14,17,7,10,11,0
3,1,0,2,1,1,6,11.71,4.9,281.06,0.02,16,0.2,15.61,7,9,5,7,7,0
3,1,0,2,1,1,6,11.71,4.9,281.06,0.02,16,0.2,15.61,7,9,5,7,7,0
1,0,0,1,1,1,2,5.33,1.5,12,0,4,0.67,0.67,1,3,1,3,2,0
1,0,0,1,1,1,2,5.33,1.5,12,0,4,0.67,0.67,1,3,1,3,2,0
3,1,0,2,1,1,6,11.23,5.6,352.28,0.02,17,0.18,19.57,7,10,5,8,7,0
7,1,1,4,1,3,13,18.91,10.45,2065.48,0.07,45,0.1,114.75,19,26,10,11,14,0
5,1,0,3,1,1,10,13.33,9,1080,0.04,30,0.11,60,14,16,7,9,11,0
3,1,0,2,1,1,6,11.71,4.9,281.06,0.02,16,0.2,15.61,7,9,5,7,7,0
7,1,1,4,1,3,13,18.91,10.45,2065.48,0.07,45,0.1,114.75,19,26,10,11,14,0
3,1,0,2,1,1,6,11.71,4.9,281.06,0.02,16,0.2,15.61,7,9,5,7,7,0
3,0,0,2,1,1,6,11.86,4.38,227.03,0.02,15,0.23,12.61,5,10,4,7,6,0
3,2,0,2,1,1,7,16.73,5.5,506,0.03,23,0.18,28.11,11,12,8,8,9,0
1,0,0,1,1,1,2,5.33,1.5,12,0,4,0.67,0.67,1,3,1,3,2,0
9,6,0,5,1,1,14,23.12,11.15,2875.94,0.09,57,0.09,159.77,29,28,13,10,20,0
3,1,0,2,1,1,7,14.43,5.14,381.76,0.02,19,0.19,21.21,9,10,7,8,8,0
7,1,1,4,1,3,13,19.62,10,1962.15,0.07,44,0.1,109.01,20,24,11,11,14,0
1,0,0,1,1,1,2,5.33,1.5,12,0,4,0.67,0.67,1,3,1,3,2,0
1,0,0,1,1,1,2,5.33,1.5,12,0,4,0.67,0.67,1,3,1,3,2,0
1,0,0,1,1,1,2,5.33,1.5,12,0,4,0.67,0.67,1,3,1,3,2,0
1,0,0,1,1,1,2,5.33,1.5,12,0,4,0.67,0.67,1,3,1,3,2,0
1,0,0,1,1,1,2,5.33,1.5,12,0,4,0.67,0.67,1,3,1,3,2,0
1,0,0,1,1,1,2,5.33,1.5,12,0,4,0.67,0.67,1,3,1,3,2,0
3,1,0,2,1,1,5,10.95,6,394.38,0.02,19,0.17,21.91,10,9,5,6,6,0
3,1,0,2,1,1,5,10.95,6,394.38,0.02,19,0.17,21.91,10,9,5,6,6,0
3,1,0,2,1,1,5,10.95,6,394.38,0.02,19,0.17,21.91,10,9,5,6,6,0
3,1,0,2,1,1,5,10.95,6,394.38,0.02,19,0.17,21.91,10,9,5,6,6,0
3,1,1,2,1,1,5,10.95,6,394.38,0.02,19,0.17,21.91,10,9,5,6,6,0
1,0,0,1,1,1,3,13,3,117,0.01,13,0.33,6.5,6,7,4,4,3,0
1,0,0,1,1,1,2,11.07,3,99.66,0.01,10,0.33,5.54,4,6,4,6,2,0
1,0,0,1,1,1,2,7.74,1.5,17.41,0,5,0.67,0.97,2,3,2,3,2,0
3,0,1,2,1,1,8,16.92,4.5,342.66,0.03,20,0.22,19.04,9,11,7,7,8,0
3,1,0,2,1,1,7,16.92,4.5,342.66,0.03,20,0.22,19.04,9,11,7,7,8,0
1,0,0,1,1,1,2,11.41,2.5,71.32,0.01,9,0.4,3.96,4,5,4,5,2,0
3,1,0,2,1,1,5,10.95,6,394.38,0.02,19,0.17,21.91,10,9,5,6,6,0
1,0,0,1,1,1,4,16.51,4.8,380.39,0.03,25,0.21,21.13,12,13,5,4,4,0
1,0,0,1,1,1,2,7.74,1.5,17.41,0,5,0.67,0.97,2,3,2,3,2,0
3,1,0,2,1,1,5,10.95,6,394.38,0.02,19,0.17,21.91,10,9,5,6,6,0
3,1,0,2,1,1,5,10.95,6,394.38,0.02,19,0.17,21.91,10,9,5,6,6,0
1,0,0,1,1,1,2,9.83,2,39.3,0.01,7,0.5,2.18,3,4,3,4,2,0
17,22,23,9,7,1,54,61.23,30,55111.29,0.61,311,0.03,3061.74,140,171,42,18,76,1
5,0,0,3,1,1,2,13.29,4.5,269.08,0.02,18,0.22,14.95,6,12,4,6,2,0
1,0,1,1,1,1,2,16.92,3.5,207.22,0.02,16,0.29,11.51,6,10,6,7,2,0
1,0,1,1,1,1,2,9.05,2,36.19,0.01,7,0.5,2,2,5,2,4,2,0
1,0,1,1,1,1,2,7.24,2.5,45.24,0.01,7,0.4,2.51,1,6,1,5,2,0
1,0,1,1,1,1,2,7.24,2.5,45.24,0.01,7,0.4,2.51,1,6,1,5,2,0
1,0,1,1,1,1,2,10.8,2.5,67.5,0.01,9,0.4,3.75,3,6,3,5,2,0
1,0,1,1,1,1,2,8.98,2.5,56.15,0.01,8,0.4,3.12,2,6,2,5,2,0
1,0,0,1,1,1,0,0,0,0,0,1,0,0,0,1,0,1,0,0
1,0,2,1,1,1,3,4.14,5,103.4,0.01,8,0.2,5.74,2,6,1,5,3,0
1,0,1,1,1,1,2,5.33,1.5,12,0,4,0.67,0.67,1,3,1,3,2,0
1,0,1,1,1,1,2,6.2,2.5,38.77,0.01,6,0.4,2.15,1,5,1,5,2,0
1,0,1,1,1,1,2,7.74,1.5,17.41,0,5,0.67,0.97,2,3,2,3,2,0
1,0,1,1,1,1,2,9.05,2,36.19,0.01,7,0.5,2,2,5,2,4,2,0
1,0,1,1,1,1,2,9.05,2,36.19,0.01,7,0.5,2,2,5,2,4,2,0
1,0,1,1,1,1,2,9.05,2,36.19,0.01,7,0.5,2,2,5,2,4,2,0
1,0,1,1,1,1,2,10.8,2.5,67.5,0.01,9,0.4,3.75,3,6,3,5,2,0
1,0,1,1,1,1,2,6.97,2,27.86,0,6,0.5,1.55,1,5,1,4,2,0
1,0,1,1,1,1,2,6.97,2,27.86,0,6,0.5,1.55,1,5,1,4,2,0
1,0,0,1,1,1,1,0,0,0,0,1,0,0,0,1,0,1,1,0
1,0,0,1,1,1,0,0,0,0,0,1,0,0,0,1,0,1,0,0
11,13,12,1,1,1,39,71.8,17.23,21318.44,0.41,216,0.06,1184.36,96,120,39,14,52,1
5,0,0,3,1,1,2,13.29,4.5,269.08,0.02,18,0.22,14.95,6,12,4,6,2,0
1,0,1,1,1,1,2,16.92,3.5,207.22,0.02,16,0.29,11.51,6,10,6,7,2,0
3,1,6,1,1,1,11,43.76,5.41,1281.7,0.08,51,0.18,71.21,23,28,17,8,12,1
9,13,8,5,4,1,21,35.54,14,6965.57,0.17,97,0.07,386.98,42,55,21,14,34,1
3,6,3,2,2,1,11,34.84,11.29,4444.2,0.13,81,0.09,246.9,32,49,17,12,17,1
1,1,2,1,1,1,3,9,3.33,100,0.01,10,0.3,5.56,4,6,3,5,4,1
1,0,0,1,1,1,2,0,0,0,0,5,0,0,0,5,0,5,2,0
1,0,0,1,1,1,0,0,0,0,0,5,0,0,0,5,0,5,0,0
1,0,0,1,1,1,0,0,0,0,0,5,0,0,0,5,0,5,0,0
1,0,0,1,1,1,0,0,0,0,0,1,0,0,0,1,0,1,0,0
1,0,0,1,1,1,2,0,0,0,0.01,6,0,0,0,6,0,6,2,0
21,20,25,12,10,1,55,60.5,25.94,40696.35,0.52,256,0.04,2260.91,106,150,47,23,75,1
1,0,0,1,1,1,2,5.33,1.5,12,0,4,0.67,0.67,1,3,1,3,2,0
1,0,0,1,1,1,0,0,0,0,0,1,0,0,0,1,0,1,0,0
1,0,2,1,1,1,3,4.14,5,103.4,0.01,8,0.2,5.74,2,6,1,5,3,0
1,0,1,1,1,1,2,5.33,1.5,12,0,4,0.67,0.67,1,3,1,3,2,0
1,0,1,1,1,1,2,6.2,2.5,38.77,0.01,6,0.4,2.15,1,5,1,5,2,0
1,0,1,1,1,1,2,7.74,1.5,17.41,0,5,0.67,0.97,2,3,2,3,2,0
1,0,0,1,1,1,1,0,0,0,0,1,0,0,0,1,0,1,1,0
1,0,0,1,1,1,2,5.33,1.5,12,0,4,0.67,0.67,1,3,1,3,2,0
1,0,0,1,1,1,2,10.44,3.5,127.89,0.01,11,0.29,7.11,3,8,3,7,2,0
1,0,0,1,1,1,2,10.44,3.5,127.89,0.01,11,0.29,7.11,3,8,3,7,2,0
1,0,0,1,1,1,2,7.49,3,67.38,0.01,8,0.33,3.74,1,7,1,6,2,0
1,0,0,1,1,1,2,9,3,81,0.01,9,0.33,4.5,2,7,2,6,2,0
1,0,0,1,1,1,2,9,3,81,0.01,9,0.33,4.5,2,7,2,6,2,0
1,0,0,1,1,1,2,9,3,81,0.01,9,0.33,4.5,2,7,2,6,2,0
1,0,0,1,1,1,2,10.44,3.5,127.89,0.01,11,0.29,7.11,3,8,3,7,2,0
1,0,0,1,1,1,2,9,3,81,0.01,9,0.33,4.5,2,7,2,6,2,0
1,0,0,1,1,1,2,9,3,81,0.01,9,0.33,4.5,2,7,2,6,2,0
1,0,0,1,1,1,2,7.49,3,67.38,0.01,8,0.33,3.74,1,7,1,6,2,0
1,0,0,1,1,1,2,7.49,3,67.38,0.01,8,0.33,3.74,1,7,1,6,2,0
1,0,0,1,1,1,2,10,3,90,0.01,10,0.33,5,2,8,2,6,2,0
1,0,0,1,1,1,3,10.44,3.5,127.89,0.01,11,0.29,7.11,3,8,3,7,3,0
1,0,0,1,1,1,3,11.39,3.5,139.52,0.01,12,0.29,7.75,3,9,3,7,3,0
1,0,0,1,1,1,2,9,3,81,0.01,9,0.33,4.5,2,7,2,6,2,0
1,0,0,1,1,1,2,10.44,3.5,127.89,0.01,11,0.29,7.11,3,8,3,7,2,0
1,0,0,1,1,1,2,9,3,81,0.01,9,0.33,4.5,2,7,2,6,2,0
1,0,0,1,1,1,2,9,3,81,0.01,9,0.33,4.5,2,7,2,6,2,0
1,0,0,1,1,1,2,10.44,3.5,127.89,0.01,11,0.29,7.11,3,8,3,7,2,0
1,0,0,1,1,1,2,9,3,81,0.01,9,0.33,4.5,2,7,2,6,2,0
1,0,0,1,1,1,2,9,3,81,0.01,9,0.33,4.5,2,7,2,6,2,0
1,0,0,1,1,1,2,9,3,81,0.01,9,0.33,4.5,2,7,2,6,2,0
1,0,0,1,1,1,2,7.49,3,67.38,0.01,8,0.33,3.74,1,7,1,6,2,0
1,0,0,1,1,1,2,9,3,81,0.01,9,0.33,4.5,2,7,2,6,2,0
1,0,0,1,1,1,2,9,3,81,0.01,9,0.33,4.5,2,7,2,6,2,0
1,0,0,1,1,1,2,10.44,3.5,127.89,0.01,11,0.29,7.11,3,8,3,7,2,0
1,0,0,1,1,1,2,9.05,2,36.19,0.01,7,0.5,2,2,5,2,4,2,0
1,0,0,1,1,1,2,9.05,2,36.19,0.01,7,0.5,2,2,5,2,4,2,0
1,0,0,1,1,1,2,9.05,2,36.19,0.01,7,0.5,2,2,5,2,4,2,0
1,0,0,1,1,1,2,9.05,2,36.19,0.01,7,0.5,2,2,5,2,4,2,0
1,0,0,1,1,1,2,9.05,2,36.19,0.01,7,0.5,2,2,5,2,4,2,0
1,0,0,1,1,1,2,9.05,2,36.19,0.01,7,0.5,2,2,5,2,4,2,0
1,0,0,1,1,1,2,9.05,2,36.19,0.01,7,0.5,2,2,5,2,4,2,0
1,0,0,1,1,1,2,9.05,2,36.19,0.01,7,0.5,2,2,5,2,4,2,0
1,0,0,1,1,1,2,9.05,2,36.19,0.01,7,0.5,2,2,5,2,4,2,0
1,0,0,1,1,1,2,9.05,2,36.19,0.01,7,0.5,2,2,5,2,4,2,0
1,0,0,1,1,1,2,9.05,2,36.19,0.01,7,0.5,2,2,5,2,4,2,0
1,0,0,1,1,1,2,9.05,2,36.19,0.01,7,0.5,2,2,5,2,4,2,0
1,0,0,1,1,1,2,9.05,2,36.19,0.01,7,0.5,2,2,5,2,4,2,0
1,0,0,1,1,1,2,10.44,3.5,127.89,0.01,11,0.29,7.11,3,8,3,7,2,0
1,0,0,1,1,1,2,10.44,3.5,127.89,0.01,11,0.29,7.11,3,8,3,7,2,0
1,0,0,1,1,1,2,9.05,2,36.19,0.01,7,0.5,2,2,5,2,4,2,0
1,0,0,1,1,1,0,0,0,0,0,1,0,0,0,1,0,1,0,0
1,0,0,1,1,1,2,5.33,1.5,12,0,4,0.67,0.67,1,3,1,3,2,0
3,0,0,2,1,1,6,11.86,4.38,227.03,0.02,15,0.23,12.61,5,10,4,7,6,0
3,2,0,2,1,1,6,14.43,5.14,381.76,0.02,19,0.19,21.21,9,10,7,8,8,0
5,1,0,3,1,1,10,12.67,10,1267.11,0.04,31,0.1,70.4,14,17,7,10,11,0
3,1,0,2,1,1,6,11.71,4.9,281.06,0.02,16,0.2,15.61,7,9,5,7,7,0
3,1,0,2,1,1,6,11.71,4.9,281.06,0.02,16,0.2,15.61,7,9,5,7,7,0
1,0,0,1,1,1,2,5.33,1.5,12,0,4,0.67,0.67,1,3,1,3,2,0
1,0,0,1,1,1,2,5.33,1.5,12,0,4,0.67,0.67,1,3,1,3,2,0
3,1,0,2,1,1,6,11.23,5.6,352.28,0.02,17,0.18,19.57,7,10,5,8,7,0
7,1,1,4,1,3,13,18.91,10.45,2065.48,0.07,45,0.1,114.75,19,26,10,11,14,0
5,1,0,3,1,1,10,13.33,9,1080,0.04,30,0.11,60,14,16,7,9,11,0
3,1,0,2,1,1,6,11.71,4.9,281.06,0.02,16,0.2,15.61,7,9,5,7,7,0
7,1,1,4,1,3,13,18.91,10.45,2065.48,0.07,45,0.1,114.75,19,26,10,11,14,0
3,1,0,2,1,1,6,11.71,4.9,281.06,0.02,16,0.2,15.61,7,9,5,7,7,0
3,0,0,2,1,1,6,11.86,4.38,227.03,0.02,15,0.23,12.61,5,10,4,7,6,0
3,2,0,2,1,1,7,16.73,5.5,506,0.03,23,0.18,28.11,11,12,8,8,9,0
1,0,0,1,1,1,2,5.33,1.5,12,0,4,0.67,0.67,1,3,1,3,2,0
9,6,0,5,1,1,14,23.12,11.15,2875.94,0.09,57,0.09,159.77,29,28,13,10,20,0
3,1,0,2,1,1,7,14.43,5.14,381.76,0.02,19,0.19,21.21,9,10,7,8,8,0
7,1,1,4,1,3,13,19.62,10,1962.15,0.07,44,0.1,109.01,20,24,11,11,14,0
1,0,0,1,1,1,2,5.33,1.5,12,0,4,0.67,0.67,1,3,1,3,2,0
1,0,0,1,1,1,2,5.33,1.5,12,0,4,0.67,0.67,1,3,1,3,2,0
1,0,0,1,1,1,2,5.33,1.5,12,0,4,0.67,0.67,1,3,1,3,2,0
1,0,0,1,1,1,2,5.33,1.5,12,0,4,0.67,0.67,1,3,1,3,2,0
1,0,0,1,1,1,2,5.33,1.5,12,0,4,0.67,0.67,1,3,1,3,2,0
1,0,0,1,1,1,2,5.33,1.5,12,0,4,0.67,0.67,1,3,1,3,2,0
3,1,0,2,1,1,5,10.95,6,394.38,0.02,19,0.17,21.91,10,9,5,6,6,0
3,1,0,2,1,1,5,10.95,6,394.38,0.02,19,0.17,21.91,10,9,5,6,6,0
3,1,0,2,1,1,5,10.95,6,394.38,0.02,19,0.17,21.91,10,9,5,6,6,0
3,1,0,2,1,1,5,10.95,6,394.38,0.02,19,0.17,21.91,10,9,5,6,6,0
3,1,1,2,1,1,5,10.95,6,394.38,0.02,19,0.17,21.91,10,9,5,6,6,0
1,0,0,1,1,1,3,13,3,117,0.01,13,0.33,6.5,6,7,4,4,3,0
1,0,0,1,1,1,2,11.07,3,99.66,0.01,10,0.33,5.54,4,6,4,6,2,0
1,0,0,1,1,1,2,7.74,1.5,17.41,0,5,0.67,0.97,2,3,2,3,2,0
3,0,1,2,1,1,8,16.92,4.5,342.66,0.03,20,0.22,19.04,9,11,7,7,8,0
3,1,0,2,1,1,7,16.92,4.5,342.66,0.03,20,0.22,19.04,9,11,7,7,8,0
1,0,0,1,1,1,2,11.41,2.5,71.32,0.01,9,0.4,3.96,4,5,4,5,2,0
3,1,0,2,1,1,5,10.95,6,394.38,0.02,19,0.17,21.91,10,9,5,6,6,0
1,0,0,1,1,1,4,16.51,4.8,380.39,0.03,25,0.21,21.13,12,13,5,4,4,0
1,0,0,1,1,1,2,7.74,1.5,17.41,0,5,0.67,0.97,2,3,2,3,2,0
3,1,0,2,1,1,5,10.95,6,394.38,0.02,19,0.17,21.91,10,9,5,6,6,0
3,1,0,2,1,1,5,10.95,6,394.38,0.02,19,0.17,21.91,10,9,5,6,6,0
1,0,0,1,1,1,2,9.83,2,39.3,0.01,7,0.5,2.18,3,4,3,4,2,0
23,33,38,12,12,1,78,114.21,22.75,59111.61,0.87,411,0.04,3283.98,182,229,64,16,111,1
1,0,0,1,1,1,1,0,0,0,0,1,0,0,0,1,0,1,1,1
11,2,2,6,4,1,33,24.34,30.8,23085.59,0.25,139,0.03,1282.53,56,83,20,22,35,0
9,0,2,5,2,1,24,20.26,14,3970.88,0.09,59,0.07,220.6,21,38,12,16,24,1
1,2,0,1,1,1,1,16.84,1.5,37.9,0.01,9,0.67,2.11,4,5,4,3,3,0
1,0,0,1,1,1,2,5.33,1.5,12,0,4,0.67,0.67,1,3,1,3,2,0
5,1,8,3,2,1,22,21.51,13,3635.88,0.09,61,0.08,201.99,26,35,12,12,23,0
1,0,0,1,1,1,0,0,0,0,0,0,0,0,0,0,0,0,0,0
1,0,0,1,1,1,1,0,0,0,0,1,0,0,0,1,0,1,1,0
1,0,0,1,1,1,1,0,0,0,0,1,0,0,0,1,0,1,1,0
1,0,0,1,1,1,1,0,0,0,0,1,0,0,0,1,0,1,1,0
1,0,0,1,1,1,1,0,0,0,0,1,0,0,0,1,0,1,1,0
1,0,0,1,1,1,1,0,0,0,0,1,0,0,0,1,0,1,1,0
1,0,0,1,1,1,1,0,0,0,0,1,0,0,0,1,0,1,1,0
1,0,0,1,1,1,2,5.33,1.5,12,0,4,0.67,0.67,1,3,1,3,2,0
1,0,0,1,1,1,2,5.33,1.5,12,0,4,0.67,0.67,1,3,1,3,2,0
1,0,0,1,1,1,2,5.33,1.5,12,0,4,0.67,0.67,1,3,1,3,2,0
1,0,0,1,1,1,2,5.33,1.5,12,0,4,0.67,0.67,1,3,1,3,2,0
1,0,0,1,1,1,2,5.33,1.5,12,0,4,0.67,0.67,1,3,1,3,2,0
1,0,0,1,1,1,2,5.33,1.5,12,0,4,0.67,0.67,1,3,1,3,2,0
1,0,0,1,1,1,2,5.33,1.5,12,0,4,0.67,0.67,1,3,1,3,2,0
1,0,0,1,1,1,2,5.33,1.5,12,0,4,0.67,0.67,1,3,1,3,2,0
1,0,0,1,1,1,2,5.33,1.5,12,0,4,0.67,0.67,1,3,1,3,2,0
1,0,0,1,1,1,2,0,0,0,0,4,0,0,0,4,0,4,2,0
1,0,0,1,1,1,1,0,0,0,0,1,0,0,0,1,0,1,1,0
1,0,0,1,1,1,2,0,0,0,0,5,0,0,0,5,0,5,2,0
1,0,0,1,1,1,2,20.97,3,188.72,0.02,17,0.33,10.48,7,10,7,6,2,0
1,0,0,1,1,1,2,20.97,3,188.72,0.02,17,0.33,10.48,7,10,7,6,2,0
1,0,0,1,1,1,2,27.35,3,246.13,0.03,21,0.33,13.67,9,12,9,6,2,0
1,0,0,1,1,1,3,30.67,3,276,0.03,23,0.33,15.33,10,13,10,6,3,0
1,0,0,1,1,1,3,30.67,3,276,0.03,23,0.33,15.33,10,13,10,6,3,0
1,0,0,1,1,1,3,30.67,3,276,0.03,23,0.33,15.33,10,13,10,6,3,0
1,0,0,1,1,1,2,27.35,3,246.13,0.03,21,0.33,13.67,9,12,9,6,2,0
1,0,0,1,1,1,3,27.35,3,246.13,0.03,21,0.33,13.67,9,12,9,6,3,0
1,0,0,1,1,1,2,20.97,3,188.72,0.02,17,0.33,10.48,7,10,7,6,2,0
1,0,0,1,1,1,2,20.97,3,188.72,0.02,17,0.33,10.48,7,10,7,6,2,0
1,0,0,1,1,1,2,20.97,3,188.72,0.02,17,0.33,10.48,7,10,7,6,2,0
1,0,0,1,1,1,2,17.92,3,161.32,0.02,15,0.33,8.96,6,9,6,6,2,0
1,0,0,1,1,1,2,17.92,3,161.32,0.02,15,0.33,8.96,6,9,6,6,2,0
1,0,0,1,1,1,2,14.99,3,134.92,0.01,13,0.33,7.5,5,8,5,6,2,0
1,0,0,1,1,1,2,14.99,3,134.92,0.01,13,0.33,7.5,5,8,5,6,2,0
1,0,0,1,1,1,2,14.99,3,134.92,0.01,13,0.33,7.5,5,8,5,6,2,0
1,0,0,1,1,1,2,14.99,3,134.92,0.01,13,0.33,7.5,5,8,5,6,2,0
1,0,0,1,1,1,2,14.99,3,134.92,0.01,13,0.33,7.5,5,8,5,6,2,0
1,0,0,1,1,1,2,17.92,3,161.32,0.02,15,0.33,8.96,6,9,6,6,2,0
1,0,0,1,1,1,2,17.92,3,161.32,0.02,15,0.33,8.96,6,9,6,6,2,0
1,2,0,1,1,1,1,16.84,1.5,37.9,0.01,9,0.67,2.11,4,5,4,3,3,0
1,0,0,1,1,1,2,5.33,1.5,12,0,4,0.67,0.67,1,3,1,3,2,0
21,0,4,11,4,7,68,64.97,24.74,39779.57,0.54,270,0.04,2209.98,112,158,43,19,68,0
21,0,4,11,4,7,68,63.53,24.74,38895.58,0.52,264,0.04,2160.87,112,152,43,19,68,0
21,0,3,11,4,7,60,53.97,27.89,41995.56,0.5,257,0.04,2333.09,106,151,38,20,60,0
17,0,3,9,4,5,58,52.8,26.39,36767.84,0.46,241,0.04,2042.66,100,141,36,19,58,0
19,0,3,10,4,6,59,54.96,26,37155.51,0.48,245,0.04,2064.19,104,141,38,19,59,0
19,0,3,10,4,6,59,54.96,26,37155.51,0.48,245,0.04,2064.19,104,141,38,19,59,0
17,0,3,9,4,5,58,51.48,26.39,35852.46,0.45,235,0.04,1991.8,100,135,36,19,58,0
13,0,2,7,4,5,53,49.71,24.17,29043.67,0.4,214,0.04,1613.54,91,123,32,17,53,0
15,0,3,8,4,5,57,52.14,25.15,32970.33,0.44,230,0.04,1831.69,95,135,34,18,57,0
15,0,3,8,4,5,57,50.78,25.15,32110.24,0.43,224,0.04,1783.9,95,129,34,18,57,0
13,0,2,7,4,5,53,49.71,24.17,29043.67,0.4,214,0.04,1613.54,91,123,32,17,53,0
17,0,3,9,4,6,57,52.59,24.94,32717.39,0.44,229,0.04,1817.63,97,132,35,18,57,0
1,0,0,1,1,1,2,20.97,3,188.72,0.02,17,0.33,10.48,7,10,7,6,2,0
15,0,2,8,4,6,54,53.43,23.25,28882.57,0.41,219,0.04,1604.59,93,126,34,17,54,0
1,0,0,1,1,1,2,20.97,3,188.72,0.02,17,0.33,10.48,7,10,7,6,2,0
15,0,2,8,4,6,54,53.43,23.25,28882.57,0.41,219,0.04,1604.59,93,126,34,17,54,0
1,0,0,1,1,1,0,0,0,0,0,1,0,0,0,1,0,1,0,0
1,0,0,1,1,1,0,0,0,0,0,1,0,0,0,1,0,1,0,0
3,0,1,2,2,1,13,14.31,10,1430.61,0.05,35,0.1,79.48,14,21,7,10,13,0
1,0,0,1,1,1,0,0,0,0,0,1,0,0,0,1,0,1,0,0
1,0,0,1,1,1,0,0,0,0,0,1,0,0,0,1,0,1,0,0
3,0,1,2,2,1,13,14.5,8.67,1088.9,0.04,33,0.12,60.49,13,20,6,8,13,0
1,0,0,1,1,1,0,0,0,0,0,1,0,0,0,1,0,1,0,0
1,0,0,1,1,1,0,0,0,0,0,1,0,0,0,1,0,1,0,0
1,0,0,1,1,1,0,0,0,0,0,1,0,0,0,1,0,1,0,0
5,0,2,3,3,1,19,22.56,12.83,3715.35,0.1,64,0.08,206.41,28,36,12,11,19,0
1,0,0,1,1,1,0,0,0,0,0,1,0,0,0,1,0,1,0,0
1,0,0,1,1,1,0,0,0,0,0,1,0,0,0,1,0,1,0,0
17,1,5,9,5,7,79,52.48,32.46,55302.23,0.57,285,0.03,3072.35,121,164,41,22,80,0
1,0,0,1,1,1,0,0,0,0,0,1,0,0,0,1,0,1,0,0
1,0,0,1,1,1,0,0,0,0,0,1,0,0,0,1,0,1,0,0
5,0,2,3,3,1,24,23.71,13.54,4345.13,0.11,70,0.07,241.4,32,38,13,11,24,0
5,0,2,3,3,1,24,23.71,13.54,4345.13,0.11,70,0.07,241.4,32,38,13,11,24,0
1,0,0,1,1,1,0,0,0,0,0,1,0,0,0,1,0,1,0,0
1,0,0,1,1,1,0,5.8,2,23.22,0,5,0.5,1.29,1,4,1,4,0,0
1,0,0,1,1,1,1,0,0,0,0,0,0,0,0,0,0,0,1,0
1,0,0,1,1,1,1,0,0,0,0,1,0,0,0,1,0,1,1,0
1,0,0,1,1,1,2,5.33,1.5,12,0,4,0.67,0.67,1,3,1,3,2,0
1,0,0,1,1,1,2,5.33,1.5,12,0,4,0.67,0.67,1,3,1,3,2,0
1,9,0,1,1,1,2,0,0,0,0,9,0,0,9,0,1,0,11,0
1,0,0,1,1,1,1,0,0,0,0,0,0,0,0,0,0,0,1,0
1,0,0,1,1,1,1,0,0,0,0,0,0,0,0,0,0,0,1,0
1,0,0,1,1,1,1,0,0,0,0,1,0,0,0,1,0,1,1,0
1,0,0,1,1,1,4,18.49,2.4,106.51,0.01,14,0.42,5.92,6,8,5,4,4,0
1,0,0,1,1,1,2,5.33,1.5,12,0,4,0.67,0.67,1,3,1,3,2,0
1,0,0,1,1,1,5,8.45,0.75,4.75,0,4,1.33,0.26,3,1,2,1,5,0
1,0,0,1,1,1,1,0,0,0,0,0,0,0,0,0,0,0,1,0
1,0,0,1,1,1,1,0,0,0,0,1,0,0,0,1,0,1,1,0
1,0,0,1,1,1,3,10.8,2.5,67.5,0.01,9,0.4,3.75,3,6,3,5,3,0
1,0,0,1,1,1,2,5.33,1.5,12,0,4,0.67,0.67,1,3,1,3,2,0
1,0,0,1,1,1,2,6.2,2.5,38.77,0.01,6,0.4,2.15,1,5,1,5,2,0
1,0,0,1,1,1,4,9.51,0.5,2.38,0,3,2,0.13,2,1,2,1,4,0
1,0,0,1,1,1,1,0,0,0,0,1,0,0,0,1,0,1,1,0
1,0,0,1,1,1,2,5.33,1.5,12,0,4,0.67,0.67,1,3,1,3,2,0
1,0,0,1,1,1,2,5.33,1.5,12,0,4,0.67,0.67,1,3,1,3,2,0
1,0,0,1,1,1,2,0,0,0,0,4,0,0,0,4,0,4,2,0
1,0,0,1,1,1,1,0,0,0,0,1,0,0,0,1,0,1,1,0
1,0,0,1,1,1,2,0,0,0,0,5,0,0,0,5,0,5,2,0
1,0,0,1,1,1,1,0,0,0,0,1,0,0,0,1,0,1,1,0
1,0,0,1,1,1,2,5.33,1.5,12,0,4,0.67,0.67,1,3,1,3,2,0
1,0,0,1,1,1,2,5.33,1.5,12,0,4,0.67,0.67,1,3,1,3,2,0
1,0,0,1,1,1,1,0,0,0,0,1,0,0,0,1,0,1,1,0
3,0,1,2,1,1,10,9.08,7.5,510.86,0.02,19,0.13,28.38,5,14,3,9,10,0
1,0,0,1,1,1,0,0,0,0,0,1,0,0,0,1,0,1,0,0
1,0,0,1,1,1,0,0,0,0,0,3,0,0,0,3,0,3,0,0
1,0,0,1,1,1,0,0,0,0,0,3,0,0,0,3,0,3,0,0
1,0,0,1,1,1,0,0,0,0,0,1,0,0,0,1,0,1,0,0
1,0,0,1,1,1,0,0,0,0,0,1,0,0,0,1,0,1,0,0
1,0,0,1,1,1,0,0,0,0,0,1,0,0,0,1,0,1,0,0
1,0,0,1,1,1,0,0,0,0,0,1,0,0,0,1,0,1,0,0
1,0,0,1,1,1,0,5.33,1.5,12,0,4,0.67,0.67,1,3,1,3,0,0
1,0,0,1,1,1,0,0,0,0,0,1,0,0,0,1,0,1,0,0
1,0,0,1,1,1,0,0,0,0,0,1,0,0,0,1,0,1,0,0
1,0,0,1,1,1,0,5.33,1.5,12,0,4,0.67,0.67,1,3,1,3,0,0
1,0,0,1,1,1,0,0,0,0,0,1,0,0,0,1,0,1,0,0
1,0,0,1,1,1,0,5.33,1.5,12,0,4,0.67,0.67,1,3,1,3,0,0
1,0,0,1,1,1,0,0,0,0,0,1,0,0,0,1,0,1,0,0
1,0,0,1,1,1,0,0,0,0,0,1,0,0,0,1,0,1,0,0
1,0,0,1,1,1,0,0,0,0,0,1,0,0,0,1,0,1,0,0
1,0,0,1,1,1,0,0,0,0,0,1,0,0,0,1,0,1,0,0
1,0,0,1,1,1,1,0,0,0,0,1,0,0,0,1,0,1,1,0
1,0,0,1,1,1,1,0,0,0,0,1,0,0,0,1,0,1,1,0
1,0,0,1,1,1,1,0,0,0,0,1,0,0,0,1,0,1,1,0
1,0,0,1,1,1,1,0,0,0,0,1,0,0,0,1,0,1,1,0
1,0,0,1,1,1,1,0,0,0,0,1,0,0,0,1,0,1,1,0
1,0,0,1,1,1,1,0,0,0,0,1,0,0,0,1,0,1,1,0
5,0,0,3,1,1,2,13.29,4.5,269.08,0.02,18,0.22,14.95,6,12,4,6,2,0
1,0,1,1,1,1,2,16.92,3.5,207.22,0.02,16,0.29,11.51,6,10,6,7,2,0
1,0,0,1,1,1,2,5.33,1.5,12,0,4,0.67,0.67,1,3,1,3,2,0
1,0,0,1,1,1,2,5.33,1.5,12,0,4,0.67,0.67,1,3,1,3,2,0
1,0,0,1,1,1,2,5.33,1.5,12,0,4,0.67,0.67,1,3,1,3,2,0
1,0,0,1,1,1,2,5.33,1.5,12,0,4,0.67,0.67,1,3,1,3,2,0
1,0,0,1,1,1,2,5.33,1.5,12,0,4,0.67,0.67,1,3,1,3,2,0
1,0,0,1,1,1,2,5.33,1.5,12,0,4,0.67,0.67,1,3,1,3,2,0
1,0,0,1,1,1,2,5.33,1.5,12,0,4,0.67,0.67,1,3,1,3,2,0
1,0,0,1,1,1,2,5.33,1.5,12,0,4,0.67,0.67,1,3,1,3,2,0
1,0,0,1,1,1,2,5.33,1.5,12,0,4,0.67,0.67,1,3,1,3,2,0
1,0,0,1,1,1,2,0,0,0,0,4,0,0,0,4,0,4,2,0
1,0,0,1,1,1,1,0,0,0,0,1,0,0,0,1,0,1,1,0
1,0,0,1,1,1,0,0,0,0,0,1,0,0,0,1,0,1,0,0
1,0,0,1,1,1,2,0,0,0,0,5,0,0,0,5,0,5,2,0
1,0,0,1,1,1,2,0,0,0,0.01,6,0,0,0,6,0,6,2,0
1,2,0,1,1,1,1,16.84,1.5,37.9,0.01,9,0.67,2.11,4,5,4,3,3,0
1,0,0,1,1,1,2,5.33,1.5,12,0,4,0.67,0.67,1,3,1,3,2,0
1,0,0,1,1,1,0,0,0,0,0,0,0,0,0,0,0,0,0,0
1,0,0,1,1,1,0,0,0,0,0,1,0,0,0,1,0,1,0,0
1,0,0,1,1,1,0,0,0,0,0,1,0,0,0,1,0,1,0,0
1,0,0,1,1,1,0,0,0,0,0,1,0,0,0,1,0,1,0,0
1,0,0,1,1,1,0,0,0,0,0,1,0,0,0,1,0,1,0,0
1,0,0,1,1,1,0,0,0,0,0,1,0,0,0,1,0,1,0,0
1,0,0,1,1,1,0,0,0,0,0,1,0,0,0,1,0,1,0,0
1,0,0,1,1,1,0,0,0,0,0,1,0,0,0,1,0,1,0,0
1,0,0,1,1,1,0,0,0,0,0,1,0,0,0,1,0,1,0,0
1,0,0,1,1,1,0,0,0,0,0,1,0,0,0,1,0,1,0,0
1,0,0,1,1,1,0,0,0,0,0,1,0,0,0,1,0,1,0,0
1,0,0,1,1,1,0,0,0,0,0,1,0,0,0,1,0,1,0,0
1,0,0,1,1,1,0,0,0,0,0,1,0,0,0,1,0,1,0,0
1,0,0,1,1,1,0,5.8,2,23.22,0,5,0.5,1.29,1,4,1,4,0,0
1,0,0,1,1,1,0,0,0,0,0,0,0,0,0,0,0,0,0,0
1,0,0,1,1,1,1,0,0,0,0,0,0,0,0,0,0,0,1,0
1,0,0,1,1,1,1,0,0,0,0,1,0,0,0,1,0,1,1,0
1,0,0,1,1,1,2,5.33,1.5,12,0,4,0.67,0.67,1,3,1,3,2,0
1,0,0,1,1,1,2,5.33,1.5,12,0,4,0.67,0.67,1,3,1,3,2,0
1,9,0,1,1,1,2,0,0,0,0,9,0,0,9,0,1,0,11,0
1,0,0,1,1,1,1,0,0,0,0,0,0,0,0,0,0,0,1,0
1,0,0,1,1,1,1,0,0,0,0,0,0,0,0,0,0,0,1,0
1,0,0,1,1,1,1,0,0,0,0,1,0,0,0,1,0,1,1,0
1,0,0,1,1,1,4,18.49,2.4,106.51,0.01,14,0.42,5.92,6,8,5,4,4,0
1,0,0,1,1,1,2,5.33,1.5,12,0,4,0.67,0.67,1,3,1,3,2,0
1,0,0,1,1,1,5,8.45,0.75,4.75,0,4,1.33,0.26,3,1,2,1,5,0
1,0,0,1,1,1,1,0,0,0,0,0,0,0,0,0,0,0,1,0
1,0,0,1,1,1,1,0,0,0,0,1,0,0,0,1,0,1,1,0
1,0,0,1,1,1,3,10.8,2.5,67.5,0.01,9,0.4,3.75,3,6,3,5,3,0
1,0,0,1,1,1,2,5.33,1.5,12,0,4,0.67,0.67,1,3,1,3,2,0
1,0,0,1,1,1,2,6.2,2.5,38.77,0.01,6,0.4,2.15,1,5,1,5,2,0
1,0,0,1,1,1,4,9.51,0.5,2.38,0,3,2,0.13,2,1,2,1,4,0
1,0,0,1,1,1,1,0,0,0,0,1,0,0,0,1,0,1,1,0
1,0,0,1,1,1,2,5.33,1.5,12,0,4,0.67,0.67,1,3,1,3,2,0
1,0,0,1,1,1,2,5.33,1.5,12,0,4,0.67,0.67,1,3,1,3,2,0
1,0,0,1,1,1,2,0,0,0,0,4,0,0,0,4,0,4,2,0
1,0,0,1,1,1,1,0,0,0,0,1,0,0,0,1,0,1,1,0
1,0,0,1,1,1,2,0,0,0,0,5,0,0,0,5,0,5,2,0
1,0,0,1,1,1,1,0,0,0,0,1,0,0,0,1,0,1,1,0
1,0,0,1,1,1,2,5.33,1.5,12,0,4,0.67,0.67,1,3,1,3,2,0
1,0,0,1,1,1,2,5.33,1.5,12,0,4,0.67,0.67,1,3,1,3,2,0
1,0,0,1,1,1,1,0,0,0,0,1,0,0,0,1,0,1,1,0
1,0,0,1,1,1,0,0,0,0,0,1,0,0,0,1,0,1,0,0
1,0,0,1,1,1,0,0,0,0,0,3,0,0,0,3,0,3,0,0
1,0,0,1,1,1,0,0,0,0,0,3,0,0,0,3,0,3,0,0
1,0,0,1,1,1,0,0,0,0,0,1,0,0,0,1,0,1,0,0
1,0,0,1,1,1,0,0,0,0,0,1,0,0,0,1,0,1,0,0
1,0,0,1,1,1,0,0,0,0,0,1,0,0,0,1,0,1,0,0
1,0,0,1,1,1,0,0,0,0,0,1,0,0,0,1,0,1,0,0
1,0,0,1,1,1,0,5.33,1.5,12,0,4,0.67,0.67,1,3,1,3,0,0
1,0,0,1,1,1,0,0,0,0,0,1,0,0,0,1,0,1,0,0
1,0,0,1,1,1,0,0,0,0,0,1,0,0,0,1,0,1,0,0
1,0,0,1,1,1,0,5.33,1.5,12,0,4,0.67,0.67,1,3,1,3,0,0
1,0,0,1,1,1,0,0,0,0,0,1,0,0,0,1,0,1,0,0
1,0,0,1,1,1,0,5.33,1.5,12,0,4,0.67,0.67,1,3,1,3,0,0
1,0,0,1,1,1,0,0,0,0,0,1,0,0,0,1,0,1,0,0
1,0,0,1,1,1,0,0,0,0,0,1,0,0,0,1,0,1,0,0
1,0,0,1,1,1,0,0,0,0,0,1,0,0,0,1,0,1,0,0
1,0,0,1,1,1,0,0,0,0,0,1,0,0,0,1,0,1,0,0
1,0,0,1,1,1,2,10.44,3.5,127.89,0.01,11,0.29,7.11,3,8,3,7,2,0
1,0,0,1,1,1,2,7.49,3,67.38,0.01,8,0.33,3.74,1,7,1,6,2,0
1,0,0,1,1,1,2,9,3,81,0.01,9,0.33,4.5,2,7,2,6,2,0
1,0,0,1,1,1,2,9,3,81,0.01,9,0.33,4.5,2,7,2,6,2,0
1,0,0,1,1,1,2,9,3,81,0.01,9,0.33,4.5,2,7,2,6,2,0
1,0,0,1,1,1,2,10.44,3.5,127.89,0.01,11,0.29,7.11,3,8,3,7,2,0
1,0,0,1,1,1,2,9,3,81,0.01,9,0.33,4.5,2,7,2,6,2,0
1,0,0,1,1,1,2,9,3,81,0.01,9,0.33,4.5,2,7,2,6,2,0
1,0,0,1,1,1,2,7.49,3,67.38,0.01,8,0.33,3.74,1,7,1,6,2,0
1,0,0,1,1,1,2,7.49,3,67.38,0.01,8,0.33,3.74,1,7,1,6,2,0
1,0,0,1,1,1,2,10,3,90,0.01,10,0.33,5,2,8,2,6,2,0
1,0,0,1,1,1,3,10.44,3.5,127.89,0.01,11,0.29,7.11,3,8,3,7,3,0
1,0,0,1,1,1,3,11.39,3.5,139.52,0.01,12,0.29,7.75,3,9,3,7,3,0
1,0,0,1,1,1,2,9,3,81,0.01,9,0.33,4.5,2,7,2,6,2,0
1,0,0,1,1,1,2,10.44,3.5,127.89,0.01,11,0.29,7.11,3,8,3,7,2,0
1,0,0,1,1,1,2,9,3,81,0.01,9,0.33,4.5,2,7,2,6,2,0
1,0,0,1,1,1,2,9,3,81,0.01,9,0.33,4.5,2,7,2,6,2,0
1,0,0,1,1,1,2,10.44,3.5,127.89,0.01,11,0.29,7.11,3,8,3,7,2,0
1,0,0,1,1,1,2,9,3,81,0.01,9,0.33,4.5,2,7,2,6,2,0
1,0,0,1,1,1,2,9,3,81,0.01,9,0.33,4.5,2,7,2,6,2,0
1,0,0,1,1,1,2,9,3,81,0.01,9,0.33,4.5,2,7,2,6,2,0
1,0,0,1,1,1,2,7.49,3,67.38,0.01,8,0.33,3.74,1,7,1,6,2,0
1,0,0,1,1,1,2,9,3,81,0.01,9,0.33,4.5,2,7,2,6,2,0
1,0,0,1,1,1,2,9,3,81,0.01,9,0.33,4.5,2,7,2,6,2,0
1,0,0,1,1,1,2,10.44,3.5,127.89,0.01,11,0.29,7.11,3,8,3,7,2,0
1,0,0,1,1,1,2,9.05,2,36.19,0.01,7,0.5,2,2,5,2,4,2,0
1,0,0,1,1,1,2,9.05,2,36.19,0.01,7,0.5,2,2,5,2,4,2,0
1,0,0,1,1,1,2,9.05,2,36.19,0.01,7,0.5,2,2,5,2,4,2,0
1,0,0,1,1,1,2,9.05,2,36.19,0.01,7,0.5,2,2,5,2,4,2,0
1,0,0,1,1,1,2,9.05,2,36.19,0.01,7,0.5,2,2,5,2,4,2,0
1,0,0,1,1,1,2,9.05,2,36.19,0.01,7,0.5,2,2,5,2,4,2,0
1,0,0,1,1,1,2,9.05,2,36.19,0.01,7,0.5,2,2,5,2,4,2,0
1,0,0,1,1,1,2,9.05,2,36.19,0.01,7,0.5,2,2,5,2,4,2,0
1,0,0,1,1,1,2,9.05,2,36.19,0.01,7,0.5,2,2,5,2,4,2,0
1,0,0,1,1,1,2,9.05,2,36.19,0.01,7,0.5,2,2,5,2,4,2,0
1,0,0,1,1,1,2,9.05,2,36.19,0.01,7,0.5,2,2,5,2,4,2,0
1,0,0,1,1,1,2,9.05,2,36.19,0.01,7,0.5,2,2,5,2,4,2,0
1,0,0,1,1,1,2,9.05,2,36.19,0.01,7,0.5,2,2,5,2,4,2,0
1,0,0,1,1,1,2,10.44,3.5,127.89,0.01,11,0.29,7.11,3,8,3,7,2,0
1,0,0,1,1,1,2,10.44,3.5,127.89,0.01,11,0.29,7.11,3,8,3,7,2,0
1,0,0,1,1,1,2,9.05,2,36.19,0.01,7,0.5,2,2,5,2,4,2,0
1,0,0,1,1,1,0,0,0,0,0,1,0,0,0,1,0,1,0,0
1,0,0,1,1,1,2,5.33,1.5,12,0,4,0.67,0.67,1,3,1,3,2,0
3,0,0,2,1,1,6,11.86,4.38,227.03,0.02,15,0.23,12.61,5,10,4,7,6,0
3,2,0,2,1,1,6,14.43,5.14,381.76,0.02,19,0.19,21.21,9,10,7,8,8,0
5,1,0,3,1,1,10,12.67,10,1267.11,0.04,31,0.1,70.4,14,17,7,10,11,0
3,1,0,2,1,1,6,11.71,4.9,281.06,0.02,16,0.2,15.61,7,9,5,7,7,0
3,1,0,2,1,1,6,11.71,4.9,281.06,0.02,16,0.2,15.61,7,9,5,7,7,0
1,0,0,1,1,1,2,5.33,1.5,12,0,4,0.67,0.67,1,3,1,3,2,0
1,0,0,1,1,1,2,5.33,1.5,12,0,4,0.67,0.67,1,3,1,3,2,0
3,1,0,2,1,1,6,11.23,5.6,352.28,0.02,17,0.18,19.57,7,10,5,8,7,0
7,1,1,4,1,3,13,18.91,10.45,2065.48,0.07,45,0.1,114.75,19,26,10,11,14,0
5,1,0,3,1,1,10,13.33,9,1080,0.04,30,0.11,60,14,16,7,9,11,0
3,1,0,2,1,1,6,11.71,4.9,281.06,0.02,16,0.2,15.61,7,9,5,7,7,0
7,1,1,4,1,3,13,18.91,10.45,2065.48,0.07,45,0.1,114.75,19,26,10,11,14,0
3,1,0,2,1,1,6,11.71,4.9,281.06,0.02,16,0.2,15.61,7,9,5,7,7,0
3,0,0,2,1,1,6,11.86,4.38,227.03,0.02,15,0.23,12.61,5,10,4,7,6,0
3,2,0,2,1,1,7,16.73,5.5,506,0.03,23,0.18,28.11,11,12,8,8,9,0
1,0,0,1,1,1,2,5.33,1.5,12,0,4,0.67,0.67,1,3,1,3,2,0
9,6,0,5,1,1,14,23.12,11.15,2875.94,0.09,57,0.09,159.77,29,28,13,10,20,0
3,1,0,2,1,1,7,14.43,5.14,381.76,0.02,19,0.19,21.21,9,10,7,8,8,0
7,1,1,4,1,3,13,19.62,10,1962.15,0.07,44,0.1,109.01,20,24,11,11,14,0
1,0,0,1,1,1,2,5.33,1.5,12,0,4,0.67,0.67,1,3,1,3,2,0
1,0,0,1,1,1,2,5.33,1.5,12,0,4,0.67,0.67,1,3,1,3,2,0
1,0,0,1,1,1,2,5.33,1.5,12,0,4,0.67,0.67,1,3,1,3,2,0
1,0,0,1,1,1,2,5.33,1.5,12,0,4,0.67,0.67,1,3,1,3,2,0
1,0,0,1,1,1,2,5.33,1.5,12,0,4,0.67,0.67,1,3,1,3,2,0
1,0,0,1,1,1,2,5.33,1.5,12,0,4,0.67,0.67,1,3,1,3,2,0
1,0,0,1,1,1,2,5.33,1.5,12,0,4,0.67,0.67,1,3,1,3,2,0
3,1,0,2,1,1,5,10.95,6,394.38,0.02,19,0.17,21.91,10,9,5,6,6,0
3,1,0,2,1,1,5,10.95,6,394.38,0.02,19,0.17,21.91,10,9,5,6,6,0
3,1,0,2,1,1,5,10.95,6,394.38,0.02,19,0.17,21.91,10,9,5,6,6,0
3,1,0,2,1,1,5,10.95,6,394.38,0.02,19,0.17,21.91,10,9,5,6,6,0
3,1,1,2,1,1,5,10.95,6,394.38,0.02,19,0.17,21.91,10,9,5,6,6,0
1,0,0,1,1,1,3,13,3,117,0.01,13,0.33,6.5,6,7,4,4,3,0
1,0,0,1,1,1,2,11.07,3,99.66,0.01,10,0.33,5.54,4,6,4,6,2,0
1,0,0,1,1,1,2,7.74,1.5,17.41,0,5,0.67,0.97,2,3,2,3,2,0
3,0,1,2,1,1,8,16.92,4.5,342.66,0.03,20,0.22,19.04,9,11,7,7,8,0
3,1,0,2,1,1,7,16.92,4.5,342.66,0.03,20,0.22,19.04,9,11,7,7,8,0
1,0,0,1,1,1,2,11.41,2.5,71.32,0.01,9,0.4,3.96,4,5,4,5,2,0
3,1,0,2,1,1,5,10.95,6,394.38,0.02,19,0.17,21.91,10,9,5,6,6,0
1,0,0,1,1,1,4,16.51,4.8,380.39,0.03,25,0.21,21.13,12,13,5,4,4,0
1,0,0,1,1,1,2,7.74,1.5,17.41,0,5,0.67,0.97,2,3,2,3,2,0
3,1,0,2,1,1,5,10.95,6,394.38,0.02,19,0.17,21.91,10,9,5,6,6,0
3,1,0,2,1,1,5,10.95,6,394.38,0.02,19,0.17,21.91,10,9,5,6,6,0
1,0,0,1,1,1,2,9.83,2,39.3,0.01,7,0.5,2.18,3,4,3,4,2,0
1,0,0,1,1,1,2,7.86,2.5,49.13,0.01,7,0.4,2.73,2,5,2,5,2,0
1,0,0,1,1,1,2,7.49,3,67.38,0.01,8,0.33,3.74,1,7,1,6,2,0
1,0,0,1,1,1,2,7.49,3,67.38,0.01,8,0.33,3.74,1,7,1,6,2,0
1,0,0,1,1,1,2,7.49,3,67.38,0.01,8,0.33,3.74,1,7,1,6,2,0
1,0,0,1,1,1,2,7.49,3,67.38,0.01,8,0.33,3.74,1,7,1,6,2,0
1,0,0,1,1,1,2,7.49,3,67.38,0.01,8,0.33,3.74,1,7,1,6,2,0
1,0,0,1,1,1,2,7.49,3,67.38,0.01,8,0.33,3.74,1,7,1,6,2,0
1,0,0,1,1,1,2,7.49,3,67.38,0.01,8,0.33,3.74,1,7,1,6,2,0
1,0,0,1,1,1,2,10.57,3,95.1,0.01,10,0.33,5.28,3,7,3,6,2,0
1,0,0,1,1,1,0,0,0,0,0,1,0,0,0,1,0,1,0,0
1,0,0,1,1,1,2,5.33,1.5,12,0,4,0.67,0.67,1,3,1,3,2,0
1,0,0,1,1,1,2,5.33,1.5,12,0,4,0.67,0.67,1,3,1,3,2,0
1,0,0,1,1,1,2,5.33,1.5,12,0,4,0.67,0.67,1,3,1,3,2,0
1,0,0,1,1,1,2,5.33,1.5,12,0,4,0.67,0.67,1,3,1,3,2,0
1,0,0,1,1,1,2,5.33,1.5,12,0,4,0.67,0.67,1,3,1,3,2,0
1,0,0,1,1,1,2,5.33,1.5,12,0,4,0.67,0.67,1,3,1,3,2,0
1,0,0,1,1,1,2,5.33,1.5,12,0,4,0.67,0.67,1,3,1,3,2,0
1,0,0,1,1,1,2,13.95,2.5,87.17,0.01,11,0.4,4.84,4,7,4,5,2,0
63,42,9,43,18,6,202,126.66,48.84,302139,2.06,847,0.02,16785.5,370,477,125,33,244,1
13,21,6,7,4,1,23,35.63,14.3,7285.62,0.17,101,0.07,404.76,44,57,20,13,44,1
39,21,6,20,6,14,53,94.34,21.98,45592.77,0.69,329,0.05,2532.93,149,180,61,18,74,1
3,6,0,1,1,1,5,27.37,6,985.4,0.05,38,0.17,54.74,18,20,12,8,11,1
1,0,0,1,1,1,2,7.86,2.5,49.13,0.01,7,0.4,2.73,2,5,2,5,2,0
1,0,0,1,1,1,2,7.49,3,67.38,0.01,8,0.33,3.74,1,7,1,6,2,0
1,0,0,1,1,1,2,7.49,3,67.38,0.01,8,0.33,3.74,1,7,1,6,2,0
1,0,0,1,1,1,2,7.49,3,67.38,0.01,8,0.33,3.74,1,7,1,6,2,0
1,0,0,1,1,1,2,7.49,3,67.38,0.01,8,0.33,3.74,1,7,1,6,2,0
1,0,0,1,1,1,2,7.49,3,67.38,0.01,8,0.33,3.74,1,7,1,6,2,0
1,0,0,1,1,1,2,7.49,3,67.38,0.01,8,0.33,3.74,1,7,1,6,2,0
1,0,0,1,1,1,2,7.49,3,67.38,0.01,8,0.33,3.74,1,7,1,6,2,0
1,0,0,1,1,1,2,10.57,3,95.1,0.01,10,0.33,5.28,3,7,3,6,2,0
1,0,0,1,1,1,0,0,0,0,0,1,0,0,0,1,0,1,0,0
1,0,0,1,1,1,2,5.33,1.5,12,0,4,0.67,0.67,1,3,1,3,2,0
1,0,0,1,1,1,2,5.33,1.5,12,0,4,0.67,0.67,1,3,1,3,2,0
1,0,0,1,1,1,2,5.33,1.5,12,0,4,0.67,0.67,1,3,1,3,2,0
1,0,0,1,1,1,2,5.33,1.5,12,0,4,0.67,0.67,1,3,1,3,2,0
1,0,0,1,1,1,2,5.33,1.5,12,0,4,0.67,0.67,1,3,1,3,2,0
1,0,0,1,1,1,2,5.33,1.5,12,0,4,0.67,0.67,1,3,1,3,2,0
1,0,0,1,1,1,2,5.33,1.5,12,0,4,0.67,0.67,1,3,1,3,2,0
1,0,0,1,1,1,2,13.95,2.5,87.17,0.01,11,0.4,4.84,4,7,4,5,2,0
1,0,0,1,1,1,1,0,0,0,0,1,0,0,0,1,0,1,1,0
1,0,0,1,1,1,1,0,0,0,0,1,0,0,0,1,0,1,1,0
1,0,0,1,1,1,1,0,0,0,0,1,0,0,0,1,0,1,1,0
1,0,0,1,1,1,1,0,0,0,0,1,0,0,0,1,0,1,1,0
1,0,0,1,1,1,2,13.29,4.5,269.08,0.02,18,0.22,14.95,6,12,4,6,2,0
1,0,0,1,1,1,3,16.58,4.8,381.92,0.03,23,0.21,21.22,8,15,5,6,3,0
1,0,1,1,1,1,2,16.92,3.5,207.22,0.02,16,0.29,11.51,6,10,6,7,2,0
1,0,0,1,1,1,2,5.33,1.5,12,0,4,0.67,0.67,1,3,1,3,2,0
1,0,0,1,1,1,2,5.33,1.5,12,0,4,0.67,0.67,1,3,1,3,2,0
1,0,0,1,1,1,2,5.33,1.5,12,0,4,0.67,0.67,1,3,1,3,2,0
1,0,0,1,1,1,2,5.33,1.5,12,0,4,0.67,0.67,1,3,1,3,2,0
1,0,0,1,1,1,2,5.33,1.5,12,0,4,0.67,0.67,1,3,1,3,2,0
1,0,0,1,1,1,2,5.33,1.5,12,0,4,0.67,0.67,1,3,1,3,2,0
1,0,0,1,1,1,2,5.33,1.5,12,0,4,0.67,0.67,1,3,1,3,2,0
1,0,0,1,1,1,0,0,0,0,0,1,0,0,0,1,0,1,0,0
1,0,2,1,1,1,3,4.14,5,103.4,0.01,8,0.2,5.74,2,6,1,5,3,0
1,0,1,1,1,1,2,5.33,1.5,12,0,4,0.67,0.67,1,3,1,3,2,0
1,0,1,1,1,1,2,6.2,2.5,38.77,0.01,6,0.4,2.15,1,5,1,5,2,0
1,0,1,1,1,1,4,16.64,8.94,1328.8,0.05,35,0.11,73.82,13,22,8,11,4,0
1,0,1,1,1,1,2,7.74,1.5,17.41,0,5,0.67,0.97,2,3,2,3,2,0
1,0,0,1,1,1,1,0,0,0,0,0,0,0,0,0,0,0,1,0
1,0,0,1,1,1,1,0,0,0,0,1,0,0,0,1,0,1,1,0
1,11,0,1,1,1,2,0,0,0,0,0,0,0,0,0,0,0,13,0
1,0,0,1,1,1,1,0,0,0,0,1,0,0,0,1,0,1,1,0
1,0,0,1,1,1,2,5.33,1.5,12,0,4,0.67,0.67,1,3,1,3,2,0
1,0,0,1,1,1,2,5.33,1.5,12,0,4,0.67,0.67,1,3,1,3,2,0
1,9,0,1,1,1,2,0,0,0,0,9,0,0,9,0,1,0,11,0
1,0,0,1,1,1,1,0,0,0,0,0,0,0,0,0,0,0,1,0
1,0,0,1,1,1,1,0,0,0,0,0,0,0,0,0,0,0,1,0
1,0,0,1,1,1,1,0,0,0,0,1,0,0,0,1,0,1,1,0
1,0,0,1,1,1,4,18.49,2.4,106.51,0.01,14,0.42,5.92,6,8,5,4,4,0
1,0,0,1,1,1,2,5.33,1.5,12,0,4,0.67,0.67,1,3,1,3,2,0
1,0,0,1,1,1,5,8.45,0.75,4.75,0,4,1.33,0.26,3,1,2,1,5,0
1,0,0,1,1,1,1,0,0,0,0,0,0,0,0,0,0,0,1,0
1,0,0,1,1,1,1,0,0,0,0,1,0,0,0,1,0,1,1,0
1,0,0,1,1,1,3,10.8,2.5,67.5,0.01,9,0.4,3.75,3,6,3,5,3,0
1,0,0,1,1,1,2,5.33,1.5,12,0,4,0.67,0.67,1,3,1,3,2,0
1,0,0,1,1,1,2,6.2,2.5,38.77,0.01,6,0.4,2.15,1,5,1,5,2,0
1,0,0,1,1,1,4,9.51,0.5,2.38,0,3,2,0.13,2,1,2,1,4,0
1,0,0,1,1,1,1,0,0,0,0,1,0,0,0,1,0,1,1,0
1,0,0,1,1,1,2,5.33,1.5,12,0,4,0.67,0.67,1,3,1,3,2,0
1,0,0,1,1,1,2,5.33,1.5,12,0,4,0.67,0.67,1,3,1,3,2,0
1,0,0,1,1,1,2,0,0,0,0,4,0,0,0,4,0,4,2,0
1,0,0,1,1,1,1,0,0,0,0,1,0,0,0,1,0,1,1,0
1,0,0,1,1,1,2,0,0,0,0,5,0,0,0,5,0,5,2,0
1,0,0,1,1,1,1,0,0,0,0,1,0,0,0,1,0,1,1,0
1,0,0,1,1,1,2,5.33,1.5,12,0,4,0.67,0.67,1,3,1,3,2,0
1,0,0,1,1,1,2,5.33,1.5,12,0,4,0.67,0.67,1,3,1,3,2,0
1,0,0,1,1,1,1,0,0,0,0,1,0,0,0,1,0,1,1,0
1,0,0,1,1,1,1,0,0,0,0,1,0,0,0,1,0,1,1,0
1,0,0,1,1,1,1,0,0,0,0,1,0,0,0,1,0,1,1,0
1,0,0,1,1,1,1,0,0,0,0,1,0,0,0,1,0,1,1,0
1,0,0,1,1,1,1,0,0,0,0,1,0,0,0,1,0,1,1,0
1,0,0,1,1,1,2,5.33,1.5,12,0,4,0.67,0.67,1,3,1,3,2,0
1,0,0,1,1,1,2,5.33,1.5,12,0,4,0.67,0.67,1,3,1,3,2,0
1,0,0,1,1,1,2,5.33,1.5,12,0,4,0.67,0.67,1,3,1,3,2,0
1,0,0,1,1,1,2,5.33,1.5,12,0,4,0.67,0.67,1,3,1,3,2,0
1,0,0,1,1,1,2,5.33,1.5,12,0,4,0.67,0.67,1,3,1,3,2,0
1,0,0,1,1,1,2,5.33,1.5,12,0,4,0.67,0.67,1,3,1,3,2,0
1,0,0,1,1,1,2,5.33,1.5,12,0,4,0.67,0.67,1,3,1,3,2,0
1,0,0,1,1,1,1,0,0,0,0,0,0,0,0,0,0,0,1,0
1,0,0,1,1,1,1,0,0,0,0,1,0,0,0,1,0,1,1,0
1,11,0,1,1,1,2,0,0,0,0,0,0,0,0,0,0,0,13,0
3,1,0,2,2,1,10,24.53,6.8,1134.22,0.06,40,0.15,63.01,17,23,10,8,11,0
1,0,0,1,1,1,1,0,0,0,0,1,0,0,0,1,0,1,1,0
1,0,0,1,1,1,2,5.33,1.5,12,0,4,0.67,0.67,1,3,1,3,2,0
1,0,0,1,1,1,2,5.33,1.5,12,0,4,0.67,0.67,1,3,1,3,2,0
1,9,0,1,1,1,2,0,0,0,0,9,0,0,9,0,1,0,11,0
11,15,6,6,5,1,26,68.54,8.73,5228.5,0.2,109,0.11,290.47,43,66,32,13,41,1
1,0,0,1,1,1,1,0,0,0,0,0,0,0,0,0,0,0,1,0
1,0,0,1,1,1,1,0,0,0,0,0,0,0,0,0,0,0,1,0
1,0,0,1,1,1,1,0,0,0,0,1,0,0,0,1,0,1,1,0
1,0,0,1,1,1,4,18.49,2.4,106.51,0.01,14,0.42,5.92,6,8,5,4,4,0
1,0,0,1,1,1,2,5.33,1.5,12,0,4,0.67,0.67,1,3,1,3,2,0
1,0,0,1,1,1,5,8.45,0.75,4.75,0,4,1.33,0.26,3,1,2,1,5,0
1,0,0,1,1,1,1,0,0,0,0,0,0,0,0,0,0,0,1,0
1,0,0,1,1,1,1,0,0,0,0,1,0,0,0,1,0,1,1,0
1,0,0,1,1,1,3,10.8,2.5,67.5,0.01,9,0.4,3.75,3,6,3,5,3,0
1,0,0,1,1,1,2,5.33,1.5,12,0,4,0.67,0.67,1,3,1,3,2,0
1,0,0,1,1,1,2,6.2,2.5,38.77,0.01,6,0.4,2.15,1,5,1,5,2,0
1,0,0,1,1,1,4,9.51,0.5,2.38,0,3,2,0.13,2,1,2,1,4,0
1,0,0,1,1,1,1,0,0,0,0,1,0,0,0,1,0,1,1,0
1,0,0,1,1,1,1,0,0,0,0,1,0,0,0,1,0,1,1,0
1,0,0,1,1,1,1,0,0,0,0,1,0,0,0,1,0,1,1,0
1,0,0,1,1,1,1,0,0,0,0,1,0,0,0,1,0,1,1,0
1,0,0,1,1,1,1,0,0,0,0,1,0,0,0,1,0,1,1,0
1,0,0,1,1,1,2,5.33,1.5,12,0,4,0.67,0.67,1,3,1,3,2,0
1,0,0,1,1,1,2,5.33,1.5,12,0,4,0.67,0.67,1,3,1,3,2,0
1,0,0,1,1,1,2,5.33,1.5,12,0,4,0.67,0.67,1,3,1,3,2,0
1,0,0,1,1,1,2,5.33,1.5,12,0,4,0.67,0.67,1,3,1,3,2,0
1,0,0,1,1,1,2,5.33,1.5,12,0,4,0.67,0.67,1,3,1,3,2,0
1,0,0,1,1,1,2,5.33,1.5,12,0,4,0.67,0.67,1,3,1,3,2,0
1,0,0,1,1,1,2,5.33,1.5,12,0,4,0.67,0.67,1,3,1,3,2,0
1,0,0,1,1,1,1,0,0,0,0,0,0,0,0,0,0,0,1,0
1,0,0,1,1,1,1,0,0,0,0,1,0,0,0,1,0,1,1,0
1,11,0,1,1,1,2,0,0,0,0,0,0,0,0,0,0,0,13,0
1,0,0,1,1,1,1,0,0,0,0,1,0,0,0,1,0,1,1,0
1,0,0,1,1,1,2,5.33,1.5,12,0,4,0.67,0.67,1,3,1,3,2,0
1,0,0,1,1,1,2,5.33,1.5,12,0,4,0.67,0.67,1,3,1,3,2,0
1,9,0,1,1,1,2,0,0,0,0,9,0,0,9,0,1,0,11,0
1,0,0,1,1,1,1,0,0,0,0,0,0,0,0,0,0,0,1,0
1,0,0,1,1,1,1,0,0,0,0,0,0,0,0,0,0,0,1,0
1,0,0,1,1,1,1,0,0,0,0,1,0,0,0,1,0,1,1,0
1,0,0,1,1,1,4,18.49,2.4,106.51,0.01,14,0.42,5.92,6,8,5,4,4,0
1,0,0,1,1,1,2,5.33,1.5,12,0,4,0.67,0.67,1,3,1,3,2,0
1,0,0,1,1,1,5,8.45,0.75,4.75,0,4,1.33,0.26,3,1,2,1,5,0
5,5,0,3,3,1,14,19.38,11.81,2703.86,0.08,56,0.08,150.21,21,35,8,9,19,0
5,16,0,3,2,1,9,22.7,11,2747.01,0.08,56,0.09,152.61,22,34,11,11,25,0
5,16,0,3,2,1,9,22.7,11,2747.01,0.08,56,0.09,152.61,22,34,11,11,25,0
5,16,0,3,2,1,9,22.7,11,2747.01,0.08,56,0.09,152.61,22,34,11,11,25,0
5,16,0,3,2,1,9,22.7,11,2747.01,0.08,56,0.09,152.61,22,34,11,11,25,0
5,16,0,3,2,1,9,22.7,11,2747.01,0.08,56,0.09,152.61,22,34,11,11,25,0
5,16,0,3,2,1,9,27.59,9.31,2389.82,0.09,56,0.11,132.77,22,34,13,11,25,0
5,16,0,3,2,1,9,27.59,9.31,2389.82,0.09,56,0.11,132.77,22,34,13,11,25,0
1,0,0,1,1,1,1,0,0,0,0,0,0,0,0,0,0,0,1,0
1,0,0,1,1,1,1,0,0,0,0,1,0,0,0,1,0,1,1,0
1,0,0,1,1,1,3,10.8,2.5,67.5,0.01,9,0.4,3.75,3,6,3,5,3,0
1,0,0,1,1,1,2,5.33,1.5,12,0,4,0.67,0.67,1,3,1,3,2,0
1,0,0,1,1,1,2,6.2,2.5,38.77,0.01,6,0.4,2.15,1,5,1,5,2,0
1,0,0,1,1,1,4,9.51,0.5,2.38,0,3,2,0.13,2,1,2,1,4,0
1,0,0,1,1,1,1,0,0,0,0,1,0,0,0,1,0,1,1,0
1,0,0,1,1,1,1,0,0,0,0,1,0,0,0,1,0,1,1,0
1,0,0,1,1,1,1,0,0,0,0,1,0,0,0,1,0,1,1,0
1,0,0,1,1,1,1,0,0,0,0,1,0,0,0,1,0,1,1,0
1,0,0,1,1,1,1,0,0,0,0,1,0,0,0,1,0,1,1,0
1,0,0,1,1,1,2,5.33,1.5,12,0,4,0.67,0.67,1,3,1,3,2,0
1,0,0,1,1,1,2,5.33,1.5,12,0,4,0.67,0.67,1,3,1,3,2,0
1,0,0,1,1,1,2,5.33,1.5,12,0,4,0.67,0.67,1,3,1,3,2,0
1,0,0,1,1,1,2,5.33,1.5,12,0,4,0.67,0.67,1,3,1,3,2,0
1,0,0,1,1,1,2,5.33,1.5,12,0,4,0.67,0.67,1,3,1,3,2,0
1,0,0,1,1,1,2,5.33,1.5,12,0,4,0.67,0.67,1,3,1,3,2,0
1,0,0,1,1,1,2,5.33,1.5,12,0,4,0.67,0.67,1,3,1,3,2,0
1,0,0,1,1,1,1,0,0,0,0,0,0,0,0,0,0,0,1,0
1,0,0,1,1,1,1,0,0,0,0,1,0,0,0,1,0,1,1,0
1,9,0,1,1,1,2,0,0,0,0,0,0,0,0,0,0,0,11,0
1,0,0,1,1,1,1,0,0,0,0,1,0,0,0,1,0,1,1,0
1,0,0,1,1,1,2,5.33,1.5,12,0,4,0.67,0.67,1,3,1,3,2,0
1,0,0,1,1,1,2,5.33,1.5,12,0,4,0.67,0.67,1,3,1,3,2,0
1,9,0,1,1,1,2,0,0,0,0,9,0,0,9,0,1,0,11,0
1,0,0,1,1,1,1,0,0,0,0,0,0,0,0,0,0,0,1,0
1,0,0,1,1,1,1,0,0,0,0,0,0,0,0,0,0,0,1,0
1,0,0,1,1,1,1,0,0,0,0,1,0,0,0,1,0,1,1,0
1,0,0,1,1,1,4,18.49,2.4,106.51,0.01,14,0.42,5.92,6,8,5,4,4,0
1,0,0,1,1,1,2,5.33,1.5,12,0,4,0.67,0.67,1,3,1,3,2,0
1,0,0,1,1,1,5,8.45,0.75,4.75,0,4,1.33,0.26,3,1,2,1,5,0
1,0,0,1,1,1,1,0,0,0,0,0,0,0,0,0,0,0,1,0
1,0,0,1,1,1,1,0,0,0,0,1,0,0,0,1,0,1,1,0
1,0,0,1,1,1,3,10.8,2.5,67.5,0.01,9,0.4,3.75,3,6,3,5,3,0
1,0,0,1,1,1,2,5.33,1.5,12,0,4,0.67,0.67,1,3,1,3,2,0
1,0,0,1,1,1,2,6.2,2.5,38.77,0.01,6,0.4,2.15,1,5,1,5,2,0
1,0,0,1,1,1,4,9.51,0.5,2.38,0,3,2,0.13,2,1,2,1,4,0
1,0,0,1,1,1,1,0,0,0,0,1,0,0,0,1,0,1,1,0
1,0,0,1,1,1,1,0,0,0,0,1,0,0,0,1,0,1,1,0
1,0,0,1,1,1,1,0,0,0,0,1,0,0,0,1,0,1,1,0
1,0,0,1,1,1,1,0,0,0,0,1,0,0,0,1,0,1,1,0
1,0,0,1,1,1,1,0,0,0,0,1,0,0,0,1,0,1,1,0
1,0,0,1,1,1,2,5.33,1.5,12,0,4,0.67,0.67,1,3,1,3,2,0
1,0,0,1,1,1,2,5.33,1.5,12,0,4,0.67,0.67,1,3,1,3,2,0
1,0,0,1,1,1,2,5.33,1.5,12,0,4,0.67,0.67,1,3,1,3,2,0
1,0,0,1,1,1,2,5.33,1.5,12,0,4,0.67,0.67,1,3,1,3,2,0
1,0,0,1,1,1,2,5.33,1.5,12,0,4,0.67,0.67,1,3,1,3,2,0
1,0,0,1,1,1,2,5.33,1.5,12,0,4,0.67,0.67,1,3,1,3,2,0
1,0,0,1,1,1,2,5.33,1.5,12,0,4,0.67,0.67,1,3,1,3,2,0
1,0,0,1,1,1,1,0,0,0,0,0,0,0,0,0,0,0,1,0
1,0,0,1,1,1,1,0,0,0,0,1,0,0,0,1,0,1,1,0
1,9,0,1,1,1,2,0,0,0,0,0,0,0,0,0,0,0,11,0
1,0,0,1,1,1,1,0,0,0,0,1,0,0,0,1,0,1,1,0
1,0,0,1,1,1,2,5.33,1.5,12,0,4,0.67,0.67,1,3,1,3,2,0
1,0,0,1,1,1,2,5.33,1.5,12,0,4,0.67,0.67,1,3,1,3,2,0
1,9,0,1,1,1,2,0,0,0,0,9,0,0,9,0,1,0,11,0
11,13,6,6,5,1,26,64.14,8.88,5061.35,0.19,105,0.11,281.19,41,64,30,13,39,1
1,0,0,1,1,1,1,0,0,0,0,0,0,0,0,0,0,0,1,0
1,0,0,1,1,1,1,0,0,0,0,0,0,0,0,0,0,0,1,0
1,0,0,1,1,1,1,0,0,0,0,1,0,0,0,1,0,1,1,0
1,0,0,1,1,1,4,18.49,2.4,106.51,0.01,14,0.42,5.92,6,8,5,4,4,0
1,0,0,1,1,1,2,5.33,1.5,12,0,4,0.67,0.67,1,3,1,3,2,0
1,0,0,1,1,1,5,8.45,0.75,4.75,0,4,1.33,0.26,3,1,2,1,5,0
1,0,0,1,1,1,1,0,0,0,0,0,0,0,0,0,0,0,1,0
1,0,0,1,1,1,1,0,0,0,0,1,0,0,0,1,0,1,1,0
1,0,0,1,1,1,3,10.8,2.5,67.5,0.01,9,0.4,3.75,3,6,3,5,3,0
1,0,0,1,1,1,2,5.33,1.5,12,0,4,0.67,0.67,1,3,1,3,2,0
1,0,0,1,1,1,2,6.2,2.5,38.77,0.01,6,0.4,2.15,1,5,1,5,2,0
1,0,0,1,1,1,4,9.51,0.5,2.38,0,3,2,0.13,2,1,2,1,4,0
1,0,0,1,1,1,1,0,0,0,0,1,0,0,0,1,0,1,1,0
1,0,0,1,1,1,1,0,0,0,0,1,0,0,0,1,0,1,1,0
1,0,0,1,1,1,1,0,0,0,0,1,0,0,0,1,0,1,1,0
1,0,0,1,1,1,1,0,0,0,0,1,0,0,0,1,0,1,1,0
1,0,0,1,1,1,1,0,0,0,0,1,0,0,0,1,0,1,1,0
1,0,0,1,1,1,2,5.33,1.5,12,0,4,0.67,0.67,1,3,1,3,2,0
1,0,0,1,1,1,2,5.33,1.5,12,0,4,0.67,0.67,1,3,1,3,2,0
1,0,0,1,1,1,2,5.33,1.5,12,0,4,0.67,0.67,1,3,1,3,2,0
1,0,0,1,1,1,2,5.33,1.5,12,0,4,0.67,0.67,1,3,1,3,2,0
1,0,0,1,1,1,2,5.33,1.5,12,0,4,0.67,0.67,1,3,1,3,2,0
1,0,0,1,1,1,2,5.33,1.5,12,0,4,0.67,0.67,1,3,1,3,2,0
1,0,0,1,1,1,2,5.33,1.5,12,0,4,0.67,0.67,1,3,1,3,2,0
1,0,0,1,1,1,1,0,0,0,0,0,0,0,0,0,0,0,1,0
1,0,0,1,1,1,1,0,0,0,0,1,0,0,0,1,0,1,1,0
1,9,0,1,1,1,2,0,0,0,0,0,0,0,0,0,0,0,11,0
1,0,0,1,1,1,1,0,0,0,0,1,0,0,0,1,0,1,1,0
1,0,0,1,1,1,2,5.33,1.5,12,0,4,0.67,0.67,1,3,1,3,2,0
1,0,0,1,1,1,2,5.33,1.5,12,0,4,0.67,0.67,1,3,1,3,2,0
1,9,0,1,1,1,2,0,0,0,0,9,0,0,9,0,1,0,11,0
1,0,0,1,1,1,1,0,0,0,0,0,0,0,0,0,0,0,1,0
1,0,0,1,1,1,1,0,0,0,0,0,0,0,0,0,0,0,1,0
1,0,0,1,1,1,1,0,0,0,0,1,0,0,0,1,0,1,1,0
1,0,0,1,1,1,4,18.49,2.4,106.51,0.01,14,0.42,5.92,6,8,5,4,4,0
1,0,0,1,1,1,2,5.33,1.5,12,0,4,0.67,0.67,1,3,1,3,2,0
1,0,0,1,1,1,5,8.45,0.75,4.75,0,4,1.33,0.26,3,1,2,1,5,0
5,5,0,3,3,1,14,19.38,11.81,2703.86,0.08,56,0.08,150.21,21,35,8,9,19,0
5,16,0,3,2,1,9,22.7,11,2747.01,0.08,56,0.09,152.61,22,34,11,11,25,0
5,16,0,3,2,1,9,22.7,11,2747.01,0.08,56,0.09,152.61,22,34,11,11,25,0
5,16,0,3,2,1,9,22.7,11,2747.01,0.08,56,0.09,152.61,22,34,11,11,25,0
5,16,0,3,2,1,9,22.7,11,2747.01,0.08,56,0.09,152.61,22,34,11,11,25,0
5,16,0,3,2,1,9,22.7,11,2747.01,0.08,56,0.09,152.61,22,34,11,11,25,0
5,16,0,3,2,1,9,27.59,9.31,2389.82,0.09,56,0.11,132.77,22,34,13,11,25,0
5,16,0,3,2,1,9,27.59,9.31,2389.82,0.09,56,0.11,132.77,22,34,13,11,25,0
1,0,0,1,1,1,1,0,0,0,0,0,0,0,0,0,0,0,1,0
1,0,0,1,1,1,1,0,0,0,0,1,0,0,0,1,0,1,1,0
1,0,0,1,1,1,3,10.8,2.5,67.5,0.01,9,0.4,3.75,3,6,3,5,3,0
1,0,0,1,1,1,2,5.33,1.5,12,0,4,0.67,0.67,1,3,1,3,2,0
1,0,0,1,1,1,2,6.2,2.5,38.77,0.01,6,0.4,2.15,1,5,1,5,2,0
1,0,0,1,1,1,4,9.51,0.5,2.38,0,3,2,0.13,2,1,2,1,4,0
5,5,0,3,3,1,13,18.89,11.25,2391.17,0.07,52,0.09,132.84,20,32,8,9,18,0
1,0,0,1,1,1,1,0,0,0,0,1,0,0,0,1,0,1,1,0
1,0,0,1,1,1,2,8,3,72,0.01,8,0.33,4,2,6,2,6,2,0
1,0,0,1,1,1,2,8,3,72,0.01,8,0.33,4,2,6,2,6,2,0
1,0,0,1,1,1,2,8,3,72,0.01,8,0.33,4,2,6,2,6,2,0
1,0,0,1,1,1,2,8,3,72,0.01,8,0.33,4,2,6,2,6,2,0
1,0,0,1,1,1,2,8,3,72,0.01,8,0.33,4,2,6,2,6,2,0
1,0,0,1,1,1,2,8,3,72,0.01,8,0.33,4,2,6,2,6,2,0
1,0,0,1,1,1,2,8,3,72,0.01,8,0.33,4,2,6,2,6,2,0
1,0,0,1,1,1,2,8,3,72,0.01,8,0.33,4,2,6,2,6,2,0
1,0,0,1,1,1,2,8,3,72,0.01,8,0.33,4,2,6,2,6,2,0
1,0,0,1,1,1,2,8,3,72,0.01,8,0.33,4,2,6,2,6,2,0
1,0,0,1,1,1,2,8,3,72,0.01,8,0.33,4,2,6,2,6,2,0
1,0,0,1,1,1,2,8,3,72,0.01,8,0.33,4,2,6,2,6,2,0
13,12,9,7,1,1,36,27.19,26,18382.41,0.24,128,0.04,1021.25,52,76,23,23,48,1
9,10,7,5,1,1,25,30.91,21.08,13741.7,0.22,118,0.05,763.43,46,72,24,22,35,0
1,0,0,1,1,1,3,21.46,5.5,649.15,0.04,31,0.18,36.06,11,20,7,7,3,0
1,0,0,1,1,1,3,21.46,5.5,649.15,0.04,31,0.18,36.06,11,20,7,7,3,0
1,0,0,1,1,1,3,21.46,5.5,649.15,0.04,31,0.18,36.06,11,20,7,7,3,0
1,0,0,1,1,1,3,21.46,5.5,649.15,0.04,31,0.18,36.06,11,20,7,7,3,0
1,0,0,1,1,1,3,21.46,5.5,649.15,0.04,31,0.18,36.06,11,20,7,7,3,0
1,0,0,1,1,1,3,21.46,5.5,649.15,0.04,31,0.18,36.06,11,20,7,7,3,0
1,0,0,1,1,1,2,8,3,72,0.01,8,0.33,4,2,6,2,6,2,0
1,0,0,1,1,1,2,8,3,72,0.01,8,0.33,4,2,6,2,6,2,0
1,0,0,1,1,1,1,0,0,0,0,1,0,0,0,1,0,1,1,0
1,0,0,1,1,1,1,0,0,0,0,1,0,0,0,1,0,1,1,0
1,0,0,1,1,1,1,0,0,0,0,1,0,0,0,1,0,1,1,0
1,0,0,1,1,1,1,0,0,0,0,1,0,0,0,1,0,1,1,0
1,0,0,1,1,1,2,5.33,1.5,12,0,4,0.67,0.67,1,3,1,3,2,0
1,0,0,1,1,1,2,5.33,1.5,12,0,4,0.67,0.67,1,3,1,3,2,0
1,0,0,1,1,1,2,5.33,1.5,12,0,4,0.67,0.67,1,3,1,3,2,0
1,0,0,1,1,1,2,5.33,1.5,12,0,4,0.67,0.67,1,3,1,3,2,0
1,0,0,1,1,1,2,5.33,1.5,12,0,4,0.67,0.67,1,3,1,3,2,0
1,0,0,1,1,1,2,5.33,1.5,12,0,4,0.67,0.67,1,3,1,3,2,0
1,0,0,1,1,1,2,5.33,1.5,12,0,4,0.67,0.67,1,3,1,3,2,0
1,0,0,1,1,1,1,0,0,0,0,0,0,0,0,0,0,0,1,0
1,0,0,1,1,1,1,0,0,0,0,1,0,0,0,1,0,1,1,0
1,0,0,1,1,1,2,5.33,1.5,12,0,4,0.67,0.67,1,3,1,3,2,0
1,0,0,1,1,1,2,5.33,1.5,12,0,4,0.67,0.67,1,3,1,3,2,0
1,9,0,1,1,1,2,0,0,0,0,9,0,0,9,0,1,0,11,0
1,0,0,1,1,1,1,0,0,0,0,0,0,0,0,0,0,0,1,0
1,0,0,1,1,1,1,0,0,0,0,0,0,0,0,0,0,0,1,0
1,0,0,1,1,1,1,0,0,0,0,1,0,0,0,1,0,1,1,0
1,0,0,1,1,1,4,18.49,2.4,106.51,0.01,14,0.42,5.92,6,8,5,4,4,0
1,0,0,1,1,1,2,5.33,1.5,12,0,4,0.67,0.67,1,3,1,3,2,0
1,0,0,1,1,1,5,8.45,0.75,4.75,0,4,1.33,0.26,3,1,2,1,5,0
1,0,0,1,1,1,1,0,0,0,0,0,0,0,0,0,0,0,1,0
1,0,0,1,1,1,1,0,0,0,0,1,0,0,0,1,0,1,1,0
1,0,0,1,1,1,3,10.8,2.5,67.5,0.01,9,0.4,3.75,3,6,3,5,3,0
1,0,0,1,1,1,2,5.33,1.5,12,0,4,0.67,0.67,1,3,1,3,2,0
1,0,0,1,1,1,2,6.2,2.5,38.77,0.01,6,0.4,2.15,1,5,1,5,2,0
1,0,0,1,1,1,4,9.51,0.5,2.38,0,3,2,0.13,2,1,2,1,4,0
1,0,0,1,1,1,1,0,0,0,0,1,0,0,0,1,0,1,1,0
1,0,0,1,1,1,1,0,0,0,0,1,0,0,0,1,0,1,1,0
1,0,0,1,1,1,1,0,0,0,0,1,0,0,0,1,0,1,1,0
1,0,0,1,1,1,1,0,0,0,0,1,0,0,0,1,0,1,1,0
1,0,0,1,1,1,1,0,0,0,0,1,0,0,0,1,0,1,1,0
1,0,0,1,1,1,1,0,0,0,0,1,0,0,0,1,0,1,1,0
1,0,0,1,1,1,1,0,0,0,0,1,0,0,0,1,0,1,1,0
1,0,0,1,1,1,1,0,0,0,0,1,0,0,0,1,0,1,1,0
3,0,0,2,2,1,8,19.46,7.5,1094.61,0.05,35,0.13,60.81,15,20,9,9,8,1
3,0,2,2,2,1,8,17.65,7.88,1094.42,0.05,34,0.13,60.8,14,20,8,9,8,1
3,0,0,2,2,1,8,19.46,7.5,1094.61,0.05,35,0.13,60.81,15,20,9,9,8,1
1,0,0,1,1,1,2,9.51,3,85.59,0.01,9,0.33,4.75,3,6,3,6,2,1
1,0,0,1,1,1,2,5.33,1.5,12,0,4,0.67,0.67,1,3,1,3,2,0
1,0,0,1,1,1,2,5.33,1.5,12,0,4,0.67,0.67,1,3,1,3,2,0
1,0,0,1,1,1,2,5.33,1.5,12,0,4,0.67,0.67,1,3,1,3,2,0
1,0,0,1,1,1,2,9.51,3,85.59,0.01,9,0.33,4.75,3,6,3,6,2,0
1,0,0,1,1,1,2,5.33,1.5,12,0,4,0.67,0.67,1,3,1,3,2,0
1,0,0,1,1,1,2,5.33,1.5,12,0,4,0.67,0.67,1,3,1,3,2,0
1,0,0,1,1,1,2,9.51,3,85.59,0.01,9,0.33,4.75,3,6,3,6,2,1
1,0,0,1,1,1,2,5.33,1.5,12,0,4,0.67,0.67,1,3,1,3,2,0
1,0,0,1,1,1,2,5.33,1.5,12,0,4,0.67,0.67,1,3,1,3,2,0
1,0,0,1,1,1,2,5.33,1.5,12,0,4,0.67,0.67,1,3,1,3,2,0
1,0,0,1,1,1,2,5.33,1.5,12,0,4,0.67,0.67,1,3,1,3,2,0
1,0,0,1,1,1,2,8,3,72,0.01,8,0.33,4,2,6,2,6,2,0
35,26,8,18,6,18,70,27.44,53.24,77776.02,0.49,263,0.02,4320.89,121,142,25,22,96,1
1,0,0,1,1,1,2,7.86,2.5,49.13,0.01,7,0.4,2.73,2,5,2,5,2,0
3,0,2,2,2,1,8,17.65,7.88,1094.42,0.05,34,0.13,60.8,14,20,8,9,8,1
3,0,1,2,2,1,8,17.65,7.88,1094.42,0.05,34,0.13,60.8,14,20,8,9,8,1
1,0,0,1,1,1,2,5.33,1.5,12,0,4,0.67,0.67,1,3,1,3,2,0
3,0,0,2,2,1,6,9.25,7.2,479.58,0.02,18,0.14,26.64,9,9,5,8,6,1
3,0,0,2,2,1,15,13.35,19.29,4966.27,0.09,63,0.05,275.9,27,36,7,10,15,1
3,0,0,2,2,1,6,9.25,7.2,479.58,0.02,18,0.14,26.64,9,9,5,8,6,1
1,0,0,1,1,1,2,0,0,0,0,4,0,0,0,4,0,4,2,0
1,0,0,1,1,1,1,0,0,0,0,1,0,0,0,1,0,1,1,0
1,0,0,1,1,1,2,0,0,0,0,5,0,0,0,5,0,5,2,0
3,0,0,2,2,1,8,19.46,7.5,1094.61,0.05,35,0.13,60.81,15,20,9,9,8,1
3,0,1,2,2,1,8,19.46,7.5,1094.61,0.05,35,0.13,60.81,15,20,9,9,8,1
3,0,1,2,2,1,8,17.65,7.88,1094.42,0.05,34,0.13,60.8,14,20,8,9,8,1
3,0,0,2,2,1,8,17.65,7.88,1094.42,0.05,34,0.13,60.8,14,20,8,9,8,1
3,0,1,2,2,1,8,19.46,7.5,1094.61,0.05,35,0.13,60.81,15,20,9,9,8,1
3,0,0,2,2,1,8,19.46,7.5,1094.61,0.05,35,0.13,60.81,15,20,9,9,8,1
1,2,0,1,1,1,1,16.84,1.5,37.9,0.01,9,0.67,2.11,4,5,4,3,3,0
1,0,0,1,1,1,2,5.33,1.5,12,0,4,0.67,0.67,1,3,1,3,2,0
1,0,0,1,1,1,1,0,0,0,0,0,0,0,0,0,0,0,1,0
1,0,0,1,1,1,13,10.6,19.25,3929.05,0.07,59,0.05,218.28,22,37,4,7,13,1
1,0,0,1,1,1,2,5.8,2,23.22,0,5,0.5,1.29,1,4,1,4,2,1
1,0,0,1,1,1,1,0,0,0,0,1,0,0,0,1,0,1,1,0
1,0,0,1,1,1,2,5.33,1.5,12,0,4,0.67,0.67,1,3,1,3,2,0
1,0,0,1,1,1,2,5.33,1.5,12,0,4,0.67,0.67,1,3,1,3,2,0
1,9,0,1,1,1,2,0,0,0,0,9,0,0,9,0,1,0,11,0
3,0,1,2,2,1,13,16.02,7.14,817.49,0.04,28,0.14,45.42,10,18,7,10,13,1
1,0,0,1,1,1,2,9.51,3,85.59,0.01,9,0.33,4.75,3,6,3,6,2,0
7,2,4,4,4,1,20,20.3,12.27,3057.42,0.08,53,0.08,169.86,18,35,11,15,22,1
1,0,0,1,1,1,1,0,0,0,0,1,0,0,0,1,0,1,1,0
1,0,0,1,1,1,2,5.33,1.5,12,0,4,0.67,0.67,1,3,1,3,2,0
1,0,0,1,1,1,2,5.33,1.5,12,0,4,0.67,0.67,1,3,1,3,2,0
1,0,0,1,1,1,2,0,0,0,0,4,0,0,0,4,0,4,2,0
1,0,0,1,1,1,1,0,0,0,0,1,0,0,0,1,0,1,1,0
1,0,0,1,1,1,2,0,0,0,0,5,0,0,0,5,0,5,2,0
1,0,0,1,1,1,1,0,0,0,0,1,0,0,0,1,0,1,1,0
1,0,0,1,1,1,2,5.33,1.5,12,0,4,0.67,0.67,1,3,1,3,2,0
1,0,0,1,1,1,2,5.33,1.5,12,0,4,0.67,0.67,1,3,1,3,2,0
21,5,11,11,8,10,101,44.63,37.74,63573.01,0.56,300,0.03,3531.83,130,170,31,18,106,1
1,14,0,1,1,1,2,0,0,0,0,0,0,0,0,0,0,0,16,0
1,0,0,1,1,1,1,0,0,0,0,1,0,0,0,1,0,1,1,0
1,0,0,1,1,1,2,5.33,1.5,12,0,4,0.67,0.67,1,3,1,3,2,0
1,0,0,1,1,1,2,5.33,1.5,12,0,4,0.67,0.67,1,3,1,3,2,0
1,0,0,1,1,1,1,0,0,0,0,1,0,0,0,1,0,1,1,0
1,0,0,1,1,1,2,5.33,1.5,12,0,4,0.67,0.67,1,3,1,3,2,0
1,0,0,1,1,1,2,5.33,1.5,12,0,4,0.67,0.67,1,3,1,3,2,0
1,0,0,1,1,1,2,0,0,0,0,4,0,0,0,4,0,4,2,0
1,0,0,1,1,1,1,0,0,0,0,1,0,0,0,1,0,1,1,0
1,0,0,1,1,1,2,0,0,0,0,5,0,0,0,5,0,5,2,0
1,0,0,1,1,1,1,0,0,0,0,1,0,0,0,1,0,1,1,0
1,0,0,1,1,1,2,5.33,1.5,12,0,4,0.67,0.67,1,3,1,3,2,0
1,0,0,1,1,1,2,5.33,1.5,12,0,4,0.67,0.67,1,3,1,3,2,0
1,0,0,1,1,1,1,0,0,0,0,1,0,0,0,1,0,1,1,0
1,0,0,1,1,1,2,5.33,1.5,12,0,4,0.67,0.67,1,3,1,3,2,0
1,0,0,1,1,1,2,5.33,1.5,12,0,4,0.67,0.67,1,3,1,3,2,0
5,2,2,3,3,1,12,20.08,10.05,2026.55,0.07,44,0.1,112.59,17,27,11,13,14,1
17,7,13,9,7,1,65,108.64,19.61,41790.22,0.71,339,0.05,2321.68,152,187,62,16,72,1
7,2,2,4,3,1,19,28.16,11.27,3574.75,0.11,66,0.09,198.6,26,40,15,13,21,1
1,0,0,1,1,1,1,0,0,0,0,0,0,0,0,0,0,0,1,0
1,0,0,1,1,1,1,0,0,0,0,0,0,0,0,0,0,0,1,0
1,0,0,1,1,1,1,0,0,0,0,1,0,0,0,1,0,1,1,0
1,0,0,1,1,1,4,18.49,2.4,106.51,0.01,14,0.42,5.92,6,8,5,4,4,0
1,0,0,1,1,1,2,5.33,1.5,12,0,4,0.67,0.67,1,3,1,3,2,0
1,0,0,1,1,1,5,8.45,0.75,4.75,0,4,1.33,0.26,3,1,2,1,5,0
1,0,0,1,1,1,1,0,0,0,0,0,0,0,0,0,0,0,1,0
1,0,0,1,1,1,1,0,0,0,0,1,0,0,0,1,0,1,1,0
1,0,0,1,1,1,3,10.8,2.5,67.5,0.01,9,0.4,3.75,3,6,3,5,3,0
1,0,0,1,1,1,2,5.33,1.5,12,0,4,0.67,0.67,1,3,1,3,2,0
1,0,0,1,1,1,2,6.2,2.5,38.77,0.01,6,0.4,2.15,1,5,1,5,2,0
1,0,0,1,1,1,4,9.51,0.5,2.38,0,3,2,0.13,2,1,2,1,4,0
1,0,0,1,1,1,1,0,0,0,0,1,0,0,0,1,0,1,1,0
1,0,0,1,1,1,2,5.33,1.5,12,0,4,0.67,0.67,1,3,1,3,2,0
1,0,0,1,1,1,2,5.33,1.5,12,0,4,0.67,0.67,1,3,1,3,2,0
1,0,0,1,1,1,2,0,0,0,0,4,0,0,0,4,0,4,2,0
1,0,0,1,1,1,1,0,0,0,0,1,0,0,0,1,0,1,1,0
1,0,0,1,1,1,2,0,0,0,0,5,0,0,0,5,0,5,2,0
1,0,0,1,1,1,1,0,0,0,0,1,0,0,0,1,0,1,1,0
1,0,0,1,1,1,2,5.33,1.5,12,0,4,0.67,0.67,1,3,1,3,2,0
1,0,0,1,1,1,2,5.33,1.5,12,0,4,0.67,0.67,1,3,1,3,2,0
1,0,0,1,1,1,1,0,0,0,0,1,0,0,0,1,0,1,1,0
1,0,0,1,1,1,1,0,0,0,0,1,0,0,0,1,0,1,1,0
1,0,0,1,1,1,1,0,0,0,0,1,0,0,0,1,0,1,1,0
1,0,0,1,1,1,1,0,0,0,0,1,0,0,0,1,0,1,1,0
1,0,0,1,1,1,1,0,0,0,0,1,0,0,0,1,0,1,1,0
1,0,0,1,1,1,1,0,0,0,0,1,0,0,0,1,0,1,1,0
1,0,0,1,1,1,1,0,0,0,0,1,0,0,0,1,0,1,1,0
1,0,0,1,1,1,1,0,0,0,0,1,0,0,0,1,0,1,1,0
1,0,0,1,1,1,2,5.33,1.5,12,0,4,0.67,0.67,1,3,1,3,2,0
1,0,0,1,1,1,2,5.33,1.5,12,0,4,0.67,0.67,1,3,1,3,2,0
1,0,0,1,1,1,2,5.33,1.5,12,0,4,0.67,0.67,1,3,1,3,2,0
1,0,0,1,1,1,2,5.33,1.5,12,0,4,0.67,0.67,1,3,1,3,2,0
1,0,0,1,1,1,2,5.33,1.5,12,0,4,0.67,0.67,1,3,1,3,2,0
1,0,0,1,1,1,2,5.33,1.5,12,0,4,0.67,0.67,1,3,1,3,2,0
1,0,0,1,1,1,2,5.33,1.5,12,0,4,0.67,0.67,1,3,1,3,2,0
1,0,0,1,1,1,1,0,0,0,0,0,0,0,0,0,0,0,1,0
1,0,0,1,1,1,1,0,0,0,0,1,0,0,0,1,0,1,1,0
1,0,0,1,1,1,2,5.33,1.5,12,0,4,0.67,0.67,1,3,1,3,2,0
1,0,0,1,1,1,2,5.33,1.5,12,0,4,0.67,0.67,1,3,1,3,2,0
1,9,0,1,1,1,2,0,0,0,0,9,0,0,9,0,1,0,11,0
9,4,0,5,5,1,31,28.81,17.87,9204.66,0.17,106,0.06,511.37,44,62,16,13,35,1
1,14,0,1,1,1,2,0,0,0,0,0,0,0,0,0,0,0,16,0
5,1,0,3,3,1,16,21.02,14,4120.51,0.1,66,0.07,228.92,28,38,11,11,17,0
5,1,0,3,3,1,16,21.02,14,4120.51,0.1,66,0.07,228.92,28,38,11,11,17,0
5,1,0,3,3,1,16,21.02,14,4120.51,0.1,66,0.07,228.92,28,38,11,11,17,0
5,1,0,3,3,1,16,21.02,14,4120.51,0.1,66,0.07,228.92,28,38,11,11,17,0
5,1,0,3,3,1,19,20.61,19.09,7513.23,0.13,87,0.05,417.4,35,52,11,12,20,0
15,18,3,8,6,1,33,79.72,9.93,7861.76,0.26,141,0.1,436.76,55,86,36,13,51,1
1,0,0,1,1,1,1,0,0,0,0,0,0,0,0,0,0,0,1,0
1,0,0,1,1,1,1,0,0,0,0,0,0,0,0,0,0,0,1,0
1,0,0,1,1,1,1,0,0,0,0,1,0,0,0,1,0,1,1,0
1,0,0,1,1,1,4,18.49,2.4,106.51,0.01,14,0.42,5.92,6,8,5,4,4,0
1,0,0,1,1,1,2,5.33,1.5,12,0,4,0.67,0.67,1,3,1,3,2,0
1,0,0,1,1,1,5,8.45,0.75,4.75,0,4,1.33,0.26,3,1,2,1,5,0
1,0,0,1,1,1,1,0,0,0,0,0,0,0,0,0,0,0,1,0
1,0,0,1,1,1,1,0,0,0,0,1,0,0,0,1,0,1,1,0
1,0,0,1,1,1,3,10.8,2.5,67.5,0.01,9,0.4,3.75,3,6,3,5,3,0
1,0,0,1,1,1,2,5.33,1.5,12,0,4,0.67,0.67,1,3,1,3,2,0
1,0,0,1,1,1,2,6.2,2.5,38.77,0.01,6,0.4,2.15,1,5,1,5,2,0
1,0,0,1,1,1,4,9.51,0.5,2.38,0,3,2,0.13,2,1,2,1,4,0
1,0,0,1,1,1,1,0,0,0,0,1,0,0,0,1,0,1,1,0
1,0,0,1,1,1,1,0,0,0,0,1,0,0,0,1,0,1,1,0
1,0,0,1,1,1,1,0,0,0,0,1,0,0,0,1,0,1,1,0
1,0,0,1,1,1,1,0,0,0,0,1,0,0,0,1,0,1,1,0
1,0,0,1,1,1,1,0,0,0,0,1,0,0,0,1,0,1,1,0
1,0,0,1,1,1,1,0,0,0,0,1,0,0,0,1,0,1,1,0
1,0,0,1,1,1,2,5.33,1.5,12,0,4,0.67,0.67,1,3,1,3,2,0
1,0,0,1,1,1,2,5.33,1.5,12,0,4,0.67,0.67,1,3,1,3,2,0
1,0,0,1,1,1,2,5.33,1.5,12,0,4,0.67,0.67,1,3,1,3,2,0
1,0,0,1,1,1,2,5.33,1.5,12,0,4,0.67,0.67,1,3,1,3,2,0
1,0,0,1,1,1,2,5.33,1.5,12,0,4,0.67,0.67,1,3,1,3,2,0
1,0,0,1,1,1,2,5.33,1.5,12,0,4,0.67,0.67,1,3,1,3,2,0
1,0,0,1,1,1,2,5.33,1.5,12,0,4,0.67,0.67,1,3,1,3,2,0
1,0,0,1,1,1,1,0,0,0,0,0,0,0,0,0,0,0,1,0
1,0,0,1,1,1,2,8,3,72,0.01,8,0.33,4,2,6,2,6,2,0
1,0,0,1,1,1,2,8,3,72,0.01,8,0.33,4,2,6,2,6,2,0
1,0,0,1,1,1,2,8,3,72,0.01,8,0.33,4,2,6,2,6,2,0
1,0,0,1,1,1,2,8,3,72,0.01,8,0.33,4,2,6,2,6,2,0
1,0,0,1,1,1,2,8,3,72,0.01,8,0.33,4,2,6,2,6,2,0
1,0,0,1,1,1,2,8,3,72,0.01,8,0.33,4,2,6,2,6,2,0
1,0,0,1,1,1,2,8,3,72,0.01,8,0.33,4,2,6,2,6,2,0
1,0,0,1,1,1,2,8,3,72,0.01,8,0.33,4,2,6,2,6,2,0
1,0,0,1,1,1,2,8,3,72,0.01,8,0.33,4,2,6,2,6,2,0
1,0,0,1,1,1,2,8,3,72,0.01,8,0.33,4,2,6,2,6,2,0
1,0,0,1,1,1,1,0,0,0,0,1,0,0,0,1,0,1,1,0
1,0,0,1,1,1,2,5.33,1.5,12,0,4,0.67,0.67,1,3,1,3,2,0
1,0,0,1,1,1,2,5.33,1.5,12,0,4,0.67,0.67,1,3,1,3,2,0
1,9,0,1,1,1,2,0,0,0,0,9,0,0,9,0,1,0,11,1
1,0,0,1,1,1,2,8,3,72,0.01,8,0.33,4,2,6,2,6,2,0
1,0,0,1,1,1,2,8,3,72,0.01,8,0.33,4,2,6,2,6,2,0
1,14,0,1,1,1,2,0,0,0,0,0,0,0,0,0,0,0,16,0
1,0,0,1,1,1,3,21.46,5.5,649.15,0.04,31,0.18,36.06,11,20,7,7,3,0
1,0,0,1,1,1,3,21.46,5.5,649.15,0.04,31,0.18,36.06,11,20,7,7,3,0
1,0,0,1,1,1,3,21.46,5.5,649.15,0.04,31,0.18,36.06,11,20,7,7,3,0
1,0,0,1,1,1,3,21.46,5.5,649.15,0.04,31,0.18,36.06,11,20,7,7,3,0
1,0,0,1,1,1,3,21.46,5.5,649.15,0.04,31,0.18,36.06,11,20,7,7,3,0
1,0,0,1,1,1,3,21.46,5.5,649.15,0.04,31,0.18,36.06,11,20,7,7,3,0
1,0,0,1,1,1,2,8,3,72,0.01,8,0.33,4,2,6,2,6,2,0
1,0,0,1,1,1,2,8,3,72,0.01,8,0.33,4,2,6,2,6,2,0
1,0,0,1,1,1,1,0,0,0,0,0,0,0,0,0,0,0,1,0
1,0,0,1,1,1,1,0,0,0,0,0,0,0,0,0,0,0,1,0
1,0,0,1,1,1,1,0,0,0,0,1,0,0,0,1,0,1,1,0
1,0,0,1,1,1,4,18.49,2.4,106.51,0.01,14,0.42,5.92,6,8,5,4,4,0
1,0,0,1,1,1,2,5.33,1.5,12,0,4,0.67,0.67,1,3,1,3,2,0
1,0,0,1,1,1,5,8.45,0.75,4.75,0,4,1.33,0.26,3,1,2,1,5,0
1,0,0,1,1,1,1,0,0,0,0,0,0,0,0,0,0,0,1,0
1,0,0,1,1,1,1,0,0,0,0,1,0,0,0,1,0,1,1,0
1,0,0,1,1,1,3,10.8,2.5,67.5,0.01,9,0.4,3.75,3,6,3,5,3,0
1,0,0,1,1,1,2,5.33,1.5,12,0,4,0.67,0.67,1,3,1,3,2,0
1,0,0,1,1,1,2,6.2,2.5,38.77,0.01,6,0.4,2.15,1,5,1,5,2,0
1,0,0,1,1,1,4,9.51,0.5,2.38,0,3,2,0.13,2,1,2,1,4,0
1,0,0,1,1,1,1,0,0,0,0,1,0,0,0,1,0,1,1,0
11,5,5,6,5,1,23,20.21,13,3415.2,0.09,69,0.08,189.73,26,43,7,7,28,1
1,0,0,1,1,1,1,0,0,0,0,1,0,0,0,1,0,1,1,0
1,0,0,1,1,1,1,0,0,0,0,1,0,0,0,1,0,1,1,0
1,0,0,1,1,1,1,0,0,0,0,1,0,0,0,1,0,1,1,0
1,0,0,1,1,1,1,0,0,0,0,1,0,0,0,1,0,1,1,0
1,0,0,1,1,1,1,0,0,0,0,1,0,0,0,1,0,1,1,0
1,0,0,1,1,1,1,0,0,0,0,1,0,0,0,1,0,1,1,0
1,0,0,1,1,1,1,0,0,0,0,1,0,0,0,1,0,1,1,0
1,0,0,1,1,1,2,5.33,1.5,12,0,4,0.67,0.67,1,3,1,3,2,0
1,0,0,1,1,1,2,5.33,1.5,12,0,4,0.67,0.67,1,3,1,3,2,0
1,0,0,1,1,1,2,5.33,1.5,12,0,4,0.67,0.67,1,3,1,3,2,0
1,0,0,1,1,1,2,5.33,1.5,12,0,4,0.67,0.67,1,3,1,3,2,0
1,0,0,1,1,1,2,5.33,1.5,12,0,4,0.67,0.67,1,3,1,3,2,0
1,0,0,1,1,1,2,5.33,1.5,12,0,4,0.67,0.67,1,3,1,3,2,0
1,0,0,1,1,1,2,5.33,1.5,12,0,4,0.67,0.67,1,3,1,3,2,0
1,0,0,1,1,1,2,5.33,1.5,12,0,4,0.67,0.67,1,3,1,3,2,0
1,0,0,1,1,1,2,5.33,1.5,12,0,4,0.67,0.67,1,3,1,3,2,0
1,0,0,1,1,1,2,5.33,1.5,12,0,4,0.67,0.67,1,3,1,3,2,0
1,0,0,1,1,1,2,0,0,0,0,4,0,0,0,4,0,4,2,0
1,0,0,1,1,1,1,0,0,0,0,1,0,0,0,1,0,1,1,0
1,0,0,1,1,1,2,0,0,0,0,5,0,0,0,5,0,5,2,0
1,2,0,1,1,1,1,16.84,1.5,37.9,0.01,9,0.67,2.11,4,5,4,3,3,0
1,0,0,1,1,1,2,5.33,1.5,12,0,4,0.67,0.67,1,3,1,3,2,0
1,0,0,1,1,1,1,0,0,0,0,0,0,0,0,0,0,0,1,0
1,0,0,1,1,1,1,0,0,0,0,1,0,0,0,1,0,1,1,0
1,0,0,1,1,1,2,5.33,1.5,12,0,4,0.67,0.67,1,3,1,3,2,0
1,0,0,1,1,1,2,5.33,1.5,12,0,4,0.67,0.67,1,3,1,3,2,0
1,9,0,1,1,1,2,0,0,0,0,9,0,0,9,0,1,0,11,0
1,0,0,1,1,1,1,0,0,0,0,1,0,0,0,1,0,1,1,0
1,0,0,1,1,1,2,5.33,1.5,12,0,4,0.67,0.67,1,3,1,3,2,0
1,0,0,1,1,1,2,5.33,1.5,12,0,4,0.67,0.67,1,3,1,3,2,0
1,0,0,1,1,1,2,0,0,0,0,4,0,0,0,4,0,4,2,0
1,0,0,1,1,1,1,0,0,0,0,1,0,0,0,1,0,1,1,0
1,0,0,1,1,1,2,0,0,0,0,5,0,0,0,5,0,5,2,0
1,0,0,1,1,1,1,0,0,0,0,1,0,0,0,1,0,1,1,0
1,0,0,1,1,1,2,5.33,1.5,12,0,4,0.67,0.67,1,3,1,3,2,0
1,0,0,1,1,1,2,5.33,1.5,12,0,4,0.67,0.67,1,3,1,3,2,0
1,14,0,1,1,1,2,0,0,0,0,0,0,0,0,0,0,0,16,0
1,0,0,1,1,1,1,0,0,0,0,1,0,0,0,1,0,1,1,0
1,0,0,1,1,1,2,5.33,1.5,12,0,4,0.67,0.67,1,3,1,3,2,0
1,0,0,1,1,1,2,5.33,1.5,12,0,4,0.67,0.67,1,3,1,3,2,0
1,0,0,1,1,1,1,0,0,0,0,1,0,0,0,1,0,1,1,0
1,0,0,1,1,1,2,5.33,1.5,12,0,4,0.67,0.67,1,3,1,3,2,0
1,0,0,1,1,1,2,5.33,1.5,12,0,4,0.67,0.67,1,3,1,3,2,0
1,0,0,1,1,1,2,0,0,0,0,4,0,0,0,4,0,4,2,0
1,0,0,1,1,1,1,0,0,0,0,1,0,0,0,1,0,1,1,0
1,0,0,1,1,1,2,0,0,0,0,5,0,0,0,5,0,5,2,0
1,0,0,1,1,1,1,0,0,0,0,1,0,0,0,1,0,1,1,0
1,0,0,1,1,1,2,5.33,1.5,12,0,4,0.67,0.67,1,3,1,3,2,0
1,0,0,1,1,1,2,5.33,1.5,12,0,4,0.67,0.67,1,3,1,3,2,0
1,0,0,1,1,1,1,0,0,0,0,1,0,0,0,1,0,1,1,0
1,0,0,1,1,1,2,5.33,1.5,12,0,4,0.67,0.67,1,3,1,3,2,0
1,0,0,1,1,1,2,5.33,1.5,12,0,4,0.67,0.67,1,3,1,3,2,0
1,0,0,1,1,1,1,0,0,0,0,0,0,0,0,0,0,0,1,0
1,0,0,1,1,1,1,0,0,0,0,0,0,0,0,0,0,0,1,0
1,0,0,1,1,1,1,0,0,0,0,1,0,0,0,1,0,1,1,0
1,0,0,1,1,1,4,18.49,2.4,106.51,0.01,14,0.42,5.92,6,8,5,4,4,0
1,0,0,1,1,1,2,5.33,1.5,12,0,4,0.67,0.67,1,3,1,3,2,0
1,0,0,1,1,1,5,8.45,0.75,4.75,0,4,1.33,0.26,3,1,2,1,5,0
1,0,0,1,1,1,2,7.75,2,31.02,0.01,6,0.5,1.72,2,4,2,4,2,0
34,33,3,21,7,1,103,40.31,58.71,138949.53,0.79,404,0.02,7719.42,155,249,33,25,136,1
25,33,3,18,6,1,57,41.34,39.71,65167.57,0.55,279,0.03,3620.42,108,171,34,25,90,1
15,19,1,10,5,1,32,36.91,22.5,18684.38,0.28,154,0.04,1038.02,60,94,24,18,51,0
5,0,1,3,3,1,14,28.61,9.67,2673.83,0.09,64,0.1,148.55,29,35,12,8,14,0
1,0,0,1,1,1,2,12.68,2.5,79.25,0.01,10,0.4,4.4,4,6,4,5,2,0
5,16,0,3,2,1,9,22.7,11,2747.01,0.08,56,0.09,152.61,22,34,11,11,25,0
5,16,0,3,2,1,9,22.7,11,2747.01,0.08,56,0.09,152.61,22,34,11,11,25,0
5,16,0,3,2,1,9,22.7,11,2747.01,0.08,56,0.09,152.61,22,34,11,11,25,0
5,16,0,3,2,1,9,22.7,11,2747.01,0.08,56,0.09,152.61,22,34,11,11,25,0
5,22,0,3,2,1,9,26.53,12.27,3994.03,0.11,71,0.08,221.89,29,42,13,11,31,0
5,22,0,3,2,1,9,26.53,12.27,3994.03,0.11,71,0.08,221.89,29,42,13,11,31,0
5,22,0,3,2,1,9,24.16,13.29,4268.92,0.11,71,0.08,237.16,29,42,12,11,31,0
5,22,0,3,2,1,9,24.16,13.29,4268.92,0.11,71,0.08,237.16,29,42,12,11,31,0
5,22,0,3,2,1,9,24.16,13.29,4268.92,0.11,71,0.08,237.16,29,42,12,11,31,0
5,22,0,3,2,1,9,36.38,9.38,3202.41,0.11,71,0.11,177.91,29,42,17,11,31,0
5,22,0,3,2,1,9,36.38,9.38,3202.41,0.11,71,0.11,177.91,29,42,17,11,31,0
5,16,0,3,2,1,9,22.7,11,2747.01,0.08,56,0.09,152.61,22,34,11,11,25,0
5,16,0,3,2,1,9,27.59,9.31,2389.82,0.09,56,0.11,132.77,22,34,13,11,25,0
5,16,0,3,2,1,9,27.59,9.31,2389.82,0.09,56,0.11,132.77,22,34,13,11,25,0
1,0,0,1,1,1,1,0,0,0,0,0,0,0,0,0,0,0,1,0
1,0,0,1,1,1,1,0,0,0,0,1,0,0,0,1,0,1,1,0
1,0,0,1,1,1,3,10.8,2.5,67.5,0.01,9,0.4,3.75,3,6,3,5,3,0
1,0,0,1,1,1,2,5.33,1.5,12,0,4,0.67,0.67,1,3,1,3,2,0
1,0,0,1,1,1,2,6.2,2.5,38.77,0.01,6,0.4,2.15,1,5,1,5,2,0
1,0,0,1,1,1,4,9.51,0.5,2.38,0,3,2,0.13,2,1,2,1,4,0
1,0,0,1,1,1,1,0,0,0,0,1,0,0,0,1,0,1,1,0
1,0,0,1,1,1,2,5.33,1.5,12,0,4,0.67,0.67,1,3,1,3,2,0
1,0,0,1,1,1,2,5.33,1.5,12,0,4,0.67,0.67,1,3,1,3,2,0
1,0,0,1,1,1,2,0,0,0,0,4,0,0,0,4,0,4,2,0
1,0,0,1,1,1,1,0,0,0,0,1,0,0,0,1,0,1,1,0
1,0,0,1,1,1,2,0,0,0,0,5,0,0,0,5,0,5,2,0
1,0,0,1,1,1,1,0,0,0,0,1,0,0,0,1,0,1,1,0
1,0,0,1,1,1,2,5.33,1.5,12,0,4,0.67,0.67,1,3,1,3,2,0
1,0,0,1,1,1,2,5.33,1.5,12,0,4,0.67,0.67,1,3,1,3,2,0
1,0,0,1,1,1,1,0,0,0,0,1,0,0,0,1,0,1,1,0
1,0,0,1,1,1,1,0,0,0,0,1,0,0,0,1,0,1,1,0
1,0,0,1,1,1,1,0,0,0,0,1,0,0,0,1,0,1,1,0
1,0,0,1,1,1,1,0,0,0,0,1,0,0,0,1,0,1,1,0
1,0,0,1,1,1,1,0,0,0,0,1,0,0,0,1,0,1,1,0
1,0,0,1,1,1,1,0,0,0,0,1,0,0,0,1,0,1,1,0
1,0,0,1,1,1,1,0,0,0,0,1,0,0,0,1,0,1,1,0
1,0,0,1,1,1,1,0,0,0,0,1,0,0,0,1,0,1,1,0
1,0,0,1,1,1,1,0,0,0,0,1,0,0,0,1,0,1,1,0
1,0,0,1,1,1,1,0,0,0,0,1,0,0,0,1,0,1,1,0
1,0,0,1,1,1,2,5.33,1.5,12,0,4,0.67,0.67,1,3,1,3,2,0
1,0,0,1,1,1,2,5.33,1.5,12,0,4,0.67,0.67,1,3,1,3,2,0
1,0,0,1,1,1,2,5.33,1.5,12,0,4,0.67,0.67,1,3,1,3,2,0
1,0,0,1,1,1,2,5.33,1.5,12,0,4,0.67,0.67,1,3,1,3,2,0
1,0,0,1,1,1,2,5.33,1.5,12,0,4,0.67,0.67,1,3,1,3,2,0
1,0,0,1,1,1,2,5.33,1.5,12,0,4,0.67,0.67,1,3,1,3,2,0
1,0,0,1,1,1,2,5.33,1.5,12,0,4,0.67,0.67,1,3,1,3,2,0
1,0,0,1,1,1,2,5.33,1.5,12,0,4,0.67,0.67,1,3,1,3,2,0
1,0,0,1,1,1,2,5.33,1.5,12,0,4,0.67,0.67,1,3,1,3,2,0
1,0,0,1,1,1,2,5.33,1.5,12,0,4,0.67,0.67,1,3,1,3,2,0
1,0,0,1,1,1,2,0,0,0,0,4,0,0,0,4,0,4,2,0
1,0,0,1,1,1,1,0,0,0,0,1,0,0,0,1,0,1,1,0
1,0,0,1,1,1,2,0,0,0,0,5,0,0,0,5,0,5,2,0
1,0,0,1,1,1,1,0,0,0,0,0,0,0,0,0,0,0,1,0
1,0,0,1,1,1,1,0,0,0,0,1,0,0,0,1,0,1,1,0
1,0,0,1,1,1,2,5.33,1.5,12,0,4,0.67,0.67,1,3,1,3,2,0
1,0,0,1,1,1,2,5.33,1.5,12,0,4,0.67,0.67,1,3,1,3,2,0
1,9,0,1,1,1,2,0,0,0,0,9,0,0,9,0,1,0,11,0
1,0,0,1,1,1,1,0,0,0,0,1,0,0,0,1,0,1,1,0
1,0,0,1,1,1,2,5.33,1.5,12,0,4,0.67,0.67,1,3,1,3,2,0
1,0,0,1,1,1,2,5.33,1.5,12,0,4,0.67,0.67,1,3,1,3,2,0
1,0,0,1,1,1,2,0,0,0,0,4,0,0,0,4,0,4,2,0
1,0,0,1,1,1,1,0,0,0,0,1,0,0,0,1,0,1,1,0
1,0,0,1,1,1,2,0,0,0,0,5,0,0,0,5,0,5,2,0
1,14,0,1,1,1,2,0,0,0,0,0,0,0,0,0,0,0,16,0
1,0,0,1,1,1,1,0,0,0,0,1,0,0,0,1,0,1,1,0
1,0,0,1,1,1,2,5.33,1.5,12,0,4,0.67,0.67,1,3,1,3,2,0
1,0,0,1,1,1,2,5.33,1.5,12,0,4,0.67,0.67,1,3,1,3,2,0
1,0,0,1,1,1,1,0,0,0,0,1,0,0,0,1,0,1,1,0
1,0,0,1,1,1,2,5.33,1.5,12,0,4,0.67,0.67,1,3,1,3,2,0
1,0,0,1,1,1,2,5.33,1.5,12,0,4,0.67,0.67,1,3,1,3,2,0
1,0,0,1,1,1,2,0,0,0,0,4,0,0,0,4,0,4,2,0
1,0,0,1,1,1,1,0,0,0,0,1,0,0,0,1,0,1,1,0
1,0,0,1,1,1,2,0,0,0,0,5,0,0,0,5,0,5,2,0
1,0,0,1,1,1,1,0,0,0,0,1,0,0,0,1,0,1,1,0
1,0,0,1,1,1,2,5.33,1.5,12,0,4,0.67,0.67,1,3,1,3,2,0
1,0,0,1,1,1,2,5.33,1.5,12,0,4,0.67,0.67,1,3,1,3,2,0
7,0,0,4,3,1,20,28.31,9.19,2389.35,0.09,53,0.11,132.74,21,32,16,14,20,1
13,1,0,7,5,7,32,30.33,15.86,7626.84,0.16,91,0.06,423.71,37,54,21,18,33,1
1,0,0,1,1,1,1,0,0,0,0,1,0,0,0,1,0,1,1,0
1,0,0,1,1,1,2,5.33,1.5,12,0,4,0.67,0.67,1,3,1,3,2,0
1,0,0,1,1,1,2,5.33,1.5,12,0,4,0.67,0.67,1,3,1,3,2,0
1,0,0,1,1,1,1,0,0,0,0,0,0,0,0,0,0,0,1,0
1,0,0,1,1,1,1,0,0,0,0,0,0,0,0,0,0,0,1,0
1,0,0,1,1,1,1,0,0,0,0,1,0,0,0,1,0,1,1,0
1,0,0,1,1,1,4,18.49,2.4,106.51,0.01,14,0.42,5.92,6,8,5,4,4,0
1,0,0,1,1,1,2,5.33,1.5,12,0,4,0.67,0.67,1,3,1,3,2,0
1,0,0,1,1,1,5,8.45,0.75,4.75,0,4,1.33,0.26,3,1,2,1,5,0
1,0,0,1,1,1,1,0,0,0,0,0,0,0,0,0,0,0,1,0
1,0,0,1,1,1,1,0,0,0,0,1,0,0,0,1,0,1,1,0
1,0,0,1,1,1,3,10.8,2.5,67.5,0.01,9,0.4,3.75,3,6,3,5,3,0
1,0,0,1,1,1,2,5.33,1.5,12,0,4,0.67,0.67,1,3,1,3,2,0
1,0,0,1,1,1,2,6.2,2.5,38.77,0.01,6,0.4,2.15,1,5,1,5,2,0
1,0,0,1,1,1,4,9.51,0.5,2.38,0,3,2,0.13,2,1,2,1,4,0
1,0,0,1,1,1,1,0,0,0,0,1,0,0,0,1,0,1,1,0
1,0,0,1,1,1,2,5.33,1.5,12,0,4,0.67,0.67,1,3,1,3,2,0
1,0,0,1,1,1,2,5.33,1.5,12,0,4,0.67,0.67,1,3,1,3,2,0
1,0,0,1,1,1,2,0,0,0,0,4,0,0,0,4,0,4,2,0
1,0,0,1,1,1,1,0,0,0,0,1,0,0,0,1,0,1,1,0
1,0,0,1,1,1,2,0,0,0,0,5,0,0,0,5,0,5,2,0
1,0,0,1,1,1,1,0,0,0,0,1,0,0,0,1,0,1,1,0
1,0,0,1,1,1,2,5.33,1.5,12,0,4,0.67,0.67,1,3,1,3,2,0
1,0,0,1,1,1,2,5.33,1.5,12,0,4,0.67,0.67,1,3,1,3,2,0
1,0,0,1,1,1,1,0,0,0,0,1,0,0,0,1,0,1,1,0
1,0,0,1,1,1,1,0,0,0,0,1,0,0,0,1,0,1,1,0
1,0,0,1,1,1,1,0,0,0,0,1,0,0,0,1,0,1,1,0
1,0,0,1,1,1,1,0,0,0,0,1,0,0,0,1,0,1,1,0
1,0,0,1,1,1,1,0,0,0,0,1,0,0,0,1,0,1,1,0
1,0,0,1,1,1,2,5.33,1.5,12,0,4,0.67,0.67,1,3,1,3,2,0
1,0,0,1,1,1,2,5.33,1.5,12,0,4,0.67,0.67,1,3,1,3,2,0
1,0,0,1,1,1,2,0,0,0,0,4,0,0,0,4,0,4,2,0
1,0,0,1,1,1,1,0,0,0,0,1,0,0,0,1,0,1,1,0
1,0,0,1,1,1,2,0,0,0,0,5,0,0,0,5,0,5,2,0
3,1,0,2,2,1,13,21.1,7.65,1234.87,0.05,38,0.13,68.6,17,21,10,9,14,1
3,1,0,2,2,1,13,21.1,7.65,1234.87,0.05,38,0.13,68.6,17,21,10,9,14,1
3,1,0,2,2,1,13,21.1,7.65,1234.87,0.05,38,0.13,68.6,17,21,10,9,14,1
3,1,0,2,2,1,13,21.1,7.65,1234.87,0.05,38,0.13,68.6,17,21,10,9,14,1
3,1,0,2,2,1,13,21.1,7.65,1234.87,0.05,38,0.13,68.6,17,21,10,9,14,0
3,1,0,2,2,1,13,21.1,7.65,1234.87,0.05,38,0.13,68.6,17,21,10,9,14,1
13,6,6,8,8,1,57,28.4,29.22,24245.57,0.28,152,0.03,1346.98,64,88,23,21,63,0
1,0,0,1,1,1,1,0,0,0,0,1,0,0,0,1,0,1,1,0
1,0,0,1,1,1,2,5.33,1.5,12,0,4,0.67,0.67,1,3,1,3,2,0
1,0,0,1,1,1,2,5.33,1.5,12,0,4,0.67,0.67,1,3,1,3,2,0
1,0,0,1,1,1,2,0,0,0,0,4,0,0,0,4,0,4,2,0
1,0,0,1,1,1,1,0,0,0,0,1,0,0,0,1,0,1,1,0
1,0,0,1,1,1,2,0,0,0,0,5,0,0,0,5,0,5,2,0
1,0,0,1,1,1,1,0,0,0,0,1,0,0,0,1,0,1,1,0
1,0,0,1,1,1,2,5.33,1.5,12,0,4,0.67,0.67,1,3,1,3,2,0
1,0,0,1,1,1,2,5.33,1.5,12,0,4,0.67,0.67,1,3,1,3,2,0
1,0,0,1,1,1,1,0,0,0,0,1,0,0,0,1,0,1,1,0
1,0,0,1,1,1,1,0,0,0,0,1,0,0,0,1,0,1,1,0
1,0,0,1,1,1,1,0,0,0,0,1,0,0,0,1,0,1,1,0
1,0,0,1,1,1,1,0,0,0,0,1,0,0,0,1,0,1,1,0
1,0,0,1,1,1,1,0,0,0,0,1,0,0,0,1,0,1,1,0
1,0,0,1,1,1,1,0,0,0,0,1,0,0,0,1,0,1,1,0
1,0,0,1,1,1,1,0,0,0,0,1,0,0,0,1,0,1,1,0
1,0,0,1,1,1,1,0,0,0,0,1,0,0,0,1,0,1,1,0
1,0,0,1,1,1,2,5.33,1.5,12,0,4,0.67,0.67,1,3,1,3,2,0
1,0,0,1,1,1,2,5.33,1.5,12,0,4,0.67,0.67,1,3,1,3,2,0
1,0,0,1,1,1,2,5.33,1.5,12,0,4,0.67,0.67,1,3,1,3,2,0
1,0,0,1,1,1,2,5.33,1.5,12,0,4,0.67,0.67,1,3,1,3,2,0
1,0,0,1,1,1,2,5.33,1.5,12,0,4,0.67,0.67,1,3,1,3,2,0
1,0,0,1,1,1,2,5.33,1.5,12,0,4,0.67,0.67,1,3,1,3,2,0
1,0,0,1,1,1,2,5.33,1.5,12,0,4,0.67,0.67,1,3,1,3,2,0
1,0,0,1,1,1,2,5.33,1.5,12,0,4,0.67,0.67,1,3,1,3,2,0
1,0,0,1,1,1,2,5.33,1.5,12,0,4,0.67,0.67,1,3,1,3,2,0
1,0,0,1,1,1,2,5.33,1.5,12,0,4,0.67,0.67,1,3,1,3,2,0
1,0,0,1,1,1,2,0,0,0,0,4,0,0,0,4,0,4,2,0
1,0,0,1,1,1,1,0,0,0,0,1,0,0,0,1,0,1,1,0
1,0,0,1,1,1,2,0,0,0,0,5,0,0,0,5,0,5,2,0
5,0,3,3,3,1,17,17.05,11.33,2190.3,0.06,44,0.09,121.68,17,27,9,12,17,1
1,0,0,1,1,1,1,0,0,0,0,0,0,0,0,0,0,0,1,0
1,0,0,1,1,1,1,0,0,0,0,1,0,0,0,1,0,1,1,0
1,0,0,1,1,1,2,5.33,1.5,12,0,4,0.67,0.67,1,3,1,3,2,0
1,0,0,1,1,1,2,5.33,1.5,12,0,4,0.67,0.67,1,3,1,3,2,0
1,9,0,1,1,1,2,0,0,0,0,9,0,0,9,0,1,0,11,0
1,0,0,1,1,1,1,0,0,0,0,1,0,0,0,1,0,1,1,0
1,0,0,1,1,1,2,5.33,1.5,12,0,4,0.67,0.67,1,3,1,3,2,0
1,0,0,1,1,1,2,5.33,1.5,12,0,4,0.67,0.67,1,3,1,3,2,0
1,0,0,1,1,1,2,0,0,0,0,4,0,0,0,4,0,4,2,0
1,0,0,1,1,1,1,0,0,0,0,1,0,0,0,1,0,1,1,0
1,0,0,1,1,1,2,0,0,0,0,5,0,0,0,5,0,5,2,0
1,14,0,1,1,1,2,0,0,0,0,0,0,0,0,0,0,0,16,0
1,0,0,1,1,1,1,0,0,0,0,1,0,0,0,1,0,1,1,0
1,0,0,1,1,1,2,5.33,1.5,12,0,4,0.67,0.67,1,3,1,3,2,0
1,0,0,1,1,1,2,5.33,1.5,12,0,4,0.67,0.67,1,3,1,3,2,0
1,0,0,1,1,1,1,0,0,0,0,1,0,0,0,1,0,1,1,0
1,0,0,1,1,1,2,5.33,1.5,12,0,4,0.67,0.67,1,3,1,3,2,0
1,0,0,1,1,1,2,5.33,1.5,12,0,4,0.67,0.67,1,3,1,3,2,0
1,0,0,1,1,1,2,0,0,0,0,4,0,0,0,4,0,4,2,0
1,0,0,1,1,1,1,0,0,0,0,1,0,0,0,1,0,1,1,0
1,0,0,1,1,1,2,0,0,0,0,5,0,0,0,5,0,5,2,0
1,0,0,1,1,1,1,0,0,0,0,1,0,0,0,1,0,1,1,0
1,0,0,1,1,1,2,5.33,1.5,12,0,4,0.67,0.67,1,3,1,3,2,0
1,0,0,1,1,1,2,5.33,1.5,12,0,4,0.67,0.67,1,3,1,3,2,0
1,0,0,1,1,1,1,0,0,0,0,1,0,0,0,1,0,1,1,0
1,0,0,1,1,1,2,5.33,1.5,12,0,4,0.67,0.67,1,3,1,3,2,0
1,0,0,1,1,1,2,5.33,1.5,12,0,4,0.67,0.67,1,3,1,3,2,0
15,1,0,8,7,1,82,101.9,17.56,31435.36,0.6,293,0.06,1746.41,138,155,55,14,83,1
1,0,0,1,1,1,1,0,0,0,0,0,0,0,0,0,0,0,1,0
1,0,0,1,1,1,1,0,0,0,0,0,0,0,0,0,0,0,1,0
1,0,0,1,1,1,1,0,0,0,0,1,0,0,0,1,0,1,1,0
1,0,0,1,1,1,4,18.49,2.4,106.51,0.01,14,0.42,5.92,6,8,5,4,4,0
1,0,0,1,1,1,2,5.33,1.5,12,0,4,0.67,0.67,1,3,1,3,2,0
1,0,0,1,1,1,5,8.45,0.75,4.75,0,4,1.33,0.26,3,1,2,1,5,0
5,0,0,3,3,1,18,22.43,10.08,2280.63,0.08,50,0.1,126.7,22,28,12,11,18,1
1,0,0,1,1,1,1,0,0,0,0,0,0,0,0,0,0,0,1,0
1,0,0,1,1,1,1,0,0,0,0,1,0,0,0,1,0,1,1,0
1,0,0,1,1,1,3,10.8,2.5,67.5,0.01,9,0.4,3.75,3,6,3,5,3,0
1,0,0,1,1,1,2,5.33,1.5,12,0,4,0.67,0.67,1,3,1,3,2,0
1,0,0,1,1,1,2,6.2,2.5,38.77,0.01,6,0.4,2.15,1,5,1,5,2,0
1,0,0,1,1,1,4,9.51,0.5,2.38,0,3,2,0.13,2,1,2,1,4,0
1,0,0,1,1,1,1,0,0,0,0,1,0,0,0,1,0,1,1,0
1,0,0,1,1,1,2,5.33,1.5,12,0,4,0.67,0.67,1,3,1,3,2,0
1,0,0,1,1,1,2,5.33,1.5,12,0,4,0.67,0.67,1,3,1,3,2,0
1,0,0,1,1,1,2,0,0,0,0,4,0,0,0,4,0,4,2,0
1,0,0,1,1,1,1,0,0,0,0,1,0,0,0,1,0,1,1,0
1,0,0,1,1,1,2,0,0,0,0,5,0,0,0,5,0,5,2,0
1,0,0,1,1,1,1,0,0,0,0,1,0,0,0,1,0,1,1,0
1,0,0,1,1,1,2,5.33,1.5,12,0,4,0.67,0.67,1,3,1,3,2,0
1,0,0,1,1,1,2,5.33,1.5,12,0,4,0.67,0.67,1,3,1,3,2,0
1,0,0,1,1,1,1,0,0,0,0,1,0,0,0,1,0,1,1,0
15,3,2,1,1,1,77,54.45,21.29,24686.12,0.39,215,0.05,1371.45,95,120,29,13,80,1
1,0,0,1,1,1,1,0,0,0,0,1,0,0,0,1,0,1,1,0
1,0,0,1,1,1,1,0,0,0,0,1,0,0,0,1,0,1,1,0
1,0,0,1,1,1,1,0,0,0,0,1,0,0,0,1,0,1,1,0
1,0,0,1,1,1,1,0,0,0,0,1,0,0,0,1,0,1,1,0
1,0,0,1,1,1,1,0,0,0,0,1,0,0,0,1,0,1,1,0
1,0,0,1,1,1,1,0,0,0,0,1,0,0,0,1,0,1,1,0
1,0,0,1,1,1,1,0,0,0,0,1,0,0,0,1,0,1,1,0
1,0,0,1,1,1,1,0,0,0,0,1,0,0,0,1,0,1,1,0
1,0,0,1,1,1,1,0,0,0,0,1,0,0,0,1,0,1,1,0
1,0,0,1,1,1,2,5.33,1.5,12,0,4,0.67,0.67,1,3,1,3,2,0
1,0,0,1,1,1,2,5.33,1.5,12,0,4,0.67,0.67,1,3,1,3,2,0
1,0,0,1,1,1,2,5.33,1.5,12,0,4,0.67,0.67,1,3,1,3,2,0
1,0,0,1,1,1,2,5.33,1.5,12,0,4,0.67,0.67,1,3,1,3,2,0
1,0,0,1,1,1,2,5.33,1.5,12,0,4,0.67,0.67,1,3,1,3,2,0
1,0,0,1,1,1,2,5.33,1.5,12,0,4,0.67,0.67,1,3,1,3,2,0
1,0,0,1,1,1,2,5.33,1.5,12,0,4,0.67,0.67,1,3,1,3,2,0
1,0,0,1,1,1,2,5.33,1.5,12,0,4,0.67,0.67,1,3,1,3,2,0
1,0,0,1,1,1,2,5.33,1.5,12,0,4,0.67,0.67,1,3,1,3,2,0
1,0,0,1,1,1,2,5.33,1.5,12,0,4,0.67,0.67,1,3,1,3,2,0
1,0,0,1,1,1,2,0,0,0,0,4,0,0,0,4,0,4,2,0
1,0,0,1,1,1,1,0,0,0,0,1,0,0,0,1,0,1,1,0
1,0,0,1,1,1,2,0,0,0,0,5,0,0,0,5,0,5,2,0
1,0,0,1,1,1,2,20.97,3,188.72,0.02,17,0.33,10.48,7,10,7,6,2,0
1,0,0,1,1,1,2,20.97,3,188.72,0.02,17,0.33,10.48,7,10,7,6,2,0
1,0,0,1,1,1,2,27.35,3,246.13,0.03,21,0.33,13.67,9,12,9,6,2,0
1,0,0,1,1,1,3,30.67,3,276,0.03,23,0.33,15.33,10,13,10,6,3,0
1,0,0,1,1,1,3,30.67,3,276,0.03,23,0.33,15.33,10,13,10,6,3,0
1,0,0,1,1,1,3,30.67,3,276,0.03,23,0.33,15.33,10,13,10,6,3,0
1,0,0,1,1,1,2,27.35,3,246.13,0.03,21,0.33,13.67,9,12,9,6,2,0
1,0,0,1,1,1,3,27.35,3,246.13,0.03,21,0.33,13.67,9,12,9,6,3,0
1,0,0,1,1,1,2,20.97,3,188.72,0.02,17,0.33,10.48,7,10,7,6,2,0
1,0,0,1,1,1,2,20.97,3,188.72,0.02,17,0.33,10.48,7,10,7,6,2,0
1,0,0,1,1,1,2,20.97,3,188.72,0.02,17,0.33,10.48,7,10,7,6,2,0
1,0,0,1,1,1,2,17.92,3,161.32,0.02,15,0.33,8.96,6,9,6,6,2,0
1,0,0,1,1,1,2,17.92,3,161.32,0.02,15,0.33,8.96,6,9,6,6,2,0
1,0,0,1,1,1,2,14.99,3,134.92,0.01,13,0.33,7.5,5,8,5,6,2,0
1,0,0,1,1,1,2,14.99,3,134.92,0.01,13,0.33,7.5,5,8,5,6,2,0
1,0,0,1,1,1,2,14.99,3,134.92,0.01,13,0.33,7.5,5,8,5,6,2,0
1,0,0,1,1,1,2,14.99,3,134.92,0.01,13,0.33,7.5,5,8,5,6,2,0
1,0,0,1,1,1,2,14.99,3,134.92,0.01,13,0.33,7.5,5,8,5,6,2,0
1,0,0,1,1,1,2,17.92,3,161.32,0.02,15,0.33,8.96,6,9,6,6,2,0
1,0,0,1,1,1,2,17.92,3,161.32,0.02,15,0.33,8.96,6,9,6,6,2,0
1,2,0,1,1,1,1,16.84,1.5,37.9,0.01,9,0.67,2.11,4,5,4,3,3,0
1,0,0,1,1,1,2,5.33,1.5,12,0,4,0.67,0.67,1,3,1,3,2,0
1,0,0,1,1,1,2,20.97,3,188.72,0.02,17,0.33,10.48,7,10,7,6,2,0
1,0,0,1,1,1,2,20.97,3,188.72,0.02,17,0.33,10.48,7,10,7,6,2,0
11,2,0,6,6,1,47,43.8,17.37,13214.9,0.25,142,0.06,734.16,67,75,27,14,49,1
9,0,0,5,4,1,43,32.06,21.12,14294.47,0.23,124,0.05,794.14,61,63,26,18,43,1
25,8,0,13,13,1,86,64.05,27.63,48905.89,0.59,309,0.04,2716.99,140,169,38,15,94,1
9,1,0,5,5,1,45,36.2,18.57,12476.19,0.22,129,0.05,693.12,61,68,23,14,46,1
11,4,3,6,6,1,45,32.46,23.4,17776.44,0.25,140,0.04,987.58,65,75,25,18,49,1
9,1,2,5,5,1,44,35.3,20.6,14975.86,0.24,134,0.05,831.99,63,71,26,17,45,1
3,0,1,2,2,1,13,17.41,7,852.85,0.04,32,0.14,47.38,14,18,7,7,13,1
9,1,0,5,5,1,44,36.2,18.57,12476.19,0.22,129,0.05,693.12,61,68,23,14,45,1
9,1,0,5,5,1,44,37.76,17.79,11951.28,0.22,128,0.06,663.96,61,67,24,14,45,1
1,0,0,1,1,1,1,0,0,0,0,0,0,0,0,0,0,0,1,0
1,0,0,1,1,1,1,0,0,0,0,1,0,0,0,1,0,1,1,0
1,0,0,1,1,1,2,5.33,1.5,12,0,4,0.67,0.67,1,3,1,3,2,0
1,0,0,1,1,1,2,5.33,1.5,12,0,4,0.67,0.67,1,3,1,3,2,0
1,9,0,1,1,1,2,0,0,0,0,9,0,0,9,0,1,0,11,0
1,0,0,1,1,1,1,0,0,0,0,1,0,0,0,1,0,1,1,0
1,0,0,1,1,1,2,5.33,1.5,12,0,4,0.67,0.67,1,3,1,3,2,0
1,0,0,1,1,1,2,5.33,1.5,12,0,4,0.67,0.67,1,3,1,3,2,0
1,0,0,1,1,1,2,0,0,0,0,4,0,0,0,4,0,4,2,0
1,0,0,1,1,1,1,0,0,0,0,1,0,0,0,1,0,1,1,0
1,0,0,1,1,1,2,0,0,0,0,5,0,0,0,5,0,5,2,0
1,0,0,1,1,1,1,0,0,0,0,1,0,0,0,1,0,1,1,0
1,0,0,1,1,1,2,5.33,1.5,12,0,4,0.67,0.67,1,3,1,3,2,0
1,0,0,1,1,1,2,5.33,1.5,12,0,4,0.67,0.67,1,3,1,3,2,0
1,14,0,1,1,1,2,0,0,0,0,0,0,0,0,0,0,0,16,0
1,0,0,1,1,1,1,0,0,0,0,1,0,0,0,1,0,1,1,0
1,0,0,1,1,1,2,5.33,1.5,12,0,4,0.67,0.67,1,3,1,3,2,0
1,0,0,1,1,1,2,5.33,1.5,12,0,4,0.67,0.67,1,3,1,3,2,0
1,0,0,1,1,1,1,0,0,0,0,1,0,0,0,1,0,1,1,0
1,0,0,1,1,1,2,5.33,1.5,12,0,4,0.67,0.67,1,3,1,3,2,0
1,0,0,1,1,1,2,5.33,1.5,12,0,4,0.67,0.67,1,3,1,3,2,0
1,0,0,1,1,1,2,0,0,0,0,4,0,0,0,4,0,4,2,0
1,0,0,1,1,1,1,0,0,0,0,1,0,0,0,1,0,1,1,0
1,0,0,1,1,1,2,0,0,0,0,5,0,0,0,5,0,5,2,0
9,1,0,5,5,1,44,36.2,18.57,12476.19,0.22,129,0.05,693.12,61,68,23,14,45,1
9,1,0,5,5,1,45,36.2,18.57,12476.19,0.22,129,0.05,693.12,61,68,23,14,46,1
11,1,0,6,6,1,56,43.81,19.44,16563.75,0.28,159,0.05,920.21,75,84,27,14,57,1
1,0,0,1,1,1,1,0,0,0,0,1,0,0,0,1,0,1,1,0
1,0,0,1,1,1,2,5.33,1.5,12,0,4,0.67,0.67,1,3,1,3,2,0
1,0,0,1,1,1,2,5.33,1.5,12,0,4,0.67,0.67,1,3,1,3,2,0
1,0,0,1,1,1,1,0,0,0,0,1,0,0,0,1,0,1,1,0
1,0,0,1,1,1,2,5.33,1.5,12,0,4,0.67,0.67,1,3,1,3,2,0
1,0,0,1,1,1,2,5.33,1.5,12,0,4,0.67,0.67,1,3,1,3,2,0
3,180,77,2,2,1,240,239.57,61.05,892966.69,4.88,2276,0.02,49609.26,928,1348,76,10,420,1
3,0,1,2,2,1,13,17.41,7,852.85,0.04,32,0.14,47.38,14,18,7,7,13,1
9,1,0,5,5,1,43,38.45,16.67,10689.16,0.21,124,0.06,593.84,59,65,23,13,44,1
3,0,1,2,2,1,13,17.41,7,852.85,0.04,32,0.14,47.38,14,18,7,7,13,1
1,0,0,1,1,1,1,0,0,0,0,0,0,0,0,0,0,0,1,0
1,0,0,1,1,1,1,0,0,0,0,0,0,0,0,0,0,0,1,0
3,0,1,2,2,1,13,17.41,7,852.85,0.04,32,0.14,47.38,14,18,7,7,13,1
13,3,0,7,7,1,50,48.04,17.62,14915.87,0.28,156,0.06,828.66,73,83,29,14,53,1
9,1,0,5,5,1,43,41.32,15.39,9789.35,0.21,124,0.06,543.85,59,65,23,12,44,1
5,0,0,3,3,1,24,27.38,11.08,3358.98,0.1,68,0.09,186.61,32,36,13,9,24,1
11,2,0,6,6,1,47,43.8,17.37,13214.9,0.25,142,0.06,734.16,67,75,27,14,49,1
3,0,1,2,2,1,13,17.41,7,852.85,0.04,32,0.14,47.38,14,18,7,7,13,1
9,1,0,5,5,1,44,36.2,18.57,12476.19,0.22,129,0.05,693.12,61,68,23,14,45,1
9,1,0,5,5,1,44,36.2,18.57,12476.19,0.22,129,0.05,693.12,61,68,23,14,45,1
3,0,1,2,2,1,13,17.41,7,852.85,0.04,32,0.14,47.38,14,18,7,7,13,1
5,0,0,3,3,1,24,27.38,11.08,3358.98,0.1,68,0.09,186.61,32,36,13,9,24,1
3,1,1,2,2,1,12,17.41,7,852.85,0.04,32,0.14,47.38,14,18,7,7,13,1
9,3,0,5,5,1,43,40.64,16.79,11459.28,0.23,131,0.06,636.63,62,69,24,13,46,1
9,3,0,5,5,1,41,40.43,15.98,10322.1,0.22,124,0.06,573.45,59,65,24,13,44,1
9,1,0,5,5,1,44,33.73,21.42,15477.46,0.24,134,0.05,859.86,63,71,25,17,45,1
5,0,0,3,3,1,24,24.99,11.25,3162.47,0.09,64,0.09,175.69,30,34,12,9,24,1
9,2,0,5,5,1,44,39.61,17.08,11555.16,0.23,128,0.06,641.95,61,67,25,14,46,1
9,1,0,5,5,1,43,41.32,15.39,9789.35,0.21,124,0.06,543.85,59,65,23,12,44,1
9,2,1,5,5,1,47,38.12,17.21,11288.51,0.22,125,0.06,627.14,59,66,24,14,49,1
1,0,0,1,1,1,1,0,0,0,0,1,0,0,0,1,0,1,1,0
1,0,0,1,1,1,4,18.49,2.4,106.51,0.01,14,0.42,5.92,6,8,5,4,4,0
1,0,0,1,1,1,2,5.33,1.5,12,0,4,0.67,0.67,1,3,1,3,2,0
1,0,0,1,1,1,5,8.45,0.75,4.75,0,4,1.33,0.26,3,1,2,1,5,0
1,0,0,1,1,1,1,0,0,0,0,0,0,0,0,0,0,0,1,0
1,0,0,1,1,1,1,0,0,0,0,1,0,0,0,1,0,1,1,0
1,0,0,1,1,1,3,10.8,2.5,67.5,0.01,9,0.4,3.75,3,6,3,5,3,0
1,0,0,1,1,1,2,5.33,1.5,12,0,4,0.67,0.67,1,3,1,3,2,0
1,0,0,1,1,1,2,6.2,2.5,38.77,0.01,6,0.4,2.15,1,5,1,5,2,0
1,0,0,1,1,1,4,9.51,0.5,2.38,0,3,2,0.13,2,1,2,1,4,0
1,0,0,1,1,1,1,0,0,0,0,1,0,0,0,1,0,1,1,0
1,0,0,1,1,1,2,5.33,1.5,12,0,4,0.67,0.67,1,3,1,3,2,0
1,0,0,1,1,1,2,5.33,1.5,12,0,4,0.67,0.67,1,3,1,3,2,0
1,0,0,1,1,1,2,0,0,0,0,4,0,0,0,4,0,4,2,0
1,0,0,1,1,1,1,0,0,0,0,1,0,0,0,1,0,1,1,0
1,0,0,1,1,1,2,0,0,0,0,5,0,0,0,5,0,5,2,0
1,0,0,1,1,1,1,0,0,0,0,1,0,0,0,1,0,1,1,0
1,0,0,1,1,1,2,5.33,1.5,12,0,4,0.67,0.67,1,3,1,3,2,0
1,0,0,1,1,1,2,5.33,1.5,12,0,4,0.67,0.67,1,3,1,3,2,0
1,0,0,1,1,1,1,0,0,0,0,1,0,0,0,1,0,1,1,0
1,0,0,1,1,1,1,0,0,0,0,1,0,0,0,1,0,1,1,0
1,0,0,1,1,1,1,0,0,0,0,1,0,0,0,1,0,1,1,0
11,11,0,6,5,1,17,20.21,13,3415.2,0.09,69,0.08,189.73,26,43,7,7,28,1
1,0,0,1,1,1,1,0,0,0,0,1,0,0,0,1,0,1,1,0
1,0,0,1,1,1,1,0,0,0,0,1,0,0,0,1,0,1,1,0
1,0,0,1,1,1,1,0,0,0,0,1,0,0,0,1,0,1,1,0
1,0,0,1,1,1,1,0,0,0,0,1,0,0,0,1,0,1,1,0
1,0,0,1,1,1,1,0,0,0,0,1,0,0,0,1,0,1,1,0
1,0,0,1,1,1,2,5.33,1.5,12,0,4,0.67,0.67,1,3,1,3,2,0
1,0,0,1,1,1,2,5.33,1.5,12,0,4,0.67,0.67,1,3,1,3,2,0
1,0,0,1,1,1,2,5.33,1.5,12,0,4,0.67,0.67,1,3,1,3,2,0
1,0,0,1,1,1,2,5.33,1.5,12,0,4,0.67,0.67,1,3,1,3,2,0
1,0,0,1,1,1,2,5.33,1.5,12,0,4,0.67,0.67,1,3,1,3,2,0
1,0,0,1,1,1,2,5.33,1.5,12,0,4,0.67,0.67,1,3,1,3,2,0
1,0,0,1,1,1,2,5.33,1.5,12,0,4,0.67,0.67,1,3,1,3,2,0
1,0,0,1,1,1,1,0,0,0,0,0,0,0,0,0,0,0,1,0
1,0,0,1,1,1,1,0,0,0,0,1,0,0,0,1,0,1,1,0
1,0,0,1,1,1,2,5.33,1.5,12,0,4,0.67,0.67,1,3,1,3,2,0
1,0,0,1,1,1,2,5.33,1.5,12,0,4,0.67,0.67,1,3,1,3,2,0
1,9,0,1,1,1,2,0,0,0,0,9,0,0,9,0,1,0,11,0
7,8,1,4,4,1,33,32.53,24.37,19317.04,0.26,147,0.04,1073.17,59,88,23,19,41,1
1,0,0,1,1,1,1,0,0,0,0,1,0,0,0,1,0,1,1,0
1,0,0,1,1,1,2,5.33,1.5,12,0,4,0.67,0.67,1,3,1,3,2,0
1,15,0,1,1,1,2,0,0,0,0,0,0,0,0,0,0,0,17,0
1,0,0,1,1,1,1,0,0,0,0,0,0,0,0,0,0,0,1,0
1,0,0,1,1,1,1,0,0,0,0,0,0,0,0,0,0,0,1,0
1,0,0,1,1,1,1,0,0,0,0,1,0,0,0,1,0,1,1,0
1,0,0,1,1,1,4,18.49,2.4,106.51,0.01,14,0.42,5.92,6,8,5,4,4,0
1,0,0,1,1,1,2,5.33,1.5,12,0,4,0.67,0.67,1,3,1,3,2,0
1,0,0,1,1,1,5,8.45,0.75,4.75,0,4,1.33,0.26,3,1,2,1,5,0
1,0,0,1,1,1,1,0,0,0,0,0,0,0,0,0,0,0,1,0
1,0,0,1,1,1,1,0,0,0,0,1,0,0,0,1,0,1,1,0
1,0,0,1,1,1,3,10.8,2.5,67.5,0.01,9,0.4,3.75,3,6,3,5,3,0
1,0,0,1,1,1,2,5.33,1.5,12,0,4,0.67,0.67,1,3,1,3,2,0
1,0,0,1,1,1,2,6.2,2.5,38.77,0.01,6,0.4,2.15,1,5,1,5,2,0
1,0,0,1,1,1,4,9.51,0.5,2.38,0,3,2,0.13,2,1,2,1,4,0
1,0,0,1,1,1,1,0,0,0,0,1,0,0,0,1,0,1,1,0
1,0,0,1,1,1,1,0,0,0,0,1,0,0,0,1,0,1,1,0
1,0,0,1,1,1,1,0,0,0,0,1,0,0,0,1,0,1,1,0
1,0,0,1,1,1,1,0,0,0,0,1,0,0,0,1,0,1,1,0
1,0,0,1,1,1,1,0,0,0,0,1,0,0,0,1,0,1,1,0
1,0,0,1,1,1,2,5.33,1.5,12,0,4,0.67,0.67,1,3,1,3,2,0
1,0,0,1,1,1,2,5.33,1.5,12,0,4,0.67,0.67,1,3,1,3,2,0
1,0,0,1,1,1,2,5.33,1.5,12,0,4,0.67,0.67,1,3,1,3,2,0
1,0,0,1,1,1,2,5.33,1.5,12,0,4,0.67,0.67,1,3,1,3,2,0
1,0,0,1,1,1,2,5.33,1.5,12,0,4,0.67,0.67,1,3,1,3,2,0
1,0,0,1,1,1,2,5.33,1.5,12,0,4,0.67,0.67,1,3,1,3,2,0
1,0,0,1,1,1,2,5.33,1.5,12,0,4,0.67,0.67,1,3,1,3,2,0
1,0,0,1,1,1,1,0,0,0,0,0,0,0,0,0,0,0,1,0
1,0,0,1,1,1,1,0,0,0,0,1,0,0,0,1,0,1,1,0
1,0,0,1,1,1,2,5.33,1.5,12,0,4,0.67,0.67,1,3,1,3,2,0
1,0,0,1,1,1,2,5.33,1.5,12,0,4,0.67,0.67,1,3,1,3,2,0
1,9,0,1,1,1,2,0,0,0,0,9,0,0,9,0,1,0,11,0
3,0,0,2,2,1,10,14.06,8.67,1055.91,0.04,32,0.12,58.66,13,19,6,8,10,0
9,2,0,5,5,1,25,25.39,19.13,9294.94,0.16,100,0.05,516.39,41,59,15,14,27,1
1,0,0,1,1,1,1,0,0,0,0,1,0,0,0,1,0,1,1,0
1,0,0,1,1,1,2,5.33,1.5,12,0,4,0.67,0.67,1,3,1,3,2,0
1,15,0,1,1,1,2,0,0,0,0,0,0,0,0,0,0,0,17,0
3,0,0,2,2,1,11,16,9,1296,0.05,36,0.11,72,14,22,7,9,11,0
3,0,0,2,2,1,11,16,9,1296,0.05,36,0.11,72,14,22,7,9,11,0
3,0,0,2,2,1,11,16,9,1296,0.05,36,0.11,72,14,22,7,9,11,0
3,0,0,2,2,1,11,16,9,1296,0.05,36,0.11,72,14,22,7,9,11,0
3,3,0,2,2,1,11,18.61,11.88,2624.45,0.07,53,0.08,145.8,19,34,8,10,14,1
1,0,0,1,1,1,1,0,0,0,0,0,0,0,0,0,0,0,1,0
1,0,0,1,1,1,1,0,0,0,0,0,0,0,0,0,0,0,1,0
1,0,0,1,1,1,1,0,0,0,0,1,0,0,0,1,0,1,1,0
1,0,0,1,1,1,4,18.49,2.4,106.51,0.01,14,0.42,5.92,6,8,5,4,4,0
1,0,0,1,1,1,2,5.33,1.5,12,0,4,0.67,0.67,1,3,1,3,2,0
1,0,0,1,1,1,5,8.45,0.75,4.75,0,4,1.33,0.26,3,1,2,1,5,0
1,0,0,1,1,1,1,0,0,0,0,0,0,0,0,0,0,0,1,0
1,0,0,1,1,1,1,0,0,0,0,1,0,0,0,1,0,1,1,0
1,0,0,1,1,1,3,10.8,2.5,67.5,0.01,9,0.4,3.75,3,6,3,5,3,0
1,0,0,1,1,1,2,5.33,1.5,12,0,4,0.67,0.67,1,3,1,3,2,0
1,0,0,1,1,1,2,6.2,2.5,38.77,0.01,6,0.4,2.15,1,5,1,5,2,0
1,0,0,1,1,1,4,9.51,0.5,2.38,0,3,2,0.13,2,1,2,1,4,0
1,0,0,1,1,1,1,0,0,0,0,1,0,0,0,1,0,1,1,0
1,0,0,1,1,1,1,0,0,0,0,1,0,0,0,1,0,1,1,0
1,0,0,1,1,1,1,0,0,0,0,1,0,0,0,1,0,1,1,0
1,0,0,1,1,1,1,0,0,0,0,1,0,0,0,1,0,1,1,0
1,0,0,1,1,1,1,0,0,0,0,1,0,0,0,1,0,1,1,0
1,0,0,1,1,1,2,5.33,1.5,12,0,4,0.67,0.67,1,3,1,3,2,0
1,0,0,1,1,1,2,5.33,1.5,12,0,4,0.67,0.67,1,3,1,3,2,0
1,0,0,1,1,1,2,5.33,1.5,12,0,4,0.67,0.67,1,3,1,3,2,0
1,0,0,1,1,1,2,5.33,1.5,12,0,4,0.67,0.67,1,3,1,3,2,0
1,0,0,1,1,1,2,5.33,1.5,12,0,4,0.67,0.67,1,3,1,3,2,0
1,0,0,1,1,1,2,5.33,1.5,12,0,4,0.67,0.67,1,3,1,3,2,0
1,0,0,1,1,1,2,5.33,1.5,12,0,4,0.67,0.67,1,3,1,3,2,0
1,0,0,1,1,1,1,0,0,0,0,0,0,0,0,0,0,0,1,0
1,0,0,1,1,1,2,8,3,72,0.01,8,0.33,4,2,6,2,6,2,0
1,0,0,1,1,1,2,8,3,72,0.01,8,0.33,4,2,6,2,6,2,0
1,0,0,1,1,1,2,8,3,72,0.01,8,0.33,4,2,6,2,6,2,0
1,0,0,1,1,1,2,8,3,72,0.01,8,0.33,4,2,6,2,6,2,0
1,0,0,1,1,1,2,8,3,72,0.01,8,0.33,4,2,6,2,6,2,0
1,0,0,1,1,1,2,8,3,72,0.01,8,0.33,4,2,6,2,6,2,0
1,0,0,1,1,1,2,8,3,72,0.01,8,0.33,4,2,6,2,6,2,0
1,0,0,1,1,1,2,8,3,72,0.01,8,0.33,4,2,6,2,6,2,0
1,0,0,1,1,1,2,8,3,72,0.01,8,0.33,4,2,6,2,6,2,0
1,0,0,1,1,1,2,8,3,72,0.01,8,0.33,4,2,6,2,6,2,0
1,0,0,1,1,1,1,0,0,0,0,1,0,0,0,1,0,1,1,0
1,0,0,1,1,1,2,5.33,1.5,12,0,4,0.67,0.67,1,3,1,3,2,0
1,0,0,1,1,1,2,5.33,1.5,12,0,4,0.67,0.67,1,3,1,3,2,0
1,9,0,1,1,1,2,0,0,0,0,9,0,0,9,0,1,0,11,0
1,0,0,1,1,1,2,8,3,72,0.01,8,0.33,4,2,6,2,6,2,0
1,0,0,1,1,1,2,8,3,72,0.01,8,0.33,4,2,6,2,6,2,0
1,0,0,1,1,1,3,21.46,5.5,649.15,0.04,31,0.18,36.06,11,20,7,7,3,0
1,0,0,1,1,1,3,21.46,5.5,649.15,0.04,31,0.18,36.06,11,20,7,7,3,0
1,0,0,1,1,1,3,21.46,5.5,649.15,0.04,31,0.18,36.06,11,20,7,7,3,0
1,0,0,1,1,1,3,21.46,5.5,649.15,0.04,31,0.18,36.06,11,20,7,7,3,0
1,0,0,1,1,1,3,21.46,5.5,649.15,0.04,31,0.18,36.06,11,20,7,7,3,0
1,0,0,1,1,1,3,21.46,5.5,649.15,0.04,31,0.18,36.06,11,20,7,7,3,0
1,0,0,1,1,1,2,8,3,72,0.01,8,0.33,4,2,6,2,6,2,0
1,0,0,1,1,1,2,8,3,72,0.01,8,0.33,4,2,6,2,6,2,0
1,0,0,1,1,1,1,0,0,0,0,1,0,0,0,1,0,1,1,0
1,0,0,1,1,1,2,5.33,1.5,12,0,4,0.67,0.67,1,3,1,3,2,0
1,15,0,1,1,1,2,0,0,0,0,0,0,0,0,0,0,0,17,0
1,0,0,1,1,1,1,0,0,0,0,0,0,0,0,0,0,0,1,0
1,0,0,1,1,1,1,0,0,0,0,0,0,0,0,0,0,0,1,0
1,0,0,1,1,1,1,0,0,0,0,1,0,0,0,1,0,1,1,0
1,0,0,1,1,1,4,18.49,2.4,106.51,0.01,14,0.42,5.92,6,8,5,4,4,0
1,0,0,1,1,1,2,5.33,1.5,12,0,4,0.67,0.67,1,3,1,3,2,0
1,0,0,1,1,1,5,8.45,0.75,4.75,0,4,1.33,0.26,3,1,2,1,5,0
1,0,0,1,1,1,1,0,0,0,0,0,0,0,0,0,0,0,1,0
1,0,0,1,1,1,1,0,0,0,0,1,0,0,0,1,0,1,1,0
1,0,0,1,1,1,3,10.8,2.5,67.5,0.01,9,0.4,3.75,3,6,3,5,3,0
1,0,0,1,1,1,2,5.33,1.5,12,0,4,0.67,0.67,1,3,1,3,2,0
1,0,0,1,1,1,2,6.2,2.5,38.77,0.01,6,0.4,2.15,1,5,1,5,2,0
1,0,0,1,1,1,4,9.51,0.5,2.38,0,3,2,0.13,2,1,2,1,4,0
1,0,0,1,1,1,1,0,0,0,0,1,0,0,0,1,0,1,1,0
1,0,0,1,1,1,1,0,0,0,0,1,0,0,0,1,0,1,1,0
1,0,0,1,1,1,1,0,0,0,0,1,0,0,0,1,0,1,1,0
1,0,0,1,1,1,1,0,0,0,0,1,0,0,0,1,0,1,1,0
1,0,0,1,1,1,1,0,0,0,0,1,0,0,0,1,0,1,1,0
1,0,0,1,1,1,2,5.33,1.5,12,0,4,0.67,0.67,1,3,1,3,2,0
1,0,0,1,1,1,2,5.33,1.5,12,0,4,0.67,0.67,1,3,1,3,2,0
1,0,0,1,1,1,2,5.33,1.5,12,0,4,0.67,0.67,1,3,1,3,2,0
1,0,0,1,1,1,2,5.33,1.5,12,0,4,0.67,0.67,1,3,1,3,2,0
1,0,0,1,1,1,2,5.33,1.5,12,0,4,0.67,0.67,1,3,1,3,2,0
1,0,0,1,1,1,2,5.33,1.5,12,0,4,0.67,0.67,1,3,1,3,2,0
1,0,0,1,1,1,2,5.33,1.5,12,0,4,0.67,0.67,1,3,1,3,2,0
1,0,0,1,1,1,1,0,0,0,0,0,0,0,0,0,0,0,1,0
1,0,0,1,1,1,1,0,0,0,0,1,0,0,0,1,0,1,1,0
1,0,0,1,1,1,2,5.33,1.5,12,0,4,0.67,0.67,1,3,1,3,2,0
1,0,0,1,1,1,2,5.33,1.5,12,0,4,0.67,0.67,1,3,1,3,2,0
1,9,0,1,1,1,2,0,0,0,0,9,0,0,9,0,1,0,11,0
11,17,5,6,3,6,37,71.47,10.29,7569.8,0.25,131,0.1,420.54,57,74,36,13,54,1
1,0,0,1,1,1,1,0,0,0,0,1,0,0,0,1,0,1,1,0
1,0,0,1,1,1,2,5.33,1.5,12,0,4,0.67,0.67,1,3,1,3,2,0
1,15,0,1,1,1,2,0,0,0,0,0,0,0,0,0,0,0,17,0
1,0,0,1,1,1,1,0,0,0,0,0,0,0,0,0,0,0,1,0
1,0,0,1,1,1,1,0,0,0,0,0,0,0,0,0,0,0,1,0
1,0,0,1,1,1,1,0,0,0,0,1,0,0,0,1,0,1,1,0
1,0,0,1,1,1,4,18.49,2.4,106.51,0.01,14,0.42,5.92,6,8,5,4,4,0
1,0,0,1,1,1,2,5.33,1.5,12,0,4,0.67,0.67,1,3,1,3,2,0
1,0,0,1,1,1,5,8.45,0.75,4.75,0,4,1.33,0.26,3,1,2,1,5,0
1,0,0,1,1,1,1,0,0,0,0,0,0,0,0,0,0,0,1,0
1,0,0,1,1,1,1,0,0,0,0,1,0,0,0,1,0,1,1,0
1,0,0,1,1,1,3,10.8,2.5,67.5,0.01,9,0.4,3.75,3,6,3,5,3,0
1,0,0,1,1,1,2,5.33,1.5,12,0,4,0.67,0.67,1,3,1,3,2,0
1,0,0,1,1,1,2,6.2,2.5,38.77,0.01,6,0.4,2.15,1,5,1,5,2,0
1,0,0,1,1,1,4,9.51,0.5,2.38,0,3,2,0.13,2,1,2,1,4,0
1,0,0,1,1,1,1,0,0,0,0,1,0,0,0,1,0,1,1,0
1,0,0,1,1,1,1,0,0,0,0,1,0,0,0,1,0,1,1,0
1,0,0,1,1,1,1,0,0,0,0,1,0,0,0,1,0,1,1,0
1,0,0,1,1,1,1,0,0,0,0,1,0,0,0,1,0,1,1,0
1,0,0,1,1,1,1,0,0,0,0,1,0,0,0,1,0,1,1,0
1,0,0,1,1,1,2,5.33,1.5,12,0,4,0.67,0.67,1,3,1,3,2,0
1,0,0,1,1,1,2,5.33,1.5,12,0,4,0.67,0.67,1,3,1,3,2,0
1,0,0,1,1,1,2,5.33,1.5,12,0,4,0.67,0.67,1,3,1,3,2,0
1,0,0,1,1,1,2,5.33,1.5,12,0,4,0.67,0.67,1,3,1,3,2,0
1,0,0,1,1,1,2,5.33,1.5,12,0,4,0.67,0.67,1,3,1,3,2,0
1,0,0,1,1,1,2,5.33,1.5,12,0,4,0.67,0.67,1,3,1,3,2,0
1,0,0,1,1,1,2,5.33,1.5,12,0,4,0.67,0.67,1,3,1,3,2,0
1,0,0,1,1,1,1,0,0,0,0,0,0,0,0,0,0,0,1,0
1,0,0,1,1,1,1,0,0,0,0,1,0,0,0,1,0,1,1,0
1,0,0,1,1,1,2,5.33,1.5,12,0,4,0.67,0.67,1,3,1,3,2,0
1,0,0,1,1,1,2,5.33,1.5,12,0,4,0.67,0.67,1,3,1,3,2,0
1,9,0,1,1,1,2,0,0,0,0,9,0,0,9,0,1,0,11,0
1,0,0,1,1,1,1,0,0,0,0,1,0,0,0,1,0,1,1,0
1,0,0,1,1,1,2,5.33,1.5,12,0,4,0.67,0.67,1,3,1,3,2,0
1,15,0,1,1,1,2,0,0,0,0,0,0,0,0,0,0,0,17,0
1,0,0,1,1,1,1,0,0,0,0,0,0,0,0,0,0,0,1,0
1,0,0,1,1,1,1,0,0,0,0,0,0,0,0,0,0,0,1,0
1,0,0,1,1,1,1,0,0,0,0,1,0,0,0,1,0,1,1,0
1,0,0,1,1,1,4,18.49,2.4,106.51,0.01,14,0.42,5.92,6,8,5,4,4,0
1,0,0,1,1,1,2,5.33,1.5,12,0,4,0.67,0.67,1,3,1,3,2,0
1,0,0,1,1,1,5,8.45,0.75,4.75,0,4,1.33,0.26,3,1,2,1,5,0
5,3,0,3,3,1,20,21.68,12.5,3388.06,0.09,65,0.08,188.23,25,40,9,9,23,0
5,3,0,3,3,1,20,23.79,11.25,3010.72,0.09,63,0.09,167.26,25,38,10,9,23,0
5,11,0,3,2,1,18,22.22,13,3755.08,0.1,63,0.08,208.62,26,37,12,12,29,0
5,11,0,3,2,1,18,22.22,13,3755.08,0.1,63,0.08,208.62,26,37,12,12,29,0
5,11,0,3,2,1,18,22.22,13,3755.08,0.1,63,0.08,208.62,26,37,12,12,29,0
5,11,0,3,2,1,18,22.22,13,3755.08,0.1,63,0.08,208.62,26,37,12,12,29,0
5,11,0,3,2,1,18,22.22,13,3755.08,0.1,63,0.08,208.62,26,37,12,12,29,0
5,11,0,3,2,1,18,26.58,11.14,3299.71,0.1,63,0.09,183.32,26,37,14,12,29,0
5,11,0,3,2,1,18,26.58,11.14,3299.71,0.1,63,0.09,183.32,26,37,14,12,29,0
5,11,0,3,2,1,18,26.58,11.14,3299.71,0.1,63,0.09,183.32,26,37,14,12,29,0
1,0,0,1,1,1,1,0,0,0,0,0,0,0,0,0,0,0,1,0
1,0,0,1,1,1,1,0,0,0,0,1,0,0,0,1,0,1,1,0
1,0,0,1,1,1,3,10.8,2.5,67.5,0.01,9,0.4,3.75,3,6,3,5,3,0
1,0,0,1,1,1,2,5.33,1.5,12,0,4,0.67,0.67,1,3,1,3,2,0
1,0,0,1,1,1,2,6.2,2.5,38.77,0.01,6,0.4,2.15,1,5,1,5,2,0
1,0,0,1,1,1,4,9.51,0.5,2.38,0,3,2,0.13,2,1,2,1,4,0
1,0,0,1,1,1,1,0,0,0,0,1,0,0,0,1,0,1,1,0
1,0,0,1,1,1,1,0,0,0,0,1,0,0,0,1,0,1,1,0
1,0,0,1,1,1,1,0,0,0,0,1,0,0,0,1,0,1,1,0
1,0,0,1,1,1,1,0,0,0,0,1,0,0,0,1,0,1,1,0
1,0,0,1,1,1,1,0,0,0,0,1,0,0,0,1,0,1,1,0
1,0,0,1,1,1,1,0,0,0,0,1,0,0,0,1,0,1,1,0
1,0,0,1,1,1,1,0,0,0,0,1,0,0,0,1,0,1,1,0
1,0,0,1,1,1,1,0,0,0,0,1,0,0,0,1,0,1,1,0
1,0,0,1,1,1,2,5.33,1.5,12,0,4,0.67,0.67,1,3,1,3,2,0
1,0,0,1,1,1,2,5.33,1.5,12,0,4,0.67,0.67,1,3,1,3,2,0
1,0,0,1,1,1,2,5.33,1.5,12,0,4,0.67,0.67,1,3,1,3,2,0
1,0,0,1,1,1,2,5.33,1.5,12,0,4,0.67,0.67,1,3,1,3,2,0
1,0,0,1,1,1,2,5.33,1.5,12,0,4,0.67,0.67,1,3,1,3,2,0
1,0,0,1,1,1,2,5.33,1.5,12,0,4,0.67,0.67,1,3,1,3,2,0
1,0,0,1,1,1,2,5.33,1.5,12,0,4,0.67,0.67,1,3,1,3,2,0
1,0,0,1,1,1,2,5.33,1.5,12,0,4,0.67,0.67,1,3,1,3,2,0
1,0,0,1,1,1,2,5.33,1.5,12,0,4,0.67,0.67,1,3,1,3,2,0
1,0,0,1,1,1,2,0,0,0,0,4,0,0,0,4,0,4,2,0
1,0,0,1,1,1,1,0,0,0,0,1,0,0,0,1,0,1,1,0
1,0,0,1,1,1,2,0,0,0,0,5,0,0,0,5,0,5,2,0
1,0,0,1,1,1,1,0,0,0,0,0,0,0,0,0,0,0,1,0
1,0,0,1,1,1,1,0,0,0,0,1,0,0,0,1,0,1,1,0
1,9,0,1,1,1,2,0,0,0,0,0,0,0,0,0,0,0,11,0
1,0,0,1,1,1,1,0,0,0,0,1,0,0,0,1,0,1,1,0
1,0,0,1,1,1,2,5.33,1.5,12,0,4,0.67,0.67,1,3,1,3,2,0
1,0,0,1,1,1,2,5.33,1.5,12,0,4,0.67,0.67,1,3,1,3,2,0
1,9,0,1,1,1,2,0,0,0,0,9,0,0,9,0,1,0,11,0
1,14,0,1,1,1,2,0,0,0,0,0,0,0,0,0,0,0,16,0
1,0,0,1,1,1,1,0,0,0,0,1,0,0,0,1,0,1,1,0
1,0,0,1,1,1,2,5.33,1.5,12,0,4,0.67,0.67,1,3,1,3,2,0
1,15,0,1,1,1,2,0,0,0,0,0,0,0,0,0,0,0,17,0
1,0,0,1,1,1,1,0,0,0,0,0,0,0,0,0,0,0,1,0
1,0,0,1,1,1,1,0,0,0,0,0,0,0,0,0,0,0,1,0
1,0,0,1,1,1,1,0,0,0,0,1,0,0,0,1,0,1,1,0
1,0,0,1,1,1,4,18.49,2.4,106.51,0.01,14,0.42,5.92,6,8,5,4,4,0
1,0,0,1,1,1,2,5.33,1.5,12,0,4,0.67,0.67,1,3,1,3,2,0
1,0,0,1,1,1,5,8.45,0.75,4.75,0,4,1.33,0.26,3,1,2,1,5,0
3,0,1,2,1,1,8,13.14,8.17,876.39,0.04,29,0.12,48.69,14,15,6,7,8,0
106,26,51,60,55,9,405,83.53,152.19,1934693.36,4.24,1828,0.01,107482.96,774,1054,89,35,431,1
5,1,3,3,2,1,13,25.14,10.58,2812.7,0.09,58,0.09,156.26,25,33,13,11,14,1
1,0,0,1,1,1,1,0,0,0,0,0,0,0,0,0,0,0,1,0
1,0,0,1,1,1,1,0,0,0,0,1,0,0,0,1,0,1,1,0
1,0,0,1,1,1,3,10.8,2.5,67.5,0.01,9,0.4,3.75,3,6,3,5,3,0
1,0,0,1,1,1,2,5.33,1.5,12,0,4,0.67,0.67,1,3,1,3,2,0
1,0,0,1,1,1,2,6.2,2.5,38.77,0.01,6,0.4,2.15,1,5,1,5,2,0
1,0,0,1,1,1,4,9.51,0.5,2.38,0,3,2,0.13,2,1,2,1,4,0
1,0,0,1,1,1,1,0,0,0,0,1,0,0,0,1,0,1,1,0
1,0,0,1,1,1,2,5.33,1.5,12,0,4,0.67,0.67,1,3,1,3,2,0
1,0,0,1,1,1,2,5.33,1.5,12,0,4,0.67,0.67,1,3,1,3,2,0
1,0,0,1,1,1,2,0,0,0,0,4,0,0,0,4,0,4,2,0
1,0,0,1,1,1,1,0,0,0,0,1,0,0,0,1,0,1,1,0
1,0,0,1,1,1,2,0,0,0,0,5,0,0,0,5,0,5,2,0
1,0,0,1,1,1,1,0,0,0,0,1,0,0,0,1,0,1,1,0
1,0,0,1,1,1,2,5.33,1.5,12,0,4,0.67,0.67,1,3,1,3,2,0
1,0,0,1,1,1,2,5.33,1.5,12,0,4,0.67,0.67,1,3,1,3,2,0
1,0,0,1,1,1,1,0,0,0,0,1,0,0,0,1,0,1,1,0
1,0,0,1,1,1,1,0,0,0,0,1,0,0,0,1,0,1,1,0
1,0,0,1,1,1,1,0,0,0,0,1,0,0,0,1,0,1,1,0
1,0,0,1,1,1,1,0,0,0,0,1,0,0,0,1,0,1,1,0
1,0,0,1,1,1,1,0,0,0,0,1,0,0,0,1,0,1,1,0
11,7,1,6,1,5,12,11.85,19,4278.34,0.08,54,0.05,237.69,19,35,6,12,19,0
1,0,0,1,1,1,2,5.33,1.5,12,0,4,0.67,0.67,1,3,1,3,2,0
1,0,0,1,1,1,2,5.33,1.5,12,0,4,0.67,0.67,1,3,1,3,2,0
1,0,0,1,1,1,2,5.33,1.5,12,0,4,0.67,0.67,1,3,1,3,2,0
1,0,0,1,1,1,2,5.33,1.5,12,0,4,0.67,0.67,1,3,1,3,2,0
1,0,0,1,1,1,2,5.33,1.5,12,0,4,0.67,0.67,1,3,1,3,2,0
1,0,0,1,1,1,2,5.33,1.5,12,0,4,0.67,0.67,1,3,1,3,2,0
1,0,0,1,1,1,2,5.33,1.5,12,0,4,0.67,0.67,1,3,1,3,2,0
11,6,1,6,1,6,17,27.73,17.33,8332.75,0.16,100,0.06,462.93,40,60,15,13,23,0
1,0,0,1,1,1,1,0,0,0,0,0,0,0,0,0,0,0,1,0
21,39,9,11,3,7,35,19.85,49,47653.19,0.32,184,0.02,2647.4,84,100,18,21,74,0
1,0,0,1,1,1,2,8,3,72,0.01,8,0.33,4,2,6,2,6,2,0
1,0,0,1,1,1,2,8,3,72,0.01,8,0.33,4,2,6,2,6,2,0
1,0,0,1,1,1,2,8,3,72,0.01,8,0.33,4,2,6,2,6,2,0
1,0,0,1,1,1,2,8,3,72,0.01,8,0.33,4,2,6,2,6,2,0
1,0,0,1,1,1,2,8,3,72,0.01,8,0.33,4,2,6,2,6,2,0
1,0,0,1,1,1,2,8,3,72,0.01,8,0.33,4,2,6,2,6,2,0
1,0,0,1,1,1,2,8,3,72,0.01,8,0.33,4,2,6,2,6,2,0
1,0,0,1,1,1,2,8,3,72,0.01,8,0.33,4,2,6,2,6,2,0
1,0,0,1,1,1,2,8,3,72,0.01,8,0.33,4,2,6,2,6,2,0
1,0,0,1,1,1,2,8,3,72,0.01,8,0.33,4,2,6,2,6,2,0
1,0,0,1,1,1,1,0,0,0,0,1,0,0,0,1,0,1,1,0
1,0,0,1,1,1,2,5.33,1.5,12,0,4,0.67,0.67,1,3,1,3,2,0
1,0,0,1,1,1,2,5.33,1.5,12,0,4,0.67,0.67,1,3,1,3,2,0
1,9,0,1,1,1,2,0,0,0,0,9,0,0,9,0,1,0,11,0
1,0,0,1,1,1,2,8,3,72,0.01,8,0.33,4,2,6,2,6,2,0
1,0,0,1,1,1,2,8,3,72,0.01,8,0.33,4,2,6,2,6,2,0
1,0,0,1,1,1,3,21.46,5.5,649.15,0.04,31,0.18,36.06,11,20,7,7,3,0
1,0,0,1,1,1,3,21.46,5.5,649.15,0.04,31,0.18,36.06,11,20,7,7,3,0
1,0,0,1,1,1,3,21.46,5.5,649.15,0.04,31,0.18,36.06,11,20,7,7,3,0
1,0,0,1,1,1,3,21.46,5.5,649.15,0.04,31,0.18,36.06,11,20,7,7,3,0
1,0,0,1,1,1,3,21.46,5.5,649.15,0.04,31,0.18,36.06,11,20,7,7,3,0
1,0,0,1,1,1,3,21.46,5.5,649.15,0.04,31,0.18,36.06,11,20,7,7,3,0
1,0,0,1,1,1,2,8,3,72,0.01,8,0.33,4,2,6,2,6,2,0
1,0,0,1,1,1,2,8,3,72,0.01,8,0.33,4,2,6,2,6,2,0
1,0,0,1,1,1,1,0,0,0,0,0,0,0,0,0,0,0,1,0
7,7,1,4,1,3,12,13.9,11,1682.18,0.05,36,0.09,93.45,16,20,8,11,19,0
1,0,0,1,1,1,1,0,0,0,0,0,0,0,0,0,0,0,1,0
9,9,1,5,1,5,13,15.49,12.83,2551.38,0.07,46,0.08,141.74,21,25,9,11,22,0
1,0,0,1,1,1,1,0,0,0,0,1,0,0,0,1,0,1,1,0
1,0,0,1,1,1,4,18.49,2.4,106.51,0.01,14,0.42,5.92,6,8,5,4,4,0
1,0,0,1,1,1,2,5.33,1.5,12,0,4,0.67,0.67,1,3,1,3,2,0
1,0,0,1,1,1,5,8.45,0.75,4.75,0,4,1.33,0.26,3,1,2,1,5,0
1,0,0,1,1,1,1,0,0,0,0,0,0,0,0,0,0,0,1,0
1,0,0,1,1,1,1,0,0,0,0,1,0,0,0,1,0,1,1,0
1,0,0,1,1,1,3,10.8,2.5,67.5,0.01,9,0.4,3.75,3,6,3,5,3,0
1,0,0,1,1,1,2,5.33,1.5,12,0,4,0.67,0.67,1,3,1,3,2,0
1,0,0,1,1,1,2,6.2,2.5,38.77,0.01,6,0.4,2.15,1,5,1,5,2,0
1,0,0,1,1,1,4,9.51,0.5,2.38,0,3,2,0.13,2,1,2,1,4,0
1,0,0,1,1,1,1,0,0,0,0,1,0,0,0,1,0,1,1,0
37,11,10,25,8,11,113,39.52,45.9,83263.92,0.6,311,0.02,4625.77,102,209,30,27,124,1
37,11,10,25,8,11,115,38.34,51.45,101508.96,0.66,334,0.02,5639.39,110,224,31,29,126,1
9,0,3,5,3,1,24,23.15,10.83,2716.66,0.08,54,0.09,150.93,20,34,12,13,24,1
25,7,22,13,8,11,73,77.19,17.65,24038.84,0.45,223,0.06,1335.49,100,123,51,18,80,1
43,4,35,25,13,19,131,48.08,46.14,102368.56,0.74,348,0.02,5687.14,133,215,49,34,135,1
62,29,110,42,6,14,250,67.04,117.44,924547.74,2.62,1092,0.01,51363.76,421,671,95,53,279,1
9,0,5,5,3,3,21,21.76,11.67,2961.28,0.08,54,0.09,164.52,20,34,12,14,21,1
1,0,0,1,1,1,1,0,0,0,0,1,0,0,0,1,0,1,1,0
1,0,0,1,1,1,1,0,0,0,0,1,0,0,0,1,0,1,1,0
1,0,0,1,1,1,0,0,0,0,0,1,0,0,0,1,0,1,0,0
5,0,0,3,1,1,2,13.29,4.5,269.08,0.02,18,0.22,14.95,6,12,4,6,2,0
1,0,1,1,1,1,2,16.92,3.5,207.22,0.02,16,0.29,11.51,6,10,6,7,2,0
47,2,10,24,4,10,88,39.17,49.31,95240.97,0.64,344,0.02,5291.16,143,201,29,20,90,1
21,0,1,12,3,1,69,22.58,67.1,101672.68,0.51,281,0.01,5648.48,122,159,20,22,69,1
1,0,0,1,1,1,2,5.33,1.5,12,0,4,0.67,0.67,1,3,1,3,2,0
1,0,0,1,1,1,2,5.33,1.5,12,0,4,0.67,0.67,1,3,1,3,2,0
5,0,0,3,1,3,10,10.91,9.17,916.67,0.03,25,0.11,50.93,11,14,6,10,10,1
17,4,11,9,6,6,44,61.37,13.58,11311.16,0.28,150,0.07,628.4,64,86,33,14,48,1
1,0,0,1,1,1,2,0,0,0,0,4,0,0,0,4,0,4,2,0
1,0,0,1,1,1,0,0,0,0,0,5,0,0,0,5,0,5,0,0
1,0,0,1,1,1,0,0,0,0,0,5,0,0,0,5,0,5,0,0
1,0,0,1,1,1,1,0,0,0,0,1,0,0,0,1,0,1,1,0
1,0,0,1,1,1,0,0,0,0,0,1,0,0,0,1,0,1,0,0
1,0,0,1,1,1,0,0,0,0,0,1,0,0,0,1,0,1,0,0
1,0,0,1,1,1,0,0,0,0,0,1,0,0,0,1,0,1,0,0
1,0,0,1,1,1,2,0,0,0,0,5,0,0,0,5,0,5,2,0
1,0,0,1,1,1,2,0,0,0,0.01,6,0,0,0,6,0,6,2,0
1,0,0,1,1,1,2,0,0,0,0.01,6,0,0,0,6,0,6,2,0
1,0,0,1,1,1,2,0,0,0,0.01,6,0,0,0,6,0,6,2,0
15,4,8,8,2,6,40,21.4,27,15598.04,0.19,126,0.04,866.56,54,72,12,12,44,1
9,1,2,5,3,4,23,33.08,12.35,5046.16,0.14,81,0.08,280.34,38,43,20,13,24,1
3,0,2,2,1,1,5,10.28,4.38,196.76,0.01,13,0.23,10.93,5,8,4,7,5,0
3,0,2,2,2,1,17,32.25,11.29,4115,0.12,75,0.09,228.61,32,43,17,12,17,0
1,0,0,1,1,1,2,7.74,1.5,17.41,0,5,0.67,0.97,2,3,2,3,2,0
1,0,0,1,1,1,2,5.33,1.5,12,0,4,0.67,0.67,1,3,1,3,2,0
19,3,2,14,13,1,62,33.3,42.05,58872.9,0.47,238,0.02,3270.72,87,151,30,29,65,0
1,0,0,1,1,1,1,0,0,0,0,1,0,0,0,1,0,1,1,0
7,2,9,4,1,4,27,26.17,10.91,3114.55,0.1,65,0.09,173.03,24,41,11,10,29,0
1,0,0,1,1,1,2,5.33,1.5,12,0,4,0.67,0.67,1,3,1,3,2,0
1,0,0,1,1,1,2,5.33,1.5,12,0,4,0.67,0.67,1,3,1,3,2,0
1,0,0,1,1,1,2,0,0,0,0,4,0,0,0,4,0,4,2,0
1,0,0,1,1,1,1,0,0,0,0,1,0,0,0,1,0,1,1,0
1,0,0,1,1,1,2,0,0,0,0,5,0,0,0,5,0,5,2,0
5,0,4,3,1,1,23,24.3,9.09,2008.11,0.07,52,0.11,111.56,25,27,11,8,23,0
11,1,0,6,4,1,25,18.81,16.79,5302.51,0.11,68,0.06,294.58,31,37,12,13,26,0
7,0,5,4,3,3,28,34.97,17.73,10989.58,0.21,119,0.06,610.53,52,67,22,15,28,0
1,0,0,1,1,1,2,6.2,2.5,38.77,0.01,6,0.4,2.15,1,5,1,5,2,1
5,0,3,3,3,1,26,37.91,14.32,7772.51,0.18,105,0.07,431.81,45,60,22,14,26,0
5,0,3,3,3,1,26,37.91,14.32,7772.51,0.18,105,0.07,431.81,45,60,22,14,26,0
17,0,14,9,7,1,54,76.32,13.91,14765.92,0.35,179,0.07,820.33,72,107,44,17,54,1
1,0,0,1,1,1,1,0,0,0,0,1,0,0,0,1,0,1,1,0
1,0,0,1,1,1,2,5.33,1.5,12,0,4,0.67,0.67,1,3,1,3,2,0
1,0,0,1,1,1,2,5.33,1.5,12,0,4,0.67,0.67,1,3,1,3,2,0
7,0,3,4,2,1,40,26.31,22.94,13846.09,0.2,123,0.04,769.23,60,63,17,13,40,1
3,0,2,2,2,1,17,32.25,11.29,4115,0.12,75,0.09,228.61,32,43,17,12,17,0
1,0,1,1,1,1,3,13.29,3.75,186.86,0.02,15,0.27,10.38,5,10,4,6,3,0
11,0,5,6,5,6,37,37.87,22.33,18888.31,0.28,154,0.04,1049.35,67,87,27,18,37,0
7,0,2,4,3,3,24,31.72,17.63,9853.99,0.19,109,0.06,547.44,47,62,20,15,24,0
3,0,2,2,2,1,17,26.69,12.86,4411.7,0.11,73,0.08,245.09,30,43,14,12,17,1
1,0,0,1,1,1,2,7.74,1.5,17.41,0,5,0.67,0.97,2,3,2,3,2,0
5,0,3,3,3,1,26,31.95,16.58,8781.23,0.18,105,0.06,487.85,45,60,19,14,26,0
1,0,0,1,1,1,1,0,0,0,0,1,0,0,0,1,0,1,1,0
1,0,0,1,1,1,0,0,0,0,0,1,0,0,0,1,0,1,0,0
3,1,0,2,1,1,6,11.71,4.9,281.06,0.02,16,0.2,15.61,7,9,5,7,7,0
3,1,0,2,1,1,6,11.71,4.9,281.06,0.02,16,0.2,15.61,7,9,5,7,7,0
1,0,0,1,1,1,2,5.33,1.5,12,0,4,0.67,0.67,1,3,1,3,2,0
3,1,0,2,1,1,6,11.71,4.9,281.06,0.02,16,0.2,15.61,7,9,5,7,7,0
1,0,0,1,1,1,0,0,0,0,0,1,0,0,0,1,0,1,0,0
1,0,0,1,1,1,2,7.86,2.5,49.13,0.01,7,0.4,2.73,2,5,2,5,2,0
1,0,0,1,1,1,2,6.97,2,27.86,0,6,0.5,1.55,1,5,1,4,2,0
1,0,0,1,1,1,2,5.33,1.5,12,0,4,0.67,0.67,1,3,1,3,2,0
1,0,0,1,1,1,2,10.44,3.5,127.89,0.01,11,0.29,7.11,3,8,3,7,2,0
1,0,0,1,1,1,2,6.97,2,27.86,0,6,0.5,1.55,1,5,1,4,2,0
1,0,0,1,1,1,0,0,0,0,0,1,0,0,0,1,0,1,0,0
1,0,0,1,1,1,2,5.33,1.5,12,0,4,0.67,0.67,1,3,1,3,2,0
1,0,0,1,1,1,2,10.44,3.5,127.89,0.01,11,0.29,7.11,3,8,3,7,2,0
1,0,0,1,1,1,2,7.49,3,67.38,0.01,8,0.33,3.74,1,7,1,6,2,0
1,0,0,1,1,1,2,9,3,81,0.01,9,0.33,4.5,2,7,2,6,2,0
1,0,0,1,1,1,2,9,3,81,0.01,9,0.33,4.5,2,7,2,6,2,0
1,0,0,1,1,1,2,9,3,81,0.01,9,0.33,4.5,2,7,2,6,2,0
1,0,0,1,1,1,2,10.44,3.5,127.89,0.01,11,0.29,7.11,3,8,3,7,2,0
1,0,0,1,1,1,2,9,3,81,0.01,9,0.33,4.5,2,7,2,6,2,0
1,0,0,1,1,1,2,9,3,81,0.01,9,0.33,4.5,2,7,2,6,2,0
1,0,0,1,1,1,2,7.49,3,67.38,0.01,8,0.33,3.74,1,7,1,6,2,0
1,0,0,1,1,1,2,7.49,3,67.38,0.01,8,0.33,3.74,1,7,1,6,2,0
1,0,0,1,1,1,2,10,3,90,0.01,10,0.33,5,2,8,2,6,2,0
1,0,0,1,1,1,3,10.44,3.5,127.89,0.01,11,0.29,7.11,3,8,3,7,3,0
1,0,0,1,1,1,3,11.39,3.5,139.52,0.01,12,0.29,7.75,3,9,3,7,3,0
1,0,0,1,1,1,2,9,3,81,0.01,9,0.33,4.5,2,7,2,6,2,0
1,0,0,1,1,1,2,10.44,3.5,127.89,0.01,11,0.29,7.11,3,8,3,7,2,0
1,0,0,1,1,1,2,9,3,81,0.01,9,0.33,4.5,2,7,2,6,2,0
1,0,0,1,1,1,2,9,3,81,0.01,9,0.33,4.5,2,7,2,6,2,0
1,0,0,1,1,1,2,10.44,3.5,127.89,0.01,11,0.29,7.11,3,8,3,7,2,0
1,0,0,1,1,1,2,9,3,81,0.01,9,0.33,4.5,2,7,2,6,2,0
1,0,0,1,1,1,2,9,3,81,0.01,9,0.33,4.5,2,7,2,6,2,0
1,0,0,1,1,1,2,9,3,81,0.01,9,0.33,4.5,2,7,2,6,2,0
1,0,0,1,1,1,2,7.49,3,67.38,0.01,8,0.33,3.74,1,7,1,6,2,0
1,0,0,1,1,1,2,9,3,81,0.01,9,0.33,4.5,2,7,2,6,2,0
1,0,0,1,1,1,2,9,3,81,0.01,9,0.33,4.5,2,7,2,6,2,0
1,0,0,1,1,1,2,10.44,3.5,127.89,0.01,11,0.29,7.11,3,8,3,7,2,0
1,0,0,1,1,1,2,9.05,2,36.19,0.01,7,0.5,2,2,5,2,4,2,0
1,0,0,1,1,1,2,9.05,2,36.19,0.01,7,0.5,2,2,5,2,4,2,0
1,0,0,1,1,1,2,9.05,2,36.19,0.01,7,0.5,2,2,5,2,4,2,0
1,0,0,1,1,1,2,9.05,2,36.19,0.01,7,0.5,2,2,5,2,4,2,0
1,0,0,1,1,1,2,9.05,2,36.19,0.01,7,0.5,2,2,5,2,4,2,0
1,0,0,1,1,1,2,9.05,2,36.19,0.01,7,0.5,2,2,5,2,4,2,0
1,0,0,1,1,1,2,9.05,2,36.19,0.01,7,0.5,2,2,5,2,4,2,0
1,0,0,1,1,1,2,9.05,2,36.19,0.01,7,0.5,2,2,5,2,4,2,0
1,0,0,1,1,1,2,9.05,2,36.19,0.01,7,0.5,2,2,5,2,4,2,0
1,0,0,1,1,1,2,9.05,2,36.19,0.01,7,0.5,2,2,5,2,4,2,0
1,0,0,1,1,1,2,9.05,2,36.19,0.01,7,0.5,2,2,5,2,4,2,0
1,0,0,1,1,1,2,9.05,2,36.19,0.01,7,0.5,2,2,5,2,4,2,0
1,0,0,1,1,1,2,9.05,2,36.19,0.01,7,0.5,2,2,5,2,4,2,0
1,0,0,1,1,1,2,10.44,3.5,127.89,0.01,11,0.29,7.11,3,8,3,7,2,0
1,0,0,1,1,1,2,10.44,3.5,127.89,0.01,11,0.29,7.11,3,8,3,7,2,0
1,0,0,1,1,1,2,9.05,2,36.19,0.01,7,0.5,2,2,5,2,4,2,0
1,0,0,1,1,1,0,0,0,0,0,1,0,0,0,1,0,1,0,0
1,0,0,1,1,1,2,5.33,1.5,12,0,4,0.67,0.67,1,3,1,3,2,0
3,0,0,2,1,1,6,11.86,4.38,227.03,0.02,15,0.23,12.61,5,10,4,7,6,0
3,2,0,2,1,1,6,14.43,5.14,381.76,0.02,19,0.19,21.21,9,10,7,8,8,0
5,1,0,3,1,1,10,12.67,10,1267.11,0.04,31,0.1,70.4,14,17,7,10,11,0
3,1,0,2,1,1,6,11.71,4.9,281.06,0.02,16,0.2,15.61,7,9,5,7,7,0
3,1,0,2,1,1,6,11.71,4.9,281.06,0.02,16,0.2,15.61,7,9,5,7,7,0
1,0,0,1,1,1,2,5.33,1.5,12,0,4,0.67,0.67,1,3,1,3,2,0
1,0,0,1,1,1,2,5.33,1.5,12,0,4,0.67,0.67,1,3,1,3,2,0
3,1,0,2,1,1,6,11.23,5.6,352.28,0.02,17,0.18,19.57,7,10,5,8,7,0
7,1,1,4,1,3,13,18.91,10.45,2065.48,0.07,45,0.1,114.75,19,26,10,11,14,0
5,1,0,3,1,1,10,13.33,9,1080,0.04,30,0.11,60,14,16,7,9,11,0
3,1,0,2,1,1,6,11.71,4.9,281.06,0.02,16,0.2,15.61,7,9,5,7,7,0
7,1,1,4,1,3,13,18.91,10.45,2065.48,0.07,45,0.1,114.75,19,26,10,11,14,0
3,1,0,2,1,1,6,11.71,4.9,281.06,0.02,16,0.2,15.61,7,9,5,7,7,0
3,0,0,2,1,1,6,11.86,4.38,227.03,0.02,15,0.23,12.61,5,10,4,7,6,0
3,2,0,2,1,1,7,16.73,5.5,506,0.03,23,0.18,28.11,11,12,8,8,9,0
1,0,0,1,1,1,2,5.33,1.5,12,0,4,0.67,0.67,1,3,1,3,2,0
9,6,0,5,1,1,14,23.12,11.15,2875.94,0.09,57,0.09,159.77,29,28,13,10,20,0
3,1,0,2,1,1,7,14.43,5.14,381.76,0.02,19,0.19,21.21,9,10,7,8,8,0
7,1,1,4,1,3,13,19.62,10,1962.15,0.07,44,0.1,109.01,20,24,11,11,14,0
1,0,0,1,1,1,2,5.33,1.5,12,0,4,0.67,0.67,1,3,1,3,2,0
1,0,0,1,1,1,2,5.33,1.5,12,0,4,0.67,0.67,1,3,1,3,2,0
1,0,0,1,1,1,2,5.33,1.5,12,0,4,0.67,0.67,1,3,1,3,2,0
1,0,0,1,1,1,2,5.33,1.5,12,0,4,0.67,0.67,1,3,1,3,2,0
1,0,0,1,1,1,2,5.33,1.5,12,0,4,0.67,0.67,1,3,1,3,2,0
1,0,0,1,1,1,2,5.33,1.5,12,0,4,0.67,0.67,1,3,1,3,2,0
1,0,0,1,1,1,2,5.33,1.5,12,0,4,0.67,0.67,1,3,1,3,2,0
3,1,0,2,1,1,5,10.95,6,394.38,0.02,19,0.17,21.91,10,9,5,6,6,0
3,1,0,2,1,1,5,10.95,6,394.38,0.02,19,0.17,21.91,10,9,5,6,6,0
3,1,0,2,1,1,5,10.95,6,394.38,0.02,19,0.17,21.91,10,9,5,6,6,0
3,1,0,2,1,1,5,10.95,6,394.38,0.02,19,0.17,21.91,10,9,5,6,6,0
3,1,1,2,1,1,5,10.95,6,394.38,0.02,19,0.17,21.91,10,9,5,6,6,0
1,0,0,1,1,1,3,13,3,117,0.01,13,0.33,6.5,6,7,4,4,3,0
1,0,0,1,1,1,2,11.07,3,99.66,0.01,10,0.33,5.54,4,6,4,6,2,0
1,0,0,1,1,1,2,7.74,1.5,17.41,0,5,0.67,0.97,2,3,2,3,2,0
3,0,1,2,1,1,8,16.92,4.5,342.66,0.03,20,0.22,19.04,9,11,7,7,8,0
3,1,0,2,1,1,7,16.92,4.5,342.66,0.03,20,0.22,19.04,9,11,7,7,8,0
1,0,0,1,1,1,2,11.41,2.5,71.32,0.01,9,0.4,3.96,4,5,4,5,2,0
3,1,0,2,1,1,5,10.95,6,394.38,0.02,19,0.17,21.91,10,9,5,6,6,0
1,0,0,1,1,1,4,16.51,4.8,380.39,0.03,25,0.21,21.13,12,13,5,4,4,0
1,0,0,1,1,1,2,7.74,1.5,17.41,0,5,0.67,0.97,2,3,2,3,2,0
3,1,0,2,1,1,5,10.95,6,394.38,0.02,19,0.17,21.91,10,9,5,6,6,0
3,1,0,2,1,1,5,10.95,6,394.38,0.02,19,0.17,21.91,10,9,5,6,6,0
1,0,0,1,1,1,2,9.83,2,39.3,0.01,7,0.5,2.18,3,4,3,4,2,0
1,0,0,1,1,1,2,7.86,2.5,49.13,0.01,7,0.4,2.73,2,5,2,5,2,0
1,0,0,1,1,1,2,7.49,3,67.38,0.01,8,0.33,3.74,1,7,1,6,2,0
1,0,0,1,1,1,2,7.49,3,67.38,0.01,8,0.33,3.74,1,7,1,6,2,0
1,0,0,1,1,1,2,7.49,3,67.38,0.01,8,0.33,3.74,1,7,1,6,2,0
1,0,0,1,1,1,2,7.49,3,67.38,0.01,8,0.33,3.74,1,7,1,6,2,0
1,0,0,1,1,1,2,7.49,3,67.38,0.01,8,0.33,3.74,1,7,1,6,2,0
1,0,0,1,1,1,2,7.49,3,67.38,0.01,8,0.33,3.74,1,7,1,6,2,0
1,0,0,1,1,1,2,7.49,3,67.38,0.01,8,0.33,3.74,1,7,1,6,2,0
1,0,0,1,1,1,2,10.57,3,95.1,0.01,10,0.33,5.28,3,7,3,6,2,0
1,0,0,1,1,1,0,0,0,0,0,1,0,0,0,1,0,1,0,0
1,0,0,1,1,1,2,5.33,1.5,12,0,4,0.67,0.67,1,3,1,3,2,0
1,0,0,1,1,1,2,5.33,1.5,12,0,4,0.67,0.67,1,3,1,3,2,0
1,0,0,1,1,1,2,5.33,1.5,12,0,4,0.67,0.67,1,3,1,3,2,0
1,0,0,1,1,1,2,5.33,1.5,12,0,4,0.67,0.67,1,3,1,3,2,0
1,0,0,1,1,1,2,5.33,1.5,12,0,4,0.67,0.67,1,3,1,3,2,0
1,0,0,1,1,1,2,5.33,1.5,12,0,4,0.67,0.67,1,3,1,3,2,0
1,0,0,1,1,1,2,5.33,1.5,12,0,4,0.67,0.67,1,3,1,3,2,0
1,0,0,1,1,1,2,13.95,2.5,87.17,0.01,11,0.4,4.84,4,7,4,5,2,0
71,76,26,38,37,1,209,116.79,66,508729.44,2.57,1126,0.02,28262.75,528,598,92,23,285,1
21,34,2,11,6,11,34,49.51,16.75,13890.27,0.28,151,0.06,771.68,67,84,30,15,68,1
3,4,1,1,1,1,11,26.59,8.85,2080.84,0.08,52,0.11,115.6,23,29,13,10,15,1
5,7,1,3,2,1,8,25.32,5.6,793.95,0.05,34,0.18,44.11,14,20,10,8,15,1
3,3,1,2,1,1,8,17.22,4.08,287.09,0.02,19,0.24,15.95,7,12,6,7,11,1
5,14,2,3,2,1,8,42.23,8.64,3154.64,0.12,73,0.12,175.26,33,40,21,11,22,0
3,7,1,1,1,1,5,21.78,6.05,797.21,0.04,30,0.17,44.29,11,19,10,11,12,1
5,3,2,3,2,1,10,13.87,9.33,1208.2,0.04,34,0.11,67.12,14,20,6,8,13,1
11,0,6,6,4,1,29,35.73,16.3,9497.61,0.19,111,0.06,527.64,50,61,23,15,29,0
13,1,3,7,2,1,29,16.88,33.41,18844.49,0.19,120,0.03,1046.92,49,71,11,15,30,0
5,0,3,3,3,1,19,39.3,10.5,4332.79,0.14,90,0.1,240.71,42,48,16,8,19,0
23,2,7,12,3,1,51,24.23,39,36855,0.32,189,0.03,2047.5,78,111,16,16,53,0
15,1,6,8,6,1,40,62.99,13.96,12272.53,0.29,155,0.07,681.81,67,88,36,15,41,0
58,25,35,30,16,16,160,71.7,64.67,299840.21,1.55,692,0.02,16657.79,291,401,72,32,185,0
33,8,15,23,2,5,89,23.67,94.73,212429.97,0.75,360,0.01,11801.66,141,219,32,43,97,0
3,0,1,2,2,1,19,54.78,8.71,4154.08,0.16,93,0.11,230.78,38,55,24,11,19,1
3,0,1,2,2,1,13,38.52,7.94,2431.42,0.1,63,0.13,135.08,26,37,18,11,13,0
25,12,2,13,13,1,37,90.56,8.08,5907.76,0.24,145,0.12,328.21,60,85,26,7,49,0
1,3,8,1,1,1,4,32.29,2.57,213.55,0.03,25,0.39,11.86,12,13,7,3,7,0
3,2,1,2,1,1,9,22.68,9.5,2047.19,0.07,47,0.11,113.73,19,28,12,12,11,0
15,1,7,8,8,1,44,46.83,20.63,19921.17,0.32,178,0.05,1106.73,77,101,28,15,45,0
68,34,22,37,5,3,164,113.85,33.24,125762.31,1.26,558,0.03,6986.8,226,332,85,25,198,0
5,0,0,3,1,1,2,13.29,4.5,269.08,0.02,18,0.22,14.95,6,12,4,6,2,0
1,0,1,1,1,1,2,16.92,3.5,207.22,0.02,16,0.29,11.51,6,10,6,7,2,0
1,0,0,1,1,1,2,0,0,0,0,5,0,0,0,5,0,5,2,0
1,0,0,1,1,1,0,0,0,0,0,1,0,0,0,1,0,1,0,0
1,0,0,1,1,1,2,0,0,0,0.01,6,0,0,0,6,0,6,2,0
5,3,14,3,1,1,25,52.14,19.36,19551.3,0.34,178,0.05,1086.18,71,107,33,18,28,1
9,1,6,6,4,1,40,32.18,40.04,51598.13,0.43,232,0.02,2866.56,91,141,25,22,41,1
5,0,2,3,3,1,22,42.32,11.13,5244.32,0.16,98,0.09,291.35,47,51,19,9,22,1
1,0,0,1,1,1,1,0,0,0,0,1,0,0,0,1,0,1,1,1
1,0,1,1,1,1,2,5.33,1.5,12,0,4,0.67,0.67,1,3,1,3,2,1
9,1,6,5,4,1,32,35.4,34.13,41218.87,0.4,224,0.03,2289.94,91,133,24,18,33,1
1,0,0,1,1,1,2,10.44,3.5,127.89,0.01,11,0.29,7.11,3,8,3,7,2,0
1,0,0,1,1,1,2,7.49,3,67.38,0.01,8,0.33,3.74,1,7,1,6,2,0
1,0,0,1,1,1,2,9,3,81,0.01,9,0.33,4.5,2,7,2,6,2,0
1,0,0,1,1,1,2,9,3,81,0.01,9,0.33,4.5,2,7,2,6,2,0
1,0,0,1,1,1,2,9,3,81,0.01,9,0.33,4.5,2,7,2,6,2,0
1,0,0,1,1,1,2,10.44,3.5,127.89,0.01,11,0.29,7.11,3,8,3,7,2,0
1,0,0,1,1,1,2,9,3,81,0.01,9,0.33,4.5,2,7,2,6,2,0
1,0,0,1,1,1,2,9,3,81,0.01,9,0.33,4.5,2,7,2,6,2,0
1,0,0,1,1,1,2,7.49,3,67.38,0.01,8,0.33,3.74,1,7,1,6,2,0
1,0,0,1,1,1,2,7.49,3,67.38,0.01,8,0.33,3.74,1,7,1,6,2,0
1,0,0,1,1,1,2,10,3,90,0.01,10,0.33,5,2,8,2,6,2,0
1,0,0,1,1,1,3,10.44,3.5,127.89,0.01,11,0.29,7.11,3,8,3,7,3,0
1,0,0,1,1,1,3,11.39,3.5,139.52,0.01,12,0.29,7.75,3,9,3,7,3,0
1,0,0,1,1,1,2,9,3,81,0.01,9,0.33,4.5,2,7,2,6,2,0
1,0,0,1,1,1,2,10.44,3.5,127.89,0.01,11,0.29,7.11,3,8,3,7,2,0
1,0,0,1,1,1,2,9,3,81,0.01,9,0.33,4.5,2,7,2,6,2,0
1,0,0,1,1,1,2,9,3,81,0.01,9,0.33,4.5,2,7,2,6,2,0
1,0,0,1,1,1,2,10.44,3.5,127.89,0.01,11,0.29,7.11,3,8,3,7,2,0
1,0,0,1,1,1,2,9,3,81,0.01,9,0.33,4.5,2,7,2,6,2,0
1,0,0,1,1,1,2,9,3,81,0.01,9,0.33,4.5,2,7,2,6,2,0
1,0,0,1,1,1,2,9,3,81,0.01,9,0.33,4.5,2,7,2,6,2,0
1,0,0,1,1,1,2,7.49,3,67.38,0.01,8,0.33,3.74,1,7,1,6,2,0
1,0,0,1,1,1,2,9,3,81,0.01,9,0.33,4.5,2,7,2,6,2,0
1,0,0,1,1,1,2,9,3,81,0.01,9,0.33,4.5,2,7,2,6,2,0
1,0,0,1,1,1,2,10.44,3.5,127.89,0.01,11,0.29,7.11,3,8,3,7,2,0
1,0,0,1,1,1,2,9.05,2,36.19,0.01,7,0.5,2,2,5,2,4,2,0
1,0,0,1,1,1,2,9.05,2,36.19,0.01,7,0.5,2,2,5,2,4,2,0
1,0,0,1,1,1,2,9.05,2,36.19,0.01,7,0.5,2,2,5,2,4,2,0
1,0,0,1,1,1,2,9.05,2,36.19,0.01,7,0.5,2,2,5,2,4,2,0
1,0,0,1,1,1,2,9.05,2,36.19,0.01,7,0.5,2,2,5,2,4,2,0
1,0,0,1,1,1,2,9.05,2,36.19,0.01,7,0.5,2,2,5,2,4,2,0
1,0,0,1,1,1,2,9.05,2,36.19,0.01,7,0.5,2,2,5,2,4,2,0
1,0,0,1,1,1,2,9.05,2,36.19,0.01,7,0.5,2,2,5,2,4,2,0
1,0,0,1,1,1,2,9.05,2,36.19,0.01,7,0.5,2,2,5,2,4,2,0
1,0,0,1,1,1,2,9.05,2,36.19,0.01,7,0.5,2,2,5,2,4,2,0
1,0,0,1,1,1,2,9.05,2,36.19,0.01,7,0.5,2,2,5,2,4,2,0
1,0,0,1,1,1,2,9.05,2,36.19,0.01,7,0.5,2,2,5,2,4,2,0
1,0,0,1,1,1,2,9.05,2,36.19,0.01,7,0.5,2,2,5,2,4,2,0
1,0,0,1,1,1,2,10.44,3.5,127.89,0.01,11,0.29,7.11,3,8,3,7,2,0
1,0,0,1,1,1,2,10.44,3.5,127.89,0.01,11,0.29,7.11,3,8,3,7,2,0
1,0,0,1,1,1,2,9.05,2,36.19,0.01,7,0.5,2,2,5,2,4,2,0
1,0,0,1,1,1,0,0,0,0,0,1,0,0,0,1,0,1,0,0
1,0,0,1,1,1,2,5.33,1.5,12,0,4,0.67,0.67,1,3,1,3,2,0
3,0,0,2,1,1,6,11.86,4.38,227.03,0.02,15,0.23,12.61,5,10,4,7,6,0
3,2,0,2,1,1,6,14.43,5.14,381.76,0.02,19,0.19,21.21,9,10,7,8,8,0
5,1,0,3,1,1,10,12.67,10,1267.11,0.04,31,0.1,70.4,14,17,7,10,11,0
3,1,0,2,1,1,6,11.71,4.9,281.06,0.02,16,0.2,15.61,7,9,5,7,7,0
3,1,0,2,1,1,6,11.71,4.9,281.06,0.02,16,0.2,15.61,7,9,5,7,7,0
1,0,0,1,1,1,2,5.33,1.5,12,0,4,0.67,0.67,1,3,1,3,2,0
1,0,0,1,1,1,2,5.33,1.5,12,0,4,0.67,0.67,1,3,1,3,2,0
3,1,0,2,1,1,6,11.23,5.6,352.28,0.02,17,0.18,19.57,7,10,5,8,7,0
7,1,1,4,1,3,13,18.91,10.45,2065.48,0.07,45,0.1,114.75,19,26,10,11,14,0
5,1,0,3,1,1,10,13.33,9,1080,0.04,30,0.11,60,14,16,7,9,11,0
3,1,0,2,1,1,6,11.71,4.9,281.06,0.02,16,0.2,15.61,7,9,5,7,7,0
7,1,1,4,1,3,13,18.91,10.45,2065.48,0.07,45,0.1,114.75,19,26,10,11,14,0
3,1,0,2,1,1,6,11.71,4.9,281.06,0.02,16,0.2,15.61,7,9,5,7,7,0
3,0,0,2,1,1,6,11.86,4.38,227.03,0.02,15,0.23,12.61,5,10,4,7,6,0
3,2,0,2,1,1,7,16.73,5.5,506,0.03,23,0.18,28.11,11,12,8,8,9,0
1,0,0,1,1,1,2,5.33,1.5,12,0,4,0.67,0.67,1,3,1,3,2,0
9,6,0,5,1,1,14,23.12,11.15,2875.94,0.09,57,0.09,159.77,29,28,13,10,20,0
3,1,0,2,1,1,7,14.43,5.14,381.76,0.02,19,0.19,21.21,9,10,7,8,8,0
7,1,1,4,1,3,13,19.62,10,1962.15,0.07,44,0.1,109.01,20,24,11,11,14,0
1,0,0,1,1,1,2,5.33,1.5,12,0,4,0.67,0.67,1,3,1,3,2,0
1,0,0,1,1,1,2,5.33,1.5,12,0,4,0.67,0.67,1,3,1,3,2,0
1,0,0,1,1,1,2,5.33,1.5,12,0,4,0.67,0.67,1,3,1,3,2,0
1,0,0,1,1,1,2,5.33,1.5,12,0,4,0.67,0.67,1,3,1,3,2,0
1,0,0,1,1,1,2,5.33,1.5,12,0,4,0.67,0.67,1,3,1,3,2,0
1,0,0,1,1,1,2,5.33,1.5,12,0,4,0.67,0.67,1,3,1,3,2,0
1,0,0,1,1,1,2,5.33,1.5,12,0,4,0.67,0.67,1,3,1,3,2,0
3,1,0,2,1,1,5,10.95,6,394.38,0.02,19,0.17,21.91,10,9,5,6,6,0
3,1,0,2,1,1,5,10.95,6,394.38,0.02,19,0.17,21.91,10,9,5,6,6,0
3,1,0,2,1,1,5,10.95,6,394.38,0.02,19,0.17,21.91,10,9,5,6,6,0
3,1,0,2,1,1,5,10.95,6,394.38,0.02,19,0.17,21.91,10,9,5,6,6,0
3,1,1,2,1,1,5,10.95,6,394.38,0.02,19,0.17,21.91,10,9,5,6,6,0
1,0,0,1,1,1,3,13,3,117,0.01,13,0.33,6.5,6,7,4,4,3,0
1,0,0,1,1,1,2,11.07,3,99.66,0.01,10,0.33,5.54,4,6,4,6,2,0
1,0,0,1,1,1,2,7.74,1.5,17.41,0,5,0.67,0.97,2,3,2,3,2,0
3,0,1,2,1,1,8,16.92,4.5,342.66,0.03,20,0.22,19.04,9,11,7,7,8,0
3,1,0,2,1,1,7,16.92,4.5,342.66,0.03,20,0.22,19.04,9,11,7,7,8,0
1,0,0,1,1,1,2,11.41,2.5,71.32,0.01,9,0.4,3.96,4,5,4,5,2,0
3,1,0,2,1,1,5,10.95,6,394.38,0.02,19,0.17,21.91,10,9,5,6,6,0
1,0,0,1,1,1,4,16.51,4.8,380.39,0.03,25,0.21,21.13,12,13,5,4,4,0
1,0,0,1,1,1,2,7.74,1.5,17.41,0,5,0.67,0.97,2,3,2,3,2,0
3,1,0,2,1,1,5,10.95,6,394.38,0.02,19,0.17,21.91,10,9,5,6,6,0
3,1,0,2,1,1,5,10.95,6,394.38,0.02,19,0.17,21.91,10,9,5,6,6,0
1,0,0,1,1,1,2,9.83,2,39.3,0.01,7,0.5,2.18,3,4,3,4,2,0
1,0,0,1,1,1,2,7.86,2.5,49.13,0.01,7,0.4,2.73,2,5,2,5,2,0
1,0,0,1,1,1,2,7.49,3,67.38,0.01,8,0.33,3.74,1,7,1,6,2,0
1,0,0,1,1,1,2,7.49,3,67.38,0.01,8,0.33,3.74,1,7,1,6,2,0
1,0,0,1,1,1,2,7.49,3,67.38,0.01,8,0.33,3.74,1,7,1,6,2,0
1,0,0,1,1,1,2,7.49,3,67.38,0.01,8,0.33,3.74,1,7,1,6,2,0
1,0,0,1,1,1,2,7.49,3,67.38,0.01,8,0.33,3.74,1,7,1,6,2,0
1,0,0,1,1,1,2,7.49,3,67.38,0.01,8,0.33,3.74,1,7,1,6,2,0
1,0,0,1,1,1,2,7.49,3,67.38,0.01,8,0.33,3.74,1,7,1,6,2,0
1,0,0,1,1,1,2,10.57,3,95.1,0.01,10,0.33,5.28,3,7,3,6,2,0
1,0,0,1,1,1,0,0,0,0,0,1,0,0,0,1,0,1,0,0
1,0,0,1,1,1,2,5.33,1.5,12,0,4,0.67,0.67,1,3,1,3,2,0
1,0,0,1,1,1,2,5.33,1.5,12,0,4,0.67,0.67,1,3,1,3,2,0
1,0,0,1,1,1,2,5.33,1.5,12,0,4,0.67,0.67,1,3,1,3,2,0
1,0,0,1,1,1,2,5.33,1.5,12,0,4,0.67,0.67,1,3,1,3,2,0
1,0,0,1,1,1,2,5.33,1.5,12,0,4,0.67,0.67,1,3,1,3,2,0
1,0,0,1,1,1,2,5.33,1.5,12,0,4,0.67,0.67,1,3,1,3,2,0
1,0,0,1,1,1,2,5.33,1.5,12,0,4,0.67,0.67,1,3,1,3,2,0
1,0,0,1,1,1,2,13.95,2.5,87.17,0.01,11,0.4,4.84,4,7,4,5,2,0
3,0,2,2,1,1,5,11.07,3,99.66,0.01,10,0.33,5.54,4,6,4,6,5,1
1,0,0,1,1,1,2,7.86,2.5,49.13,0.01,7,0.4,2.73,2,5,2,5,2,0
1,0,0,1,1,1,2,7.49,3,67.38,0.01,8,0.33,3.74,1,7,1,6,2,0
1,0,0,1,1,1,2,7.49,3,67.38,0.01,8,0.33,3.74,1,7,1,6,2,0
1,0,0,1,1,1,2,7.49,3,67.38,0.01,8,0.33,3.74,1,7,1,6,2,0
1,0,0,1,1,1,2,7.49,3,67.38,0.01,8,0.33,3.74,1,7,1,6,2,0
1,0,0,1,1,1,2,7.49,3,67.38,0.01,8,0.33,3.74,1,7,1,6,2,0
1,0,0,1,1,1,2,7.49,3,67.38,0.01,8,0.33,3.74,1,7,1,6,2,0
1,0,0,1,1,1,2,7.49,3,67.38,0.01,8,0.33,3.74,1,7,1,6,2,0
1,0,0,1,1,1,2,10.57,3,95.1,0.01,10,0.33,5.28,3,7,3,6,2,0
1,0,0,1,1,1,0,0,0,0,0,1,0,0,0,1,0,1,0,0
1,0,0,1,1,1,2,5.33,1.5,12,0,4,0.67,0.67,1,3,1,3,2,0
1,0,0,1,1,1,2,5.33,1.5,12,0,4,0.67,0.67,1,3,1,3,2,0
1,0,0,1,1,1,2,5.33,1.5,12,0,4,0.67,0.67,1,3,1,3,2,0
1,0,0,1,1,1,2,5.33,1.5,12,0,4,0.67,0.67,1,3,1,3,2,0
1,0,0,1,1,1,2,5.33,1.5,12,0,4,0.67,0.67,1,3,1,3,2,0
1,0,0,1,1,1,2,5.33,1.5,12,0,4,0.67,0.67,1,3,1,3,2,0
1,0,0,1,1,1,2,5.33,1.5,12,0,4,0.67,0.67,1,3,1,3,2,0
1,0,0,1,1,1,2,13.95,2.5,87.17,0.01,11,0.4,4.84,4,7,4,5,2,0
3,0,1,2,2,1,7,27.56,6.38,1120.04,0.06,40,0.16,62.22,17,23,12,9,7,0
12,0,3,7,6,1,37,34.98,19.08,12734.58,0.22,123,0.05,707.48,53,70,25,18,37,1
5,0,2,3,2,1,15,42.49,8.11,2801.07,0.12,69,0.12,155.62,31,38,21,11,15,0
1,0,0,1,1,1,2,7.74,1.5,17.41,0,5,0.67,0.97,2,3,2,3,2,0
1,0,0,1,1,1,0,0,0,0,0,1,0,0,0,1,0,1,0,0
9,6,17,5,3,1,33,48.04,17.21,14221.76,0.28,145,0.06,790.1,65,80,34,18,39,1
5,0,0,3,1,1,2,13.29,4.5,269.08,0.02,18,0.22,14.95,6,12,4,6,2,0
1,0,1,1,1,1,2,16.92,3.5,207.22,0.02,16,0.29,11.51,6,10,6,7,2,0
21,8,17,11,4,4,40,27.59,39.14,42260.49,0.36,199,0.03,2347.8,82,117,22,21,48,1
47,13,45,24,12,11,101,61.68,55.25,188272.55,1.14,536,0.02,10459.59,238,298,56,26,114,1
13,11,4,8,5,4,35,30.3,35.19,37506.78,0.36,187,0.03,2083.71,76,111,27,25,46,0
21,10,19,11,7,6,69,66.32,31.67,66500,0.7,350,0.03,3694.44,150,200,45,19,79,1
1,0,0,1,1,1,2,0,0,0,0,5,0,0,0,5,0,5,2,0
1,0,0,1,1,1,0,0,0,0,0,5,0,0,0,5,0,5,0,0
1,0,0,1,1,1,0,0,0,0,0,5,0,0,0,5,0,5,0,0
1,0,0,1,1,1,0,0,0,0,0,1,0,0,0,1,0,1,0,0
1,0,0,1,1,1,2,0,0,0,0.01,6,0,0,0,6,0,6,2,0
1,0,0,1,1,1,2,0,0,0,0.01,6,0,0,0,6,0,6,2,0
1,0,0,1,1,1,2,0,0,0,0.01,6,0,0,0,6,0,6,2,0
1,0,0,1,1,1,2,0,0,0,0.01,6,0,0,0,6,0,6,2,0
11,8,19,6,6,5,39,49.75,22.91,26116.12,0.38,199,0.04,1450.9,82,117,34,19,47,0
33,12,34,17,8,10,71,50.13,40.97,84170.75,0.68,345,0.02,4676.15,149,196,40,22,83,0
21,15,14,1,1,1,68,69.63,29.3,59767.66,0.68,340,0.03,3320.43,162,178,47,17,83,0
13,5,11,7,7,1,58,69.98,27.32,52234.72,0.64,325,0.04,2901.93,135,190,42,17,63,0
1,0,0,1,1,1,0,0,0,0,0,1,0,0,0,1,0,1,0,0
1,0,3,1,1,1,2,5.33,1.5,12,0,4,0.67,0.67,1,3,1,3,2,0
1,0,0,1,1,1,2,5.33,1.5,12,0,4,0.67,0.67,1,3,1,3,2,0
3,1,0,2,1,1,6,11.71,4.9,281.06,0.02,16,0.2,15.61,7,9,5,7,7,0
1,0,1,1,1,1,2,5.33,1.5,12,0,4,0.67,0.67,1,3,1,3,2,0
1,0,0,1,1,1,2,5.33,1.5,12,0,4,0.67,0.67,1,3,1,3,2,0
1,0,0,1,1,1,2,6.97,2,27.86,0,6,0.5,1.55,1,5,1,4,2,0
1,0,1,1,1,1,2,10.8,2.5,67.5,0.01,9,0.4,3.75,3,6,3,5,2,0
1,0,0,1,1,1,2,9.05,2,36.19,0.01,7,0.5,2,2,5,2,4,2,0
1,0,0,1,1,1,2,7.49,3,67.38,0.01,8,0.33,3.74,1,7,1,6,2,0
1,0,0,1,1,1,2,9,3,81,0.01,9,0.33,4.5,2,7,2,6,2,0
1,0,0,1,1,1,2,9,3,81,0.01,9,0.33,4.5,2,7,2,6,2,0
1,0,0,1,1,1,2,7.49,3,67.38,0.01,8,0.33,3.74,1,7,1,6,2,0
1,0,0,1,1,1,2,10.8,2.5,67.5,0.01,9,0.4,3.75,3,6,3,5,2,0
1,0,0,1,1,1,2,9,3,81,0.01,9,0.33,4.5,2,7,2,6,2,0
1,0,0,1,1,1,2,9.05,2,36.19,0.01,7,0.5,2,2,5,2,4,2,0
1,0,0,1,1,1,2,9.05,2,36.19,0.01,7,0.5,2,2,5,2,4,2,0
1,0,0,1,1,1,0,0,0,0,0,1,0,0,0,1,0,1,0,0
3,1,0,2,1,1,6,11.71,4.9,281.06,0.02,16,0.2,15.61,7,9,5,7,7,0
3,1,0,2,1,1,6,11.71,4.9,281.06,0.02,16,0.2,15.61,7,9,5,7,7,0
1,0,0,1,1,1,2,5.33,1.5,12,0,4,0.67,0.67,1,3,1,3,2,0
21,8,6,11,1,9,49,62.81,18.93,22497.56,0.4,214,0.05,1249.86,99,115,34,13,57,0
3,1,0,2,1,1,6,11.71,4.9,281.06,0.02,16,0.2,15.61,7,9,5,7,7,0
1,0,0,1,1,1,2,5.33,1.5,12,0,4,0.67,0.67,1,3,1,3,2,0
1,0,0,1,1,1,0,0,0,0,0,1,0,0,0,1,0,1,0,0
1,0,0,1,1,1,2,7.86,2.5,49.13,0.01,7,0.4,2.73,2,5,2,5,2,0
1,0,0,1,1,1,2,6.97,2,27.86,0,6,0.5,1.55,1,5,1,4,2,0
9,2,5,5,5,1,23,14.48,19.43,5465.18,0.09,72,0.05,303.62,34,38,7,8,25,1
1,0,0,1,1,1,2,5.33,1.5,12,0,4,0.67,0.67,1,3,1,3,2,0
1,0,0,1,1,1,2,10.44,3.5,127.89,0.01,11,0.29,7.11,3,8,3,7,2,0
1,0,0,1,1,1,2,6.97,2,27.86,0,6,0.5,1.55,1,5,1,4,2,0
1,0,0,1,1,1,0,0,0,0,0,1,0,0,0,1,0,1,0,0
1,0,0,1,1,1,2,5.33,1.5,12,0,4,0.67,0.67,1,3,1,3,2,0
1,0,0,1,1,1,0,0,0,0,0,1,0,0,0,1,0,1,0,0
1,0,0,1,1,1,2,5.33,1.5,12,0,4,0.67,0.67,1,3,1,3,2,0
1,0,0,1,1,1,2,8,3,72,0.01,8,0.33,4,2,6,2,6,2,0
1,0,0,1,1,1,2,0,0,0,0,5,0,0,0,5,0,5,2,0
1,0,0,1,1,1,0,0,0,0,0,1,0,0,0,1,0,1,0,0
1,0,0,1,1,1,2,0,0,0,0.01,6,0,0,0,6,0,6,2,0
1,0,0,1,1,1,2,7.75,2,31.02,0.01,6,0.5,1.72,2,4,2,4,2,0
1,0,0,1,1,1,2,7.74,1.5,17.41,0,5,0.67,0.97,2,3,2,3,2,0
1,1,1,1,1,1,1,0,0,0,0,1,0,0,1,0,1,0,2,0
3,1,0,2,1,1,7,12.44,4.9,298.63,0.02,17,0.2,16.59,7,10,5,7,8,0
1,0,0,1,1,1,0,0,0,0,0,1,0,0,0,1,0,1,0,0
3,1,0,2,2,1,6,10.88,6.3,431.75,0.02,18,0.16,23.99,7,11,5,9,7,0
1,0,0,1,1,1,2,5.33,1.5,12,0,4,0.67,0.67,1,3,1,3,2,0
1,0,0,1,1,1,2,0,0,0,0,5,0,0,0,5,0,5,2,0
1,0,0,1,1,1,0,0,0,0,0,1,0,0,0,1,0,1,0,0
1,0,0,1,1,1,2,0,0,0,0.01,6,0,0,0,6,0,6,2,0
1,0,3,1,1,1,4,0,0,0,0,3,0,0,3,0,2,0,4,0
1,0,0,1,1,1,0,0,0,0,0,1,0,0,0,1,0,1,0,0
3,2,1,2,1,1,5,10.33,4.5,209.28,0.02,14,0.22,11.63,6,8,4,6,7,0
3,1,0,2,1,1,6,13.45,3.6,174.36,0.02,14,0.28,9.69,6,8,5,6,7,0
1,0,0,1,1,1,2,0,0,0,0,5,0,0,0,5,0,5,2,0
1,0,0,1,1,1,0,0,0,0,0,1,0,0,0,1,0,1,0,0
1,0,0,1,1,1,2,0,0,0,0.01,6,0,0,0,6,0,6,2,0
1,0,0,1,1,1,0,0,0,0,0,1,0,0,0,1,0,1,0,0
1,0,0,1,1,1,2,6.55,3,58.95,0.01,7,0.33,3.28,1,6,1,6,2,0
1,0,0,1,1,1,2,5.33,1.5,12,0,4,0.67,0.67,1,3,1,3,2,0
1,0,0,1,1,1,2,8,3,72,0.01,8,0.33,4,2,6,2,6,2,0
1,0,0,1,1,1,2,9,3,81,0.01,9,0.33,4.5,2,7,2,6,2,0
1,0,0,1,1,1,2,8,3,72,0.01,8,0.33,4,2,6,2,6,2,0
1,0,0,1,1,1,2,9.49,3.5,116.27,0.01,10,0.29,6.46,3,7,3,7,2,0
1,0,0,1,1,1,2,11.86,3.5,145.3,0.01,12,0.29,8.07,4,8,4,7,2,0
1,0,0,1,1,1,2,0,0,0,0,5,0,0,0,5,0,5,2,0
1,0,0,1,1,1,0,0,0,0,0,1,0,0,0,1,0,1,0,0
1,0,0,1,1,1,2,0,0,0,0.01,6,0,0,0,6,0,6,2,0
1,0,0,1,1,1,2,7.75,2,31.02,0.01,6,0.5,1.72,2,4,2,4,2,0
1,0,0,1,1,1,3,10.8,3.33,120,0.01,12,0.3,6.67,4,8,3,5,3,0
1,0,0,1,1,1,2,7.75,2,31.02,0.01,6,0.5,1.72,2,4,2,4,2,0
1,0,0,1,1,1,3,12.68,2.5,79.25,0.01,10,0.4,4.4,4,6,4,5,3,0
1,3,1,1,1,1,1,0,0,0,0,1,0,0,1,0,1,0,4,0
1,0,0,1,1,1,2,6.55,3,58.95,0.01,7,0.33,3.28,1,6,1,6,2,0
1,0,0,1,1,1,0,0,0,0,0,1,0,0,0,1,0,1,0,0
1,0,0,1,1,1,2,8,3,72,0.01,8,0.33,4,2,6,2,6,2,0
1,0,0,1,1,1,2,9,3,81,0.01,9,0.33,4.5,2,7,2,6,2,0
1,0,0,1,1,1,2,5.33,1.5,12,0,4,0.67,0.67,1,3,1,3,2,0
1,0,0,1,1,1,2,5.33,1.5,12,0,4,0.67,0.67,1,3,1,3,2,0
1,0,0,1,1,1,2,6.55,3,58.95,0.01,7,0.33,3.28,1,6,1,6,2,0
1,0,0,1,1,1,2,5.33,1.5,12,0,4,0.67,0.67,1,3,1,3,2,0
1,0,0,1,1,1,2,5.33,1.5,12,0,4,0.67,0.67,1,3,1,3,2,0
1,0,0,1,1,1,2,6.55,3,58.95,0.01,7,0.33,3.28,1,6,1,6,2,0
1,0,0,1,1,1,2,0,0,0,0,5,0,0,0,5,0,5,2,0
1,0,0,1,1,1,0,0,0,0,0,1,0,0,0,1,0,1,0,0
1,0,0,1,1,1,2,0,0,0,0.01,6,0,0,0,6,0,6,2,0
1,0,0,1,1,1,0,0,0,0,0,1,0,0,0,1,0,1,0,0
1,0,1,1,1,1,2,9.51,3,85.59,0.01,9,0.33,4.75,3,6,3,6,2,0
1,0,0,1,1,1,2,0,0,0,0,5,0,0,0,5,0,5,2,0
1,0,0,1,1,1,0,0,0,0,0,1,0,0,0,1,0,1,0,0
1,0,0,1,1,1,2,0,0,0,0.01,6,0,0,0,6,0,6,2,0
1,0,0,1,1,1,2,10.44,3.5,127.89,0.01,11,0.29,7.11,3,8,3,7,2,0
1,0,0,1,1,1,2,7.49,3,67.38,0.01,8,0.33,3.74,1,7,1,6,2,0
1,0,0,1,1,1,2,9,3,81,0.01,9,0.33,4.5,2,7,2,6,2,0
1,0,0,1,1,1,2,9,3,81,0.01,9,0.33,4.5,2,7,2,6,2,0
1,0,0,1,1,1,2,9,3,81,0.01,9,0.33,4.5,2,7,2,6,2,0
1,0,0,1,1,1,2,10.44,3.5,127.89,0.01,11,0.29,7.11,3,8,3,7,2,0
1,0,0,1,1,1,2,9,3,81,0.01,9,0.33,4.5,2,7,2,6,2,0
1,0,0,1,1,1,2,9,3,81,0.01,9,0.33,4.5,2,7,2,6,2,0
1,0,0,1,1,1,2,7.49,3,67.38,0.01,8,0.33,3.74,1,7,1,6,2,0
1,0,0,1,1,1,2,7.49,3,67.38,0.01,8,0.33,3.74,1,7,1,6,2,0
1,0,0,1,1,1,2,10,3,90,0.01,10,0.33,5,2,8,2,6,2,0
1,0,0,1,1,1,3,10.44,3.5,127.89,0.01,11,0.29,7.11,3,8,3,7,3,0
1,0,0,1,1,1,3,11.39,3.5,139.52,0.01,12,0.29,7.75,3,9,3,7,3,0
1,0,0,1,1,1,2,9,3,81,0.01,9,0.33,4.5,2,7,2,6,2,0
1,0,0,1,1,1,2,10.44,3.5,127.89,0.01,11,0.29,7.11,3,8,3,7,2,0
1,0,0,1,1,1,2,9,3,81,0.01,9,0.33,4.5,2,7,2,6,2,0
1,0,0,1,1,1,2,9,3,81,0.01,9,0.33,4.5,2,7,2,6,2,0
1,0,0,1,1,1,2,10.44,3.5,127.89,0.01,11,0.29,7.11,3,8,3,7,2,0
1,0,0,1,1,1,2,9,3,81,0.01,9,0.33,4.5,2,7,2,6,2,0
1,0,0,1,1,1,2,9,3,81,0.01,9,0.33,4.5,2,7,2,6,2,0
1,0,0,1,1,1,2,9,3,81,0.01,9,0.33,4.5,2,7,2,6,2,0
1,0,0,1,1,1,2,7.49,3,67.38,0.01,8,0.33,3.74,1,7,1,6,2,0
1,0,0,1,1,1,2,9,3,81,0.01,9,0.33,4.5,2,7,2,6,2,0
1,0,0,1,1,1,2,9,3,81,0.01,9,0.33,4.5,2,7,2,6,2,0
1,0,0,1,1,1,2,10.44,3.5,127.89,0.01,11,0.29,7.11,3,8,3,7,2,0
1,0,0,1,1,1,2,9.05,2,36.19,0.01,7,0.5,2,2,5,2,4,2,0
1,0,0,1,1,1,2,9.05,2,36.19,0.01,7,0.5,2,2,5,2,4,2,0
1,0,0,1,1,1,2,9.05,2,36.19,0.01,7,0.5,2,2,5,2,4,2,0
1,0,0,1,1,1,2,9.05,2,36.19,0.01,7,0.5,2,2,5,2,4,2,0
1,0,0,1,1,1,2,9.05,2,36.19,0.01,7,0.5,2,2,5,2,4,2,0
1,0,0,1,1,1,2,9.05,2,36.19,0.01,7,0.5,2,2,5,2,4,2,0
1,0,0,1,1,1,2,9.05,2,36.19,0.01,7,0.5,2,2,5,2,4,2,0
1,0,0,1,1,1,2,9.05,2,36.19,0.01,7,0.5,2,2,5,2,4,2,0
1,0,0,1,1,1,2,9.05,2,36.19,0.01,7,0.5,2,2,5,2,4,2,0
1,0,0,1,1,1,2,9.05,2,36.19,0.01,7,0.5,2,2,5,2,4,2,0
1,0,0,1,1,1,2,9.05,2,36.19,0.01,7,0.5,2,2,5,2,4,2,0
1,0,0,1,1,1,2,9.05,2,36.19,0.01,7,0.5,2,2,5,2,4,2,0
1,0,0,1,1,1,2,9.05,2,36.19,0.01,7,0.5,2,2,5,2,4,2,0
1,0,0,1,1,1,2,10.44,3.5,127.89,0.01,11,0.29,7.11,3,8,3,7,2,0
1,0,0,1,1,1,2,10.44,3.5,127.89,0.01,11,0.29,7.11,3,8,3,7,2,0
1,0,0,1,1,1,2,9.05,2,36.19,0.01,7,0.5,2,2,5,2,4,2,0
1,0,0,1,1,1,0,0,0,0,0,1,0,0,0,1,0,1,0,0
1,0,0,1,1,1,2,5.33,1.5,12,0,4,0.67,0.67,1,3,1,3,2,0
3,0,0,2,1,1,6,11.86,4.38,227.03,0.02,15,0.23,12.61,5,10,4,7,6,0
3,2,0,2,1,1,6,14.43,5.14,381.76,0.02,19,0.19,21.21,9,10,7,8,8,0
5,1,0,3,1,1,10,12.67,10,1267.11,0.04,31,0.1,70.4,14,17,7,10,11,0
3,1,0,2,1,1,6,11.71,4.9,281.06,0.02,16,0.2,15.61,7,9,5,7,7,0
3,1,0,2,1,1,6,11.71,4.9,281.06,0.02,16,0.2,15.61,7,9,5,7,7,0
1,0,0,1,1,1,2,5.33,1.5,12,0,4,0.67,0.67,1,3,1,3,2,0
1,0,0,1,1,1,2,5.33,1.5,12,0,4,0.67,0.67,1,3,1,3,2,0
3,1,0,2,1,1,6,11.23,5.6,352.28,0.02,17,0.18,19.57,7,10,5,8,7,0
7,1,1,4,1,3,13,18.91,10.45,2065.48,0.07,45,0.1,114.75,19,26,10,11,14,0
5,1,0,3,1,1,10,13.33,9,1080,0.04,30,0.11,60,14,16,7,9,11,0
3,1,0,2,1,1,6,11.71,4.9,281.06,0.02,16,0.2,15.61,7,9,5,7,7,0
7,1,1,4,1,3,13,18.91,10.45,2065.48,0.07,45,0.1,114.75,19,26,10,11,14,0
3,1,0,2,1,1,6,11.71,4.9,281.06,0.02,16,0.2,15.61,7,9,5,7,7,0
3,0,0,2,1,1,6,11.86,4.38,227.03,0.02,15,0.23,12.61,5,10,4,7,6,0
3,2,0,2,1,1,7,16.73,5.5,506,0.03,23,0.18,28.11,11,12,8,8,9,0
1,0,0,1,1,1,2,5.33,1.5,12,0,4,0.67,0.67,1,3,1,3,2,0
9,6,0,5,1,1,14,23.12,11.15,2875.94,0.09,57,0.09,159.77,29,28,13,10,20,0
3,1,0,2,1,1,7,14.43,5.14,381.76,0.02,19,0.19,21.21,9,10,7,8,8,0
7,1,1,4,1,3,13,19.62,10,1962.15,0.07,44,0.1,109.01,20,24,11,11,14,0
1,0,0,1,1,1,2,5.33,1.5,12,0,4,0.67,0.67,1,3,1,3,2,0
1,0,0,1,1,1,2,5.33,1.5,12,0,4,0.67,0.67,1,3,1,3,2,0
1,0,0,1,1,1,2,5.33,1.5,12,0,4,0.67,0.67,1,3,1,3,2,0
1,0,0,1,1,1,2,5.33,1.5,12,0,4,0.67,0.67,1,3,1,3,2,0
1,0,0,1,1,1,2,5.33,1.5,12,0,4,0.67,0.67,1,3,1,3,2,0
1,0,0,1,1,1,2,5.33,1.5,12,0,4,0.67,0.67,1,3,1,3,2,0
1,0,0,1,1,1,2,5.33,1.5,12,0,4,0.67,0.67,1,3,1,3,2,0
3,1,0,2,1,1,5,10.95,6,394.38,0.02,19,0.17,21.91,10,9,5,6,6,0
3,1,0,2,1,1,5,10.95,6,394.38,0.02,19,0.17,21.91,10,9,5,6,6,0
3,1,0,2,1,1,5,10.95,6,394.38,0.02,19,0.17,21.91,10,9,5,6,6,0
3,1,0,2,1,1,5,10.95,6,394.38,0.02,19,0.17,21.91,10,9,5,6,6,0
3,1,1,2,1,1,5,10.95,6,394.38,0.02,19,0.17,21.91,10,9,5,6,6,0
1,0,0,1,1,1,3,13,3,117,0.01,13,0.33,6.5,6,7,4,4,3,0
1,0,0,1,1,1,2,11.07,3,99.66,0.01,10,0.33,5.54,4,6,4,6,2,0
1,0,0,1,1,1,2,7.74,1.5,17.41,0,5,0.67,0.97,2,3,2,3,2,0
3,0,1,2,1,1,8,16.92,4.5,342.66,0.03,20,0.22,19.04,9,11,7,7,8,0
3,1,0,2,1,1,7,16.92,4.5,342.66,0.03,20,0.22,19.04,9,11,7,7,8,0
1,0,0,1,1,1,2,11.41,2.5,71.32,0.01,9,0.4,3.96,4,5,4,5,2,0
3,1,0,2,1,1,5,10.95,6,394.38,0.02,19,0.17,21.91,10,9,5,6,6,0
1,0,0,1,1,1,4,16.51,4.8,380.39,0.03,25,0.21,21.13,12,13,5,4,4,0
1,0,0,1,1,1,2,7.74,1.5,17.41,0,5,0.67,0.97,2,3,2,3,2,0
3,1,0,2,1,1,5,10.95,6,394.38,0.02,19,0.17,21.91,10,9,5,6,6,0
3,1,0,2,1,1,5,10.95,6,394.38,0.02,19,0.17,21.91,10,9,5,6,6,0
1,0,0,1,1,1,2,9.83,2,39.3,0.01,7,0.5,2.18,3,4,3,4,2,0
7,0,0,4,1,1,25,29.71,7,1456,0.07,52,0.14,80.89,18,34,9,7,25,1
1,0,0,1,1,1,0,0,0,0,0,1,0,0,0,1,0,1,0,0
17,10,18,9,3,4,33,27.52,37.13,37936.51,0.34,185,0.03,2107.58,81,104,24,22,43,0
1,0,0,1,1,1,0,0,0,0,0,5,0,0,0,5,0,5,0,0
1,0,0,1,1,1,0,0,0,0,0,5,0,0,0,5,0,5,0,0
23,20,34,12,7,7,65,41.17,45.26,84328.48,0.62,303,0.02,4684.92,139,164,43,28,85,0
11,11,19,6,5,1,42,62.46,18.79,22051.63,0.39,203,0.05,1225.09,84,119,38,17,53,0
1,0,0,1,1,1,2,5.33,1.5,12,0,4,0.67,0.67,1,3,1,3,2,0
23,19,32,12,7,8,69,57.17,33.33,63520.6,0.64,305,0.03,3528.92,136,169,51,25,88,0
1,0,0,1,1,1,0,0,0,0,0,1,0,0,0,1,0,1,0,0
1,0,0,1,1,1,0,0,0,0,0,5,0,0,0,5,0,5,0,0
1,0,0,1,1,1,0,0,0,0,0,5,0,0,0,5,0,5,0,0
1,0,0,1,1,1,2,5.33,1.5,12,0,4,0.67,0.67,1,3,1,3,2,0
1,0,0,1,1,1,0,0,0,0,0,1,0,0,0,1,0,1,0,0
5,0,0,3,1,1,2,13.29,4.5,269.08,0.02,18,0.22,14.95,6,12,4,6,2,0
1,0,1,1,1,1,2,16.92,3.5,207.22,0.02,16,0.29,11.51,6,10,6,7,2,0
7,1,7,4,1,1,19,19.4,13,3278.25,0.08,55,0.08,182.12,22,33,11,13,20,1
1,0,0,1,1,1,2,0,0,0,0,5,0,0,0,5,0,5,2,0
1,0,0,1,1,1,0,0,0,0,0,5,0,0,0,5,0,5,0,0
1,0,0,1,1,1,0,0,0,0,0,5,0,0,0,5,0,5,0,0
1,0,0,1,1,1,0,0,0,0,0,1,0,0,0,1,0,1,0,0
1,0,0,1,1,1,2,0,0,0,0.01,6,0,0,0,6,0,6,2,0
1,0,0,1,1,1,2,0,0,0,0.01,6,0,0,0,6,0,6,2,0
1,0,0,1,1,1,2,0,0,0,0.01,6,0,0,0,6,0,6,2,0
1,0,0,1,1,1,2,0,0,0,0.01,6,0,0,0,6,0,6,2,0
33,16,15,18,9,5,64,51.8,33.46,57985.2,0.58,280,0.03,3221.4,114,166,46,27,80,1
1,0,0,1,1,1,0,0,0,0,0,1,0,0,0,1,0,1,0,0
1,0,3,1,1,1,2,5.33,1.5,12,0,4,0.67,0.67,1,3,1,3,2,0
1,0,0,1,1,1,2,5.33,1.5,12,0,4,0.67,0.67,1,3,1,3,2,0
3,1,0,2,1,1,6,11.71,4.9,281.06,0.02,16,0.2,15.61,7,9,5,7,7,0
1,0,1,1,1,1,2,5.33,1.5,12,0,4,0.67,0.67,1,3,1,3,2,0
1,0,0,1,1,1,2,5.33,1.5,12,0,4,0.67,0.67,1,3,1,3,2,0
1,0,0,1,1,1,2,6.97,2,27.86,0,6,0.5,1.55,1,5,1,4,2,0
1,0,1,1,1,1,2,10.8,2.5,67.5,0.01,9,0.4,3.75,3,6,3,5,2,0
1,0,0,1,1,1,2,9.05,2,36.19,0.01,7,0.5,2,2,5,2,4,2,0
1,0,0,1,1,1,2,7.49,3,67.38,0.01,8,0.33,3.74,1,7,1,6,2,0
1,0,0,1,1,1,2,9,3,81,0.01,9,0.33,4.5,2,7,2,6,2,0
1,0,0,1,1,1,2,9,3,81,0.01,9,0.33,4.5,2,7,2,6,2,0
1,0,0,1,1,1,2,7.49,3,67.38,0.01,8,0.33,3.74,1,7,1,6,2,0
1,0,0,1,1,1,2,10.8,2.5,67.5,0.01,9,0.4,3.75,3,6,3,5,2,0
1,0,0,1,1,1,2,9,3,81,0.01,9,0.33,4.5,2,7,2,6,2,0
1,0,0,1,1,1,2,9.05,2,36.19,0.01,7,0.5,2,2,5,2,4,2,0
1,0,0,1,1,1,2,9.05,2,36.19,0.01,7,0.5,2,2,5,2,4,2,0
1,0,0,1,1,1,0,0,0,0,0,1,0,0,0,1,0,1,0,0
3,1,0,2,1,1,6,11.71,4.9,281.06,0.02,16,0.2,15.61,7,9,5,7,7,0
3,1,0,2,1,1,6,11.71,4.9,281.06,0.02,16,0.2,15.61,7,9,5,7,7,0
1,0,0,1,1,1,2,5.33,1.5,12,0,4,0.67,0.67,1,3,1,3,2,0
3,1,0,2,1,1,6,11.71,4.9,281.06,0.02,16,0.2,15.61,7,9,5,7,7,0
1,0,0,1,1,1,0,0,0,0,0,1,0,0,0,1,0,1,0,0
1,0,0,1,1,1,2,7.86,2.5,49.13,0.01,7,0.4,2.73,2,5,2,5,2,0
1,0,0,1,1,1,2,6.97,2,27.86,0,6,0.5,1.55,1,5,1,4,2,0
1,0,0,1,1,1,2,5.33,1.5,12,0,4,0.67,0.67,1,3,1,3,2,0
1,0,0,1,1,1,2,10.44,3.5,127.89,0.01,11,0.29,7.11,3,8,3,7,2,0
1,0,0,1,1,1,2,6.97,2,27.86,0,6,0.5,1.55,1,5,1,4,2,0
1,0,0,1,1,1,0,0,0,0,0,1,0,0,0,1,0,1,0,0
1,0,0,1,1,1,2,5.33,1.5,12,0,4,0.67,0.67,1,3,1,3,2,0
19,1,4,10,1,10,34,49.41,11.7,6763.77,0.19,119,0.09,375.76,52,67,20,9,35,0
1,0,0,1,1,1,2,5.33,1.5,12,0,4,0.67,0.67,1,3,1,3,2,0
1,0,0,1,1,1,0,0,0,0,0,1,0,0,0,1,0,1,0,0
1,0,0,1,1,1,2,5.33,1.5,12,0,4,0.67,0.67,1,3,1,3,2,0
1,0,0,1,1,1,2,8,3,72,0.01,8,0.33,4,2,6,2,6,2,0
1,0,0,1,1,1,2,0,0,0,0,5,0,0,0,5,0,5,2,0
1,0,0,1,1,1,0,0,0,0,0,1,0,0,0,1,0,1,0,0
1,0,0,1,1,1,2,0,0,0,0.01,6,0,0,0,6,0,6,2,0
1,0,0,1,1,1,2,7.75,2,31.02,0.01,6,0.5,1.72,2,4,2,4,2,0
1,0,0,1,1,1,2,7.74,1.5,17.41,0,5,0.67,0.97,2,3,2,3,2,0
1,1,1,1,1,1,1,0,0,0,0,1,0,0,1,0,1,0,2,0
3,1,0,2,1,1,7,12.44,4.9,298.63,0.02,17,0.2,16.59,7,10,5,7,8,0
1,0,0,1,1,1,0,0,0,0,0,1,0,0,0,1,0,1,0,0
3,1,0,2,2,1,6,10.88,6.3,431.75,0.02,18,0.16,23.99,7,11,5,9,7,0
1,0,0,1,1,1,2,5.33,1.5,12,0,4,0.67,0.67,1,3,1,3,2,0
1,0,0,1,1,1,2,0,0,0,0,5,0,0,0,5,0,5,2,0
1,0,0,1,1,1,0,0,0,0,0,1,0,0,0,1,0,1,0,0
1,0,0,1,1,1,2,0,0,0,0.01,6,0,0,0,6,0,6,2,0
1,0,3,1,1,1,4,0,0,0,0,3,0,0,3,0,3,0,4,0
1,0,0,1,1,1,0,0,0,0,0,1,0,0,0,1,0,1,0,0
3,2,1,2,1,1,5,10.33,4.5,209.28,0.02,14,0.22,11.63,6,8,4,6,7,0
3,1,0,2,1,1,6,13.45,3.6,174.36,0.02,14,0.28,9.69,6,8,5,6,7,0
1,0,0,1,1,1,2,0,0,0,0,5,0,0,0,5,0,5,2,0
1,0,0,1,1,1,0,0,0,0,0,1,0,0,0,1,0,1,0,0
1,0,0,1,1,1,2,0,0,0,0.01,6,0,0,0,6,0,6,2,0
1,0,0,1,1,1,0,0,0,0,0,1,0,0,0,1,0,1,0,0
1,0,0,1,1,1,2,6.55,3,58.95,0.01,7,0.33,3.28,1,6,1,6,2,0
1,0,0,1,1,1,2,5.33,1.5,12,0,4,0.67,0.67,1,3,1,3,2,0
1,0,0,1,1,1,2,8,3,72,0.01,8,0.33,4,2,6,2,6,2,0
1,0,0,1,1,1,2,9,3,81,0.01,9,0.33,4.5,2,7,2,6,2,0
1,0,0,1,1,1,2,8,3,72,0.01,8,0.33,4,2,6,2,6,2,0
1,0,0,1,1,1,2,9.49,3.5,116.27,0.01,10,0.29,6.46,3,7,3,7,2,0
1,0,0,1,1,1,2,11.86,3.5,145.3,0.01,12,0.29,8.07,4,8,4,7,2,0
1,0,0,1,1,1,2,0,0,0,0,5,0,0,0,5,0,5,2,0
1,0,0,1,1,1,0,0,0,0,0,1,0,0,0,1,0,1,0,0
1,0,0,1,1,1,2,0,0,0,0.01,6,0,0,0,6,0,6,2,0
1,0,0,1,1,1,2,7.75,2,31.02,0.01,6,0.5,1.72,2,4,2,4,2,0
1,0,0,1,1,1,3,10.8,3.33,120,0.01,12,0.3,6.67,4,8,3,5,3,0
1,0,0,1,1,1,2,7.75,2,31.02,0.01,6,0.5,1.72,2,4,2,4,2,0
1,0,0,1,1,1,3,12.68,2.5,79.25,0.01,10,0.4,4.4,4,6,4,5,3,0
1,3,1,1,1,1,1,0,0,0,0,1,0,0,1,0,1,0,4,0
1,0,0,1,1,1,2,6.55,3,58.95,0.01,7,0.33,3.28,1,6,1,6,2,0
1,0,0,1,1,1,0,0,0,0,0,1,0,0,0,1,0,1,0,0
1,0,0,1,1,1,2,8,3,72,0.01,8,0.33,4,2,6,2,6,2,0
1,0,0,1,1,1,2,9,3,81,0.01,9,0.33,4.5,2,7,2,6,2,0
1,0,0,1,1,1,2,5.33,1.5,12,0,4,0.67,0.67,1,3,1,3,2,0
1,0,0,1,1,1,2,5.33,1.5,12,0,4,0.67,0.67,1,3,1,3,2,0
1,0,0,1,1,1,2,6.55,3,58.95,0.01,7,0.33,3.28,1,6,1,6,2,0
1,0,0,1,1,1,2,5.33,1.5,12,0,4,0.67,0.67,1,3,1,3,2,0
1,0,0,1,1,1,2,5.33,1.5,12,0,4,0.67,0.67,1,3,1,3,2,0
1,0,0,1,1,1,2,6.55,3,58.95,0.01,7,0.33,3.28,1,6,1,6,2,0
1,0,0,1,1,1,2,0,0,0,0,5,0,0,0,5,0,5,2,0
1,0,0,1,1,1,0,0,0,0,0,1,0,0,0,1,0,1,0,0
1,0,0,1,1,1,2,0,0,0,0.01,6,0,0,0,6,0,6,2,0
1,0,0,1,1,1,0,0,0,0,0,1,0,0,0,1,0,1,0,0
1,0,1,1,1,1,2,9.51,3,85.59,0.01,9,0.33,4.75,3,6,3,6,2,0
1,0,0,1,1,1,2,0,0,0,0,5,0,0,0,5,0,5,2,0
1,0,0,1,1,1,0,0,0,0,0,1,0,0,0,1,0,1,0,0
1,0,0,1,1,1,2,0,0,0,0.01,6,0,0,0,6,0,6,2,0
1,0,0,1,1,1,2,10.44,3.5,127.89,0.01,11,0.29,7.11,3,8,3,7,2,0
1,0,0,1,1,1,2,7.49,3,67.38,0.01,8,0.33,3.74,1,7,1,6,2,0
1,0,0,1,1,1,2,9,3,81,0.01,9,0.33,4.5,2,7,2,6,2,0
1,0,0,1,1,1,2,9,3,81,0.01,9,0.33,4.5,2,7,2,6,2,0
1,0,0,1,1,1,2,9,3,81,0.01,9,0.33,4.5,2,7,2,6,2,0
1,0,0,1,1,1,2,10.44,3.5,127.89,0.01,11,0.29,7.11,3,8,3,7,2,0
1,0,0,1,1,1,2,9,3,81,0.01,9,0.33,4.5,2,7,2,6,2,0
1,0,0,1,1,1,2,9,3,81,0.01,9,0.33,4.5,2,7,2,6,2,0
1,0,0,1,1,1,2,7.49,3,67.38,0.01,8,0.33,3.74,1,7,1,6,2,0
1,0,0,1,1,1,2,7.49,3,67.38,0.01,8,0.33,3.74,1,7,1,6,2,0
1,0,0,1,1,1,2,10,3,90,0.01,10,0.33,5,2,8,2,6,2,0
1,0,0,1,1,1,3,10.44,3.5,127.89,0.01,11,0.29,7.11,3,8,3,7,3,0
1,0,0,1,1,1,3,11.39,3.5,139.52,0.01,12,0.29,7.75,3,9,3,7,3,0
1,0,0,1,1,1,2,9,3,81,0.01,9,0.33,4.5,2,7,2,6,2,0
1,0,0,1,1,1,2,10.44,3.5,127.89,0.01,11,0.29,7.11,3,8,3,7,2,0
1,0,0,1,1,1,2,9,3,81,0.01,9,0.33,4.5,2,7,2,6,2,0
1,0,0,1,1,1,2,9,3,81,0.01,9,0.33,4.5,2,7,2,6,2,0
1,0,0,1,1,1,2,10.44,3.5,127.89,0.01,11,0.29,7.11,3,8,3,7,2,0
1,0,0,1,1,1,2,9,3,81,0.01,9,0.33,4.5,2,7,2,6,2,0
1,0,0,1,1,1,2,9,3,81,0.01,9,0.33,4.5,2,7,2,6,2,0
1,0,0,1,1,1,2,9,3,81,0.01,9,0.33,4.5,2,7,2,6,2,0
1,0,0,1,1,1,2,7.49,3,67.38,0.01,8,0.33,3.74,1,7,1,6,2,0
1,0,0,1,1,1,2,9,3,81,0.01,9,0.33,4.5,2,7,2,6,2,0
1,0,0,1,1,1,2,9,3,81,0.01,9,0.33,4.5,2,7,2,6,2,0
1,0,0,1,1,1,2,10.44,3.5,127.89,0.01,11,0.29,7.11,3,8,3,7,2,0
1,0,0,1,1,1,2,9.05,2,36.19,0.01,7,0.5,2,2,5,2,4,2,0
1,0,0,1,1,1,2,9.05,2,36.19,0.01,7,0.5,2,2,5,2,4,2,0
1,0,0,1,1,1,2,9.05,2,36.19,0.01,7,0.5,2,2,5,2,4,2,0
1,0,0,1,1,1,2,9.05,2,36.19,0.01,7,0.5,2,2,5,2,4,2,0
1,0,0,1,1,1,2,9.05,2,36.19,0.01,7,0.5,2,2,5,2,4,2,0
1,0,0,1,1,1,2,9.05,2,36.19,0.01,7,0.5,2,2,5,2,4,2,0
1,0,0,1,1,1,2,9.05,2,36.19,0.01,7,0.5,2,2,5,2,4,2,0
1,0,0,1,1,1,2,9.05,2,36.19,0.01,7,0.5,2,2,5,2,4,2,0
1,0,0,1,1,1,2,9.05,2,36.19,0.01,7,0.5,2,2,5,2,4,2,0
1,0,0,1,1,1,2,9.05,2,36.19,0.01,7,0.5,2,2,5,2,4,2,0
1,0,0,1,1,1,2,9.05,2,36.19,0.01,7,0.5,2,2,5,2,4,2,0
1,0,0,1,1,1,2,9.05,2,36.19,0.01,7,0.5,2,2,5,2,4,2,0
1,0,0,1,1,1,2,9.05,2,36.19,0.01,7,0.5,2,2,5,2,4,2,0
1,0,0,1,1,1,2,10.44,3.5,127.89,0.01,11,0.29,7.11,3,8,3,7,2,0
1,0,0,1,1,1,2,10.44,3.5,127.89,0.01,11,0.29,7.11,3,8,3,7,2,0
1,0,0,1,1,1,2,9.05,2,36.19,0.01,7,0.5,2,2,5,2,4,2,0
1,0,0,1,1,1,0,0,0,0,0,1,0,0,0,1,0,1,0,0
1,0,0,1,1,1,2,5.33,1.5,12,0,4,0.67,0.67,1,3,1,3,2,0
3,0,0,2,1,1,6,11.86,4.38,227.03,0.02,15,0.23,12.61,5,10,4,7,6,0
3,2,0,2,1,1,6,14.43,5.14,381.76,0.02,19,0.19,21.21,9,10,7,8,8,0
5,1,0,3,1,1,10,12.67,10,1267.11,0.04,31,0.1,70.4,14,17,7,10,11,0
3,1,0,2,1,1,6,11.71,4.9,281.06,0.02,16,0.2,15.61,7,9,5,7,7,0
3,1,0,2,1,1,6,11.71,4.9,281.06,0.02,16,0.2,15.61,7,9,5,7,7,0
1,0,0,1,1,1,2,5.33,1.5,12,0,4,0.67,0.67,1,3,1,3,2,0
1,0,0,1,1,1,2,5.33,1.5,12,0,4,0.67,0.67,1,3,1,3,2,0
3,1,0,2,1,1,6,11.23,5.6,352.28,0.02,17,0.18,19.57,7,10,5,8,7,0
7,1,1,4,1,3,13,18.91,10.45,2065.48,0.07,45,0.1,114.75,19,26,10,11,14,0
5,1,0,3,1,1,10,13.33,9,1080,0.04,30,0.11,60,14,16,7,9,11,0
3,1,0,2,1,1,6,11.71,4.9,281.06,0.02,16,0.2,15.61,7,9,5,7,7,0
7,1,1,4,1,3,13,18.91,10.45,2065.48,0.07,45,0.1,114.75,19,26,10,11,14,0
3,1,0,2,1,1,6,11.71,4.9,281.06,0.02,16,0.2,15.61,7,9,5,7,7,0
3,0,0,2,1,1,6,11.86,4.38,227.03,0.02,15,0.23,12.61,5,10,4,7,6,0
3,2,0,2,1,1,7,16.73,5.5,506,0.03,23,0.18,28.11,11,12,8,8,9,0
1,0,0,1,1,1,2,5.33,1.5,12,0,4,0.67,0.67,1,3,1,3,2,0
9,6,0,5,1,1,14,23.12,11.15,2875.94,0.09,57,0.09,159.77,29,28,13,10,20,0
3,1,0,2,1,1,7,14.43,5.14,381.76,0.02,19,0.19,21.21,9,10,7,8,8,0
7,1,1,4,1,3,13,19.62,10,1962.15,0.07,44,0.1,109.01,20,24,11,11,14,0
1,0,0,1,1,1,2,5.33,1.5,12,0,4,0.67,0.67,1,3,1,3,2,0
1,0,0,1,1,1,2,5.33,1.5,12,0,4,0.67,0.67,1,3,1,3,2,0
1,0,0,1,1,1,2,5.33,1.5,12,0,4,0.67,0.67,1,3,1,3,2,0
1,0,0,1,1,1,2,5.33,1.5,12,0,4,0.67,0.67,1,3,1,3,2,0
1,0,0,1,1,1,2,5.33,1.5,12,0,4,0.67,0.67,1,3,1,3,2,0
1,0,0,1,1,1,2,5.33,1.5,12,0,4,0.67,0.67,1,3,1,3,2,0
1,0,0,1,1,1,2,5.33,1.5,12,0,4,0.67,0.67,1,3,1,3,2,0
3,1,0,2,1,1,5,10.95,6,394.38,0.02,19,0.17,21.91,10,9,5,6,6,0
3,1,0,2,1,1,5,10.95,6,394.38,0.02,19,0.17,21.91,10,9,5,6,6,0
3,1,0,2,1,1,5,10.95,6,394.38,0.02,19,0.17,21.91,10,9,5,6,6,0
3,1,0,2,1,1,5,10.95,6,394.38,0.02,19,0.17,21.91,10,9,5,6,6,0
3,1,1,2,1,1,5,10.95,6,394.38,0.02,19,0.17,21.91,10,9,5,6,6,0
1,0,0,1,1,1,3,13,3,117,0.01,13,0.33,6.5,6,7,4,4,3,0
1,0,0,1,1,1,2,11.07,3,99.66,0.01,10,0.33,5.54,4,6,4,6,2,0
1,0,0,1,1,1,2,7.74,1.5,17.41,0,5,0.67,0.97,2,3,2,3,2,0
3,0,1,2,1,1,8,16.92,4.5,342.66,0.03,20,0.22,19.04,9,11,7,7,8,0
3,1,0,2,1,1,7,16.92,4.5,342.66,0.03,20,0.22,19.04,9,11,7,7,8,0
1,0,0,1,1,1,2,11.41,2.5,71.32,0.01,9,0.4,3.96,4,5,4,5,2,0
3,1,0,2,1,1,5,10.95,6,394.38,0.02,19,0.17,21.91,10,9,5,6,6,0
1,0,0,1,1,1,4,16.51,4.8,380.39,0.03,25,0.21,21.13,12,13,5,4,4,0
1,0,0,1,1,1,2,7.74,1.5,17.41,0,5,0.67,0.97,2,3,2,3,2,0
3,1,0,2,1,1,5,10.95,6,394.38,0.02,19,0.17,21.91,10,9,5,6,6,0
3,1,0,2,1,1,5,10.95,6,394.38,0.02,19,0.17,21.91,10,9,5,6,6,0
1,0,0,1,1,1,2,9.83,2,39.3,0.01,7,0.5,2.18,3,4,3,4,2,0
5,0,0,3,1,1,2,13.29,4.5,269.08,0.02,18,0.22,14.95,6,12,4,6,2,0
1,0,1,1,1,1,2,16.92,3.5,207.22,0.02,16,0.29,11.51,6,10,6,7,2,0
1,0,0,1,1,1,2,0,0,0,0,5,0,0,0,5,0,5,2,0
1,0,0,1,1,1,0,0,0,0,0,1,0,0,0,1,0,1,0,0
1,0,0,1,1,1,2,0,0,0,0.01,6,0,0,0,6,0,6,2,0
23,1,0,12,7,1,72,47.74,31.17,46373.73,0.5,254,0.03,2576.32,102,152,36,22,73,0
5,0,0,3,2,1,15,21.68,7.7,1285.19,0.06,38,0.13,71.4,14,24,10,11,15,0
1,0,0,1,1,1,6,14.58,5,364.54,0.02,23,0.2,20.25,8,15,4,5,6,0
17,7,3,9,7,1,69,53.99,38.93,81817.63,0.7,353,0.03,4545.42,152,201,41,21,76,0
1,0,0,1,1,1,2,10.44,3.5,127.89,0.01,11,0.29,7.11,3,8,3,7,2,0
1,0,0,1,1,1,2,7.49,3,67.38,0.01,8,0.33,3.74,1,7,1,6,2,0
1,0,0,1,1,1,2,9,3,81,0.01,9,0.33,4.5,2,7,2,6,2,0
1,0,0,1,1,1,2,9,3,81,0.01,9,0.33,4.5,2,7,2,6,2,0
1,0,0,1,1,1,2,9,3,81,0.01,9,0.33,4.5,2,7,2,6,2,0
1,0,0,1,1,1,2,10.44,3.5,127.89,0.01,11,0.29,7.11,3,8,3,7,2,0
1,0,0,1,1,1,2,9,3,81,0.01,9,0.33,4.5,2,7,2,6,2,0
1,0,0,1,1,1,2,9,3,81,0.01,9,0.33,4.5,2,7,2,6,2,0
1,0,0,1,1,1,2,7.49,3,67.38,0.01,8,0.33,3.74,1,7,1,6,2,0
1,0,0,1,1,1,2,7.49,3,67.38,0.01,8,0.33,3.74,1,7,1,6,2,0
1,0,0,1,1,1,2,10,3,90,0.01,10,0.33,5,2,8,2,6,2,0
1,0,0,1,1,1,3,10.44,3.5,127.89,0.01,11,0.29,7.11,3,8,3,7,3,0
1,0,0,1,1,1,3,11.39,3.5,139.52,0.01,12,0.29,7.75,3,9,3,7,3,0
1,0,0,1,1,1,2,9,3,81,0.01,9,0.33,4.5,2,7,2,6,2,0
1,0,0,1,1,1,2,10.44,3.5,127.89,0.01,11,0.29,7.11,3,8,3,7,2,0
1,0,0,1,1,1,2,9,3,81,0.01,9,0.33,4.5,2,7,2,6,2,0
1,0,0,1,1,1,2,9,3,81,0.01,9,0.33,4.5,2,7,2,6,2,0
1,0,0,1,1,1,2,10.44,3.5,127.89,0.01,11,0.29,7.11,3,8,3,7,2,0
1,0,0,1,1,1,2,9,3,81,0.01,9,0.33,4.5,2,7,2,6,2,0
1,0,0,1,1,1,2,9,3,81,0.01,9,0.33,4.5,2,7,2,6,2,0
1,0,0,1,1,1,2,9,3,81,0.01,9,0.33,4.5,2,7,2,6,2,0
1,0,0,1,1,1,2,7.49,3,67.38,0.01,8,0.33,3.74,1,7,1,6,2,0
1,0,0,1,1,1,2,9,3,81,0.01,9,0.33,4.5,2,7,2,6,2,0
1,0,0,1,1,1,2,9,3,81,0.01,9,0.33,4.5,2,7,2,6,2,0
1,0,0,1,1,1,2,10.44,3.5,127.89,0.01,11,0.29,7.11,3,8,3,7,2,0
1,0,0,1,1,1,2,9.05,2,36.19,0.01,7,0.5,2,2,5,2,4,2,0
1,0,0,1,1,1,2,9.05,2,36.19,0.01,7,0.5,2,2,5,2,4,2,0
1,0,0,1,1,1,2,9.05,2,36.19,0.01,7,0.5,2,2,5,2,4,2,0
1,0,0,1,1,1,2,9.05,2,36.19,0.01,7,0.5,2,2,5,2,4,2,0
1,0,0,1,1,1,2,9.05,2,36.19,0.01,7,0.5,2,2,5,2,4,2,0
1,0,0,1,1,1,2,9.05,2,36.19,0.01,7,0.5,2,2,5,2,4,2,0
1,0,0,1,1,1,2,9.05,2,36.19,0.01,7,0.5,2,2,5,2,4,2,0
1,0,0,1,1,1,2,9.05,2,36.19,0.01,7,0.5,2,2,5,2,4,2,0
1,0,0,1,1,1,2,9.05,2,36.19,0.01,7,0.5,2,2,5,2,4,2,0
1,0,0,1,1,1,2,9.05,2,36.19,0.01,7,0.5,2,2,5,2,4,2,0
1,0,0,1,1,1,2,9.05,2,36.19,0.01,7,0.5,2,2,5,2,4,2,0
1,0,0,1,1,1,2,9.05,2,36.19,0.01,7,0.5,2,2,5,2,4,2,0
1,0,0,1,1,1,2,9.05,2,36.19,0.01,7,0.5,2,2,5,2,4,2,0
1,0,0,1,1,1,2,10.44,3.5,127.89,0.01,11,0.29,7.11,3,8,3,7,2,0
1,0,0,1,1,1,2,10.44,3.5,127.89,0.01,11,0.29,7.11,3,8,3,7,2,0
1,0,0,1,1,1,2,9.05,2,36.19,0.01,7,0.5,2,2,5,2,4,2,0
1,0,0,1,1,1,0,0,0,0,0,1,0,0,0,1,0,1,0,0
1,0,0,1,1,1,2,5.33,1.5,12,0,4,0.67,0.67,1,3,1,3,2,0
3,0,0,2,1,1,6,11.86,4.38,227.03,0.02,15,0.23,12.61,5,10,4,7,6,0
3,2,0,2,1,1,6,14.43,5.14,381.76,0.02,19,0.19,21.21,9,10,7,8,8,0
5,1,0,3,1,1,10,12.67,10,1267.11,0.04,31,0.1,70.4,14,17,7,10,11,0
3,1,0,2,1,1,6,11.71,4.9,281.06,0.02,16,0.2,15.61,7,9,5,7,7,0
3,1,0,2,1,1,6,11.71,4.9,281.06,0.02,16,0.2,15.61,7,9,5,7,7,0
1,0,0,1,1,1,2,5.33,1.5,12,0,4,0.67,0.67,1,3,1,3,2,0
1,0,0,1,1,1,2,5.33,1.5,12,0,4,0.67,0.67,1,3,1,3,2,0
3,1,0,2,1,1,6,11.23,5.6,352.28,0.02,17,0.18,19.57,7,10,5,8,7,0
7,1,1,4,1,3,13,18.91,10.45,2065.48,0.07,45,0.1,114.75,19,26,10,11,14,0
5,1,0,3,1,1,10,13.33,9,1080,0.04,30,0.11,60,14,16,7,9,11,0
3,1,0,2,1,1,6,11.71,4.9,281.06,0.02,16,0.2,15.61,7,9,5,7,7,0
7,1,1,4,1,3,13,18.91,10.45,2065.48,0.07,45,0.1,114.75,19,26,10,11,14,0
3,1,0,2,1,1,6,11.71,4.9,281.06,0.02,16,0.2,15.61,7,9,5,7,7,0
3,0,0,2,1,1,6,11.86,4.38,227.03,0.02,15,0.23,12.61,5,10,4,7,6,0
3,2,0,2,1,1,7,16.73,5.5,506,0.03,23,0.18,28.11,11,12,8,8,9,0
1,0,0,1,1,1,2,5.33,1.5,12,0,4,0.67,0.67,1,3,1,3,2,0
9,6,0,5,1,1,14,23.12,11.15,2875.94,0.09,57,0.09,159.77,29,28,13,10,20,0
3,1,0,2,1,1,7,14.43,5.14,381.76,0.02,19,0.19,21.21,9,10,7,8,8,0
7,1,1,4,1,3,13,19.62,10,1962.15,0.07,44,0.1,109.01,20,24,11,11,14,0
1,0,0,1,1,1,2,5.33,1.5,12,0,4,0.67,0.67,1,3,1,3,2,0
1,0,0,1,1,1,2,5.33,1.5,12,0,4,0.67,0.67,1,3,1,3,2,0
1,0,0,1,1,1,2,5.33,1.5,12,0,4,0.67,0.67,1,3,1,3,2,0
1,0,0,1,1,1,2,5.33,1.5,12,0,4,0.67,0.67,1,3,1,3,2,0
1,0,0,1,1,1,2,5.33,1.5,12,0,4,0.67,0.67,1,3,1,3,2,0
1,0,0,1,1,1,2,5.33,1.5,12,0,4,0.67,0.67,1,3,1,3,2,0
1,0,0,1,1,1,2,5.33,1.5,12,0,4,0.67,0.67,1,3,1,3,2,0
3,1,0,2,1,1,5,10.95,6,394.38,0.02,19,0.17,21.91,10,9,5,6,6,0
3,1,0,2,1,1,5,10.95,6,394.38,0.02,19,0.17,21.91,10,9,5,6,6,0
3,1,0,2,1,1,5,10.95,6,394.38,0.02,19,0.17,21.91,10,9,5,6,6,0
3,1,0,2,1,1,5,10.95,6,394.38,0.02,19,0.17,21.91,10,9,5,6,6,0
3,1,1,2,1,1,5,10.95,6,394.38,0.02,19,0.17,21.91,10,9,5,6,6,0
1,0,0,1,1,1,3,13,3,117,0.01,13,0.33,6.5,6,7,4,4,3,0
1,0,0,1,1,1,2,11.07,3,99.66,0.01,10,0.33,5.54,4,6,4,6,2,0
1,0,0,1,1,1,2,7.74,1.5,17.41,0,5,0.67,0.97,2,3,2,3,2,0
3,0,1,2,1,1,8,16.92,4.5,342.66,0.03,20,0.22,19.04,9,11,7,7,8,0
3,1,0,2,1,1,7,16.92,4.5,342.66,0.03,20,0.22,19.04,9,11,7,7,8,0
1,0,0,1,1,1,2,11.41,2.5,71.32,0.01,9,0.4,3.96,4,5,4,5,2,0
3,1,0,2,1,1,5,10.95,6,394.38,0.02,19,0.17,21.91,10,9,5,6,6,0
1,0,0,1,1,1,4,16.51,4.8,380.39,0.03,25,0.21,21.13,12,13,5,4,4,0
1,0,0,1,1,1,2,7.74,1.5,17.41,0,5,0.67,0.97,2,3,2,3,2,0
3,1,0,2,1,1,5,10.95,6,394.38,0.02,19,0.17,21.91,10,9,5,6,6,0
3,1,0,2,1,1,5,10.95,6,394.38,0.02,19,0.17,21.91,10,9,5,6,6,0
1,0,0,1,1,1,2,9.83,2,39.3,0.01,7,0.5,2.18,3,4,3,4,2,0
1,0,0,1,1,1,2,7.86,2.5,49.13,0.01,7,0.4,2.73,2,5,2,5,2,0
1,0,0,1,1,1,2,7.49,3,67.38,0.01,8,0.33,3.74,1,7,1,6,2,0
1,0,0,1,1,1,2,7.49,3,67.38,0.01,8,0.33,3.74,1,7,1,6,2,0
1,0,0,1,1,1,2,7.49,3,67.38,0.01,8,0.33,3.74,1,7,1,6,2,0
1,0,0,1,1,1,2,7.49,3,67.38,0.01,8,0.33,3.74,1,7,1,6,2,0
1,0,0,1,1,1,2,7.49,3,67.38,0.01,8,0.33,3.74,1,7,1,6,2,0
1,0,0,1,1,1,2,7.49,3,67.38,0.01,8,0.33,3.74,1,7,1,6,2,0
1,0,0,1,1,1,2,7.49,3,67.38,0.01,8,0.33,3.74,1,7,1,6,2,0
1,0,0,1,1,1,2,10.57,3,95.1,0.01,10,0.33,5.28,3,7,3,6,2,0
1,0,0,1,1,1,0,0,0,0,0,1,0,0,0,1,0,1,0,0
1,0,0,1,1,1,2,5.33,1.5,12,0,4,0.67,0.67,1,3,1,3,2,0
1,0,0,1,1,1,2,5.33,1.5,12,0,4,0.67,0.67,1,3,1,3,2,0
1,0,0,1,1,1,2,5.33,1.5,12,0,4,0.67,0.67,1,3,1,3,2,0
1,0,0,1,1,1,2,5.33,1.5,12,0,4,0.67,0.67,1,3,1,3,2,0
1,0,0,1,1,1,2,5.33,1.5,12,0,4,0.67,0.67,1,3,1,3,2,0
1,0,0,1,1,1,2,5.33,1.5,12,0,4,0.67,0.67,1,3,1,3,2,0
1,0,0,1,1,1,2,5.33,1.5,12,0,4,0.67,0.67,1,3,1,3,2,0
1,0,0,1,1,1,2,13.95,2.5,87.17,0.01,11,0.4,4.84,4,7,4,5,2,0
5,0,0,3,1,1,2,13.29,4.5,269.08,0.02,18,0.22,14.95,6,12,4,6,2,0
1,0,1,1,1,1,2,16.92,3.5,207.22,0.02,16,0.29,11.51,6,10,6,7,2,0
1,0,0,1,1,1,2,0,0,0,0,5,0,0,0,5,0,5,2,0
1,0,0,1,1,1,0,0,0,0,0,1,0,0,0,1,0,1,0,0
1,0,0,1,1,1,2,0,0,0,0.01,6,0,0,0,6,0,6,2,0
1,0,0,1,1,1,0,0,0,0,0,1,0,0,0,1,0,1,0,0
1,0,0,1,1,1,3,8.43,5.33,239.85,0.01,13,0.19,13.33,4,9,3,8,3,0
1,0,0,1,1,1,3,11.65,4,186.42,0.02,13,0.25,10.36,4,9,4,8,3,0
3,0,2,2,1,1,19,21.1,15.17,4853.33,0.11,80,0.07,269.63,39,41,9,7,19,0
1,0,0,1,1,1,0,0,0,0,0,1,0,0,0,1,0,1,0,0
1,0,0,1,1,1,0,0,0,0,0,1,0,0,0,1,0,1,0,0
1,0,0,1,1,1,0,5.33,1.5,12,0,4,0.67,0.67,1,3,1,3,0,0
1,0,0,1,1,1,0,5.33,1.5,12,0,4,0.67,0.67,1,3,1,3,0,0
1,0,0,1,1,1,0,0,0,0,0,1,0,0,0,1,0,1,0,0
1,0,0,1,1,1,0,0,0,0,0,1,0,0,0,1,0,1,0,0
1,0,0,1,1,1,2,5.33,1.5,12,0,4,0.67,0.67,1,3,1,3,2,0
1,0,0,1,1,1,2,5.33,1.5,12,0,4,0.67,0.67,1,3,1,3,2,0
1,0,0,1,1,1,0,0,0,0,0,1,0,0,0,1,0,1,0,0
1,0,0,1,1,1,0,0,0,0,0,1,0,0,0,1,0,1,0,0
1,0,0,1,1,1,0,0,0,0,0,1,0,0,0,1,0,1,0,0
1,0,0,1,1,1,0,0,0,0,0,1,0,0,0,1,0,1,0,0
1,0,0,1,1,1,3,10.8,2.5,67.5,0.01,9,0.4,3.75,3,6,3,5,3,0
1,0,0,1,1,1,2,7.75,2,31.02,0.01,6,0.5,1.72,2,4,2,4,2,0
7,3,3,1,1,1,28,46.66,12.03,6756.37,0.19,100,0.08,375.35,38,62,30,19,31,0
1,0,0,1,1,1,2,10.44,3.5,127.89,0.01,11,0.29,7.11,3,8,3,7,2,0
1,0,0,1,1,1,2,7.49,3,67.38,0.01,8,0.33,3.74,1,7,1,6,2,0
1,0,0,1,1,1,2,9,3,81,0.01,9,0.33,4.5,2,7,2,6,2,0
1,0,0,1,1,1,2,9,3,81,0.01,9,0.33,4.5,2,7,2,6,2,0
1,0,0,1,1,1,2,9,3,81,0.01,9,0.33,4.5,2,7,2,6,2,0
1,0,0,1,1,1,2,10.44,3.5,127.89,0.01,11,0.29,7.11,3,8,3,7,2,0
1,0,0,1,1,1,2,9,3,81,0.01,9,0.33,4.5,2,7,2,6,2,0
1,0,0,1,1,1,2,9,3,81,0.01,9,0.33,4.5,2,7,2,6,2,0
1,0,0,1,1,1,2,7.49,3,67.38,0.01,8,0.33,3.74,1,7,1,6,2,0
1,0,0,1,1,1,2,7.49,3,67.38,0.01,8,0.33,3.74,1,7,1,6,2,0
1,0,0,1,1,1,2,10,3,90,0.01,10,0.33,5,2,8,2,6,2,0
1,0,0,1,1,1,3,10.44,3.5,127.89,0.01,11,0.29,7.11,3,8,3,7,3,0
1,0,0,1,1,1,3,11.39,3.5,139.52,0.01,12,0.29,7.75,3,9,3,7,3,0
1,0,0,1,1,1,2,9,3,81,0.01,9,0.33,4.5,2,7,2,6,2,0
1,0,0,1,1,1,2,10.44,3.5,127.89,0.01,11,0.29,7.11,3,8,3,7,2,0
1,0,0,1,1,1,2,9,3,81,0.01,9,0.33,4.5,2,7,2,6,2,0
1,0,0,1,1,1,2,9,3,81,0.01,9,0.33,4.5,2,7,2,6,2,0
1,0,0,1,1,1,2,10.44,3.5,127.89,0.01,11,0.29,7.11,3,8,3,7,2,0
1,0,0,1,1,1,2,9,3,81,0.01,9,0.33,4.5,2,7,2,6,2,0
1,0,0,1,1,1,2,9,3,81,0.01,9,0.33,4.5,2,7,2,6,2,0
1,0,0,1,1,1,2,9,3,81,0.01,9,0.33,4.5,2,7,2,6,2,0
1,0,0,1,1,1,2,7.49,3,67.38,0.01,8,0.33,3.74,1,7,1,6,2,0
1,0,0,1,1,1,2,9,3,81,0.01,9,0.33,4.5,2,7,2,6,2,0
1,0,0,1,1,1,2,9,3,81,0.01,9,0.33,4.5,2,7,2,6,2,0
1,0,0,1,1,1,2,10.44,3.5,127.89,0.01,11,0.29,7.11,3,8,3,7,2,0
1,0,0,1,1,1,2,9.05,2,36.19,0.01,7,0.5,2,2,5,2,4,2,0
1,0,0,1,1,1,2,9.05,2,36.19,0.01,7,0.5,2,2,5,2,4,2,0
1,0,0,1,1,1,2,9.05,2,36.19,0.01,7,0.5,2,2,5,2,4,2,0
1,0,0,1,1,1,2,9.05,2,36.19,0.01,7,0.5,2,2,5,2,4,2,0
1,0,0,1,1,1,2,9.05,2,36.19,0.01,7,0.5,2,2,5,2,4,2,0
1,0,0,1,1,1,2,9.05,2,36.19,0.01,7,0.5,2,2,5,2,4,2,0
1,0,0,1,1,1,2,9.05,2,36.19,0.01,7,0.5,2,2,5,2,4,2,0
1,0,0,1,1,1,2,9.05,2,36.19,0.01,7,0.5,2,2,5,2,4,2,0
1,0,0,1,1,1,2,9.05,2,36.19,0.01,7,0.5,2,2,5,2,4,2,0
1,0,0,1,1,1,2,9.05,2,36.19,0.01,7,0.5,2,2,5,2,4,2,0
1,0,0,1,1,1,2,9.05,2,36.19,0.01,7,0.5,2,2,5,2,4,2,0
1,0,0,1,1,1,2,9.05,2,36.19,0.01,7,0.5,2,2,5,2,4,2,0
1,0,0,1,1,1,2,9.05,2,36.19,0.01,7,0.5,2,2,5,2,4,2,0
1,0,0,1,1,1,2,10.44,3.5,127.89,0.01,11,0.29,7.11,3,8,3,7,2,0
1,0,0,1,1,1,2,10.44,3.5,127.89,0.01,11,0.29,7.11,3,8,3,7,2,0
1,0,0,1,1,1,2,9.05,2,36.19,0.01,7,0.5,2,2,5,2,4,2,0
1,0,0,1,1,1,0,0,0,0,0,1,0,0,0,1,0,1,0,0
1,0,0,1,1,1,2,5.33,1.5,12,0,4,0.67,0.67,1,3,1,3,2,0
3,0,0,2,1,1,6,11.86,4.38,227.03,0.02,15,0.23,12.61,5,10,4,7,6,0
3,2,0,2,1,1,6,14.43,5.14,381.76,0.02,19,0.19,21.21,9,10,7,8,8,0
5,1,0,3,1,1,10,12.67,10,1267.11,0.04,31,0.1,70.4,14,17,7,10,11,0
3,1,0,2,1,1,6,11.71,4.9,281.06,0.02,16,0.2,15.61,7,9,5,7,7,0
3,1,0,2,1,1,6,11.71,4.9,281.06,0.02,16,0.2,15.61,7,9,5,7,7,0
1,0,0,1,1,1,2,5.33,1.5,12,0,4,0.67,0.67,1,3,1,3,2,0
1,0,0,1,1,1,2,5.33,1.5,12,0,4,0.67,0.67,1,3,1,3,2,0
3,1,0,2,1,1,6,11.23,5.6,352.28,0.02,17,0.18,19.57,7,10,5,8,7,0
7,1,1,4,1,3,13,18.91,10.45,2065.48,0.07,45,0.1,114.75,19,26,10,11,14,0
5,1,0,3,1,1,10,13.33,9,1080,0.04,30,0.11,60,14,16,7,9,11,0
3,1,0,2,1,1,6,11.71,4.9,281.06,0.02,16,0.2,15.61,7,9,5,7,7,0
7,1,1,4,1,3,13,18.91,10.45,2065.48,0.07,45,0.1,114.75,19,26,10,11,14,0
3,1,0,2,1,1,6,11.71,4.9,281.06,0.02,16,0.2,15.61,7,9,5,7,7,0
3,0,0,2,1,1,6,11.86,4.38,227.03,0.02,15,0.23,12.61,5,10,4,7,6,0
3,2,0,2,1,1,7,16.73,5.5,506,0.03,23,0.18,28.11,11,12,8,8,9,0
1,0,0,1,1,1,2,5.33,1.5,12,0,4,0.67,0.67,1,3,1,3,2,0
9,6,0,5,1,1,14,23.12,11.15,2875.94,0.09,57,0.09,159.77,29,28,13,10,20,0
3,1,0,2,1,1,7,14.43,5.14,381.76,0.02,19,0.19,21.21,9,10,7,8,8,0
7,1,1,4,1,3,13,19.62,10,1962.15,0.07,44,0.1,109.01,20,24,11,11,14,0
1,0,0,1,1,1,2,5.33,1.5,12,0,4,0.67,0.67,1,3,1,3,2,0
1,0,0,1,1,1,2,5.33,1.5,12,0,4,0.67,0.67,1,3,1,3,2,0
1,0,0,1,1,1,2,5.33,1.5,12,0,4,0.67,0.67,1,3,1,3,2,0
1,0,0,1,1,1,2,5.33,1.5,12,0,4,0.67,0.67,1,3,1,3,2,0
1,0,0,1,1,1,2,5.33,1.5,12,0,4,0.67,0.67,1,3,1,3,2,0
1,0,0,1,1,1,2,5.33,1.5,12,0,4,0.67,0.67,1,3,1,3,2,0
1,0,0,1,1,1,2,5.33,1.5,12,0,4,0.67,0.67,1,3,1,3,2,0
3,1,0,2,1,1,5,10.95,6,394.38,0.02,19,0.17,21.91,10,9,5,6,6,0
3,1,0,2,1,1,5,10.95,6,394.38,0.02,19,0.17,21.91,10,9,5,6,6,0
3,1,0,2,1,1,5,10.95,6,394.38,0.02,19,0.17,21.91,10,9,5,6,6,0
3,1,0,2,1,1,5,10.95,6,394.38,0.02,19,0.17,21.91,10,9,5,6,6,0
3,1,1,2,1,1,5,10.95,6,394.38,0.02,19,0.17,21.91,10,9,5,6,6,0
1,0,0,1,1,1,3,13,3,117,0.01,13,0.33,6.5,6,7,4,4,3,0
1,0,0,1,1,1,2,11.07,3,99.66,0.01,10,0.33,5.54,4,6,4,6,2,0
1,0,0,1,1,1,2,7.74,1.5,17.41,0,5,0.67,0.97,2,3,2,3,2,0
3,0,1,2,1,1,8,16.92,4.5,342.66,0.03,20,0.22,19.04,9,11,7,7,8,0
3,1,0,2,1,1,7,16.92,4.5,342.66,0.03,20,0.22,19.04,9,11,7,7,8,0
1,0,0,1,1,1,2,11.41,2.5,71.32,0.01,9,0.4,3.96,4,5,4,5,2,0
3,1,0,2,1,1,5,10.95,6,394.38,0.02,19,0.17,21.91,10,9,5,6,6,0
1,0,0,1,1,1,4,16.51,4.8,380.39,0.03,25,0.21,21.13,12,13,5,4,4,0
1,0,0,1,1,1,2,7.74,1.5,17.41,0,5,0.67,0.97,2,3,2,3,2,0
3,1,0,2,1,1,5,10.95,6,394.38,0.02,19,0.17,21.91,10,9,5,6,6,0
3,1,0,2,1,1,5,10.95,6,394.38,0.02,19,0.17,21.91,10,9,5,6,6,0
1,0,0,1,1,1,2,9.83,2,39.3,0.01,7,0.5,2.18,3,4,3,4,2,0
1,0,0,1,1,1,0,5.33,1.5,12,0,4,0.67,0.67,1,3,1,3,0,0
1,0,0,1,1,1,0,0,0,0,0,1,0,0,0,1,0,1,0,0
1,0,0,1,1,1,3,8.43,5.33,239.85,0.01,13,0.19,13.33,4,9,3,8,3,0
1,0,0,1,1,1,3,11.65,4,186.42,0.02,13,0.25,10.36,4,9,4,8,3,0
1,0,0,1,1,1,0,0,0,0,0,1,0,0,0,1,0,1,0,0
1,0,0,1,1,1,0,0,0,0,0,1,0,0,0,1,0,1,0,0
1,0,0,1,1,1,0,5.33,1.5,12,0,4,0.67,0.67,1,3,1,3,0,0
1,0,0,1,1,1,0,5.33,1.5,12,0,4,0.67,0.67,1,3,1,3,0,0
1,0,0,1,1,1,0,0,0,0,0,1,0,0,0,1,0,1,0,0
133,9,38,67,36,66,519,203.6,64.48,846697.33,4.38,1839,0.02,47038.74,737,1102,120,21,528,0
1,0,0,1,1,1,0,0,0,0,0,1,0,0,0,1,0,1,0,0
1,0,0,1,1,1,5,53.15,1,53.15,0.02,16,1,2.95,8,8,8,2,5,0
1,0,0,1,1,1,0,0,0,0,0,1,0,0,0,1,0,1,0,0
1,0,0,1,1,1,5,53.15,1,53.15,0.02,16,1,2.95,8,8,8,2,5,0
1,0,0,1,1,1,0,0,0,0,0,1,0,0,0,1,0,1,0,0
1,0,0,1,1,1,5,53.15,1,53.15,0.02,16,1,2.95,8,8,8,2,5,0
1,0,0,1,1,1,0,0,0,0,0,1,0,0,0,1,0,1,0,0
1,0,0,1,1,1,5,53.15,1,53.15,0.02,16,1,2.95,8,8,8,2,5,0
1,0,0,1,1,1,0,0,0,0,0,1,0,0,0,1,0,1,0,0
1,0,0,1,1,1,5,53.15,1,53.15,0.02,16,1,2.95,8,8,8,2,5,0
1,0,0,1,1,1,0,0,0,0,0,1,0,0,0,1,0,1,0,0
1,0,0,1,1,1,5,53.15,1,53.15,0.02,16,1,2.95,8,8,8,2,5,0
1,0,0,1,1,1,0,0,0,0,0,1,0,0,0,1,0,1,0,0
1,0,1,1,1,1,5,53.15,1,53.15,0.02,16,1,2.95,8,8,8,2,5,0
1,0,0,1,1,1,0,0,0,0,0,3,0,0,0,3,0,3,0,0
1,1,0,1,1,1,4,53.15,1,53.15,0.02,16,1,2.95,8,8,8,2,5,0
1,0,0,1,1,1,0,0,0,0,0,1,0,0,0,1,0,1,0,0
7,1,2,4,3,1,21,23.34,11,2824.34,0.09,56,0.09,156.91,22,34,12,12,22,0
1,0,0,1,1,1,2,5.33,1.5,12,0,4,0.67,0.67,1,3,1,3,2,0
1,0,0,1,1,1,2,5.33,1.5,12,0,4,0.67,0.67,1,3,1,3,2,0
7,1,2,4,2,4,19,17.61,15.36,4156.06,0.09,59,0.07,230.89,26,33,11,13,20,0
1,0,0,1,1,1,0,0,0,0,0,1,0,0,0,1,0,1,0,0
1,1,0,1,1,1,4,53.15,1,53.15,0.02,16,1,2.95,8,8,8,2,5,0
1,0,0,1,1,1,0,0,0,0,0,1,0,0,0,1,0,1,0,0
1,1,0,1,1,1,4,53.15,1,53.15,0.02,16,1,2.95,8,8,8,2,5,0
1,0,0,1,1,1,0,0,0,0,0,1,0,0,0,1,0,1,0,0
1,0,0,1,1,1,5,53.15,1,53.15,0.02,16,1,2.95,8,8,8,2,5,0
1,0,0,1,1,1,0,0,0,0,0,1,0,0,0,1,0,1,0,0
1,1,0,1,1,1,4,53.15,1,53.15,0.02,16,1,2.95,8,8,8,2,5,0
1,0,0,1,1,1,0,0,0,0,0,1,0,0,0,1,0,1,0,0
1,1,0,1,1,1,4,53.15,1,53.15,0.02,16,1,2.95,8,8,8,2,5,0
1,0,0,1,1,1,0,0,0,0,0,1,0,0,0,1,0,1,0,0
1,1,0,1,1,1,4,53.15,1,53.15,0.02,16,1,2.95,8,8,8,2,5,0
1,0,0,1,1,1,0,0,0,0,0,1,0,0,0,1,0,1,0,0
1,1,0,1,1,1,4,53.15,1,53.15,0.02,16,1,2.95,8,8,8,2,5,0
1,0,0,1,1,1,0,0,0,0,0,1,0,0,0,1,0,1,0,0
1,0,0,1,1,1,0,0,0,0,0,1,0,0,0,1,0,1,0,0
1,1,0,1,1,1,4,53.15,1,53.15,0.02,16,1,2.95,8,8,8,2,5,0
1,0,0,1,1,1,0,0,0,0,0,1,0,0,0,1,0,1,0,0
1,0,0,1,1,1,5,53.15,1,53.15,0.02,16,1,2.95,8,8,8,2,5,0
1,0,0,1,1,1,0,0,0,0,0,1,0,0,0,1,0,1,0,0
1,0,0,1,1,1,5,53.15,1,53.15,0.02,16,1,2.95,8,8,8,2,5,0
1,0,0,1,1,1,0,0,0,0,0,1,0,0,0,1,0,1,0,0
1,0,1,1,1,1,5,53.15,1,53.15,0.02,16,1,2.95,8,8,8,2,5,0
1,0,0,1,1,1,0,0,0,0,0,1,0,0,0,1,0,1,0,0
1,0,0,1,1,1,5,53.15,1,53.15,0.02,16,1,2.95,8,8,8,2,5,0
1,0,0,1,1,1,0,0,0,0,0,1,0,0,0,1,0,1,0,0
1,0,0,1,1,1,6,62.27,1.11,76.88,0.02,20,0.9,4.27,10,10,9,2,6,0
1,0,0,1,1,1,0,0,0,0,0,1,0,0,0,1,0,1,0,0
1,0,0,1,1,1,5,53.15,1,53.15,0.02,16,1,2.95,8,8,8,2,5,0
1,0,0,1,1,1,0,0,0,0,0,1,0,0,0,1,0,1,0,0
1,1,0,1,1,1,4,53.15,1,53.15,0.02,16,1,2.95,8,8,8,2,5,0
1,0,0,1,1,1,0,0,0,0,0,1,0,0,0,1,0,1,0,0
1,1,0,1,1,1,4,53.15,1,53.15,0.02,16,1,2.95,8,8,8,2,5,0
1,0,0,1,1,1,0,0,0,0,0,1,0,0,0,1,0,1,0,0
1,1,0,1,1,1,4,53.15,1,53.15,0.02,16,1,2.95,8,8,8,2,5,0
1,0,0,1,1,1,0,0,0,0,0,1,0,0,0,1,0,1,0,0
1,1,0,1,1,1,4,53.15,1,53.15,0.02,16,1,2.95,8,8,8,2,5,0
1,0,0,1,1,1,0,0,0,0,0,1,0,0,0,1,0,1,0,0
1,1,0,1,1,1,4,53.15,1,53.15,0.02,16,1,2.95,8,8,8,2,5,0
1,0,0,1,1,1,0,0,0,0,0,1,0,0,0,1,0,1,0,0
1,0,0,1,1,1,0,0,0,0,0,1,0,0,0,1,0,1,0,0
5,1,3,3,2,1,23,18.65,22,9025.89,0.14,92,0.05,501.44,44,48,11,11,24,0
1,0,0,1,1,1,0,0,0,0,0,1,0,0,0,1,0,1,0,0
1,0,0,1,1,1,3,10.8,2.5,67.5,0.01,9,0.4,3.75,3,6,3,5,3,0
1,0,0,1,1,1,2,7.75,2,31.02,0.01,6,0.5,1.72,2,4,2,4,2,0
3,2,1,2,1,1,9,17.6,5.63,556.83,0.03,26,0.18,30.93,15,11,8,6,11,0
1,0,0,1,1,1,0,5.33,1.5,12,0,4,0.67,0.67,1,3,1,3,0,0
13,2,4,7,6,1,37,23.34,28.93,19537.5,0.23,139,0.03,1085.42,62,77,15,14,39,0
1,0,0,1,1,1,0,0,0,0,0,1,0,0,0,1,0,1,0,0
1,0,0,1,1,1,3,8.43,5.33,239.85,0.01,13,0.19,13.33,4,9,3,8,3,0
1,0,0,1,1,1,3,11.65,4,186.42,0.02,13,0.25,10.36,4,9,4,8,3,0
1,0,0,1,1,1,0,0,0,0,0,1,0,0,0,1,0,1,0,0
1,0,0,1,1,1,0,0,0,0,0,1,0,0,0,1,0,1,0,0
1,0,0,1,1,1,0,5.33,1.5,12,0,4,0.67,0.67,1,3,1,3,0,0
1,0,0,1,1,1,0,5.33,1.5,12,0,4,0.67,0.67,1,3,1,3,0,0
1,0,0,1,1,1,0,0,0,0,0,1,0,0,0,1,0,1,0,0
1,0,0,1,1,1,0,0,0,0,0,1,0,0,0,1,0,1,0,0
1,0,0,1,1,1,2,5.33,1.5,12,0,4,0.67,0.67,1,3,1,3,2,0
1,0,0,1,1,1,2,5.33,1.5,12,0,4,0.67,0.67,1,3,1,3,2,0
1,0,0,1,1,1,0,0,0,0,0,1,0,0,0,1,0,1,0,0
1,0,0,1,1,1,0,0,0,0,0,1,0,0,0,1,0,1,0,0
1,0,0,1,1,1,0,0,0,0,0,1,0,0,0,1,0,1,0,0
1,0,0,1,1,1,0,0,0,0,0,1,0,0,0,1,0,1,0,0
1,0,0,1,1,1,3,10.8,2.5,67.5,0.01,9,0.4,3.75,3,6,3,5,3,0
1,0,0,1,1,1,2,7.75,2,31.02,0.01,6,0.5,1.72,2,4,2,4,2,0
1,0,0,1,1,1,0,5.33,1.5,12,0,4,0.67,0.67,1,3,1,3,0,0
1,0,0,1,1,1,0,0,0,0,0,1,0,0,0,1,0,1,0,0
1,0,0,1,1,1,3,8.43,5.33,239.85,0.01,13,0.19,13.33,4,9,3,8,3,0
1,0,0,1,1,1,3,11.65,4,186.42,0.02,13,0.25,10.36,4,9,4,8,3,0
1,0,0,1,1,1,0,0,0,0,0,1,0,0,0,1,0,1,0,0
1,0,0,1,1,1,0,0,0,0,0,1,0,0,0,1,0,1,0,0
1,0,0,1,1,1,0,5.33,1.5,12,0,4,0.67,0.67,1,3,1,3,0,0
1,0,0,1,1,1,0,5.33,1.5,12,0,4,0.67,0.67,1,3,1,3,0,0
1,0,0,1,1,1,0,0,0,0,0,1,0,0,0,1,0,1,0,0
1,0,0,1,1,1,0,0,0,0,0,1,0,0,0,1,0,1,0,0
1,0,0,1,1,1,5,53.15,1,53.15,0.02,16,1,2.95,8,8,8,2,5,0
1,0,0,1,1,1,0,0,0,0,0,1,0,0,0,1,0,1,0,0
1,0,0,1,1,1,5,53.15,1,53.15,0.02,16,1,2.95,8,8,8,2,5,0
1,0,0,1,1,1,0,0,0,0,0,1,0,0,0,1,0,1,0,0
1,0,0,1,1,1,5,53.15,1,53.15,0.02,16,1,2.95,8,8,8,2,5,0
1,0,0,1,1,1,0,0,0,0,0,1,0,0,0,1,0,1,0,0
1,0,0,1,1,1,5,53.15,1,53.15,0.02,16,1,2.95,8,8,8,2,5,0
1,0,0,1,1,1,0,0,0,0,0,1,0,0,0,1,0,1,0,0
1,0,0,1,1,1,5,53.15,1,53.15,0.02,16,1,2.95,8,8,8,2,5,0
1,0,0,1,1,1,0,0,0,0,0,1,0,0,0,1,0,1,0,0
1,0,0,1,1,1,5,53.15,1,53.15,0.02,16,1,2.95,8,8,8,2,5,0
1,0,0,1,1,1,0,0,0,0,0,1,0,0,0,1,0,1,0,0
1,0,1,1,1,1,5,53.15,1,53.15,0.02,16,1,2.95,8,8,8,2,5,0
1,0,0,1,1,1,0,0,0,0,0,3,0,0,0,3,0,3,0,0
1,1,0,1,1,1,4,53.15,1,53.15,0.02,16,1,2.95,8,8,8,2,5,0
1,0,0,1,1,1,0,0,0,0,0,1,0,0,0,1,0,1,0,0
1,0,0,1,1,1,2,5.33,1.5,12,0,4,0.67,0.67,1,3,1,3,2,0
1,0,0,1,1,1,2,5.33,1.5,12,0,4,0.67,0.67,1,3,1,3,2,0
1,0,0,1,1,1,0,0,0,0,0,1,0,0,0,1,0,1,0,0
1,1,0,1,1,1,4,53.15,1,53.15,0.02,16,1,2.95,8,8,8,2,5,0
1,0,0,1,1,1,0,0,0,0,0,1,0,0,0,1,0,1,0,0
1,1,0,1,1,1,4,53.15,1,53.15,0.02,16,1,2.95,8,8,8,2,5,0
1,0,0,1,1,1,0,0,0,0,0,1,0,0,0,1,0,1,0,0
1,0,0,1,1,1,5,53.15,1,53.15,0.02,16,1,2.95,8,8,8,2,5,0
1,0,0,1,1,1,0,0,0,0,0,1,0,0,0,1,0,1,0,0
1,1,0,1,1,1,4,53.15,1,53.15,0.02,16,1,2.95,8,8,8,2,5,0
1,0,0,1,1,1,0,0,0,0,0,1,0,0,0,1,0,1,0,0
1,1,0,1,1,1,4,53.15,1,53.15,0.02,16,1,2.95,8,8,8,2,5,0
1,0,0,1,1,1,0,0,0,0,0,1,0,0,0,1,0,1,0,0
1,1,0,1,1,1,4,53.15,1,53.15,0.02,16,1,2.95,8,8,8,2,5,0
1,0,0,1,1,1,0,0,0,0,0,1,0,0,0,1,0,1,0,0
1,1,0,1,1,1,4,53.15,1,53.15,0.02,16,1,2.95,8,8,8,2,5,0
1,0,0,1,1,1,0,0,0,0,0,1,0,0,0,1,0,1,0,0
1,0,0,1,1,1,0,0,0,0,0,1,0,0,0,1,0,1,0,0
1,1,0,1,1,1,4,53.15,1,53.15,0.02,16,1,2.95,8,8,8,2,5,0
1,0,0,1,1,1,0,0,0,0,0,1,0,0,0,1,0,1,0,0
1,0,0,1,1,1,5,53.15,1,53.15,0.02,16,1,2.95,8,8,8,2,5,0
1,0,0,1,1,1,0,0,0,0,0,1,0,0,0,1,0,1,0,0
1,0,0,1,1,1,5,53.15,1,53.15,0.02,16,1,2.95,8,8,8,2,5,0
1,0,0,1,1,1,0,0,0,0,0,1,0,0,0,1,0,1,0,0
1,0,1,1,1,1,5,53.15,1,53.15,0.02,16,1,2.95,8,8,8,2,5,0
1,0,0,1,1,1,0,0,0,0,0,1,0,0,0,1,0,1,0,0
1,0,0,1,1,1,5,53.15,1,53.15,0.02,16,1,2.95,8,8,8,2,5,0
1,0,0,1,1,1,0,0,0,0,0,1,0,0,0,1,0,1,0,0
1,0,0,1,1,1,6,62.27,1.11,76.88,0.02,20,0.9,4.27,10,10,9,2,6,0
1,0,0,1,1,1,0,0,0,0,0,1,0,0,0,1,0,1,0,0
1,0,0,1,1,1,5,53.15,1,53.15,0.02,16,1,2.95,8,8,8,2,5,0
1,0,0,1,1,1,0,0,0,0,0,1,0,0,0,1,0,1,0,0
1,1,0,1,1,1,4,53.15,1,53.15,0.02,16,1,2.95,8,8,8,2,5,0
1,0,0,1,1,1,0,0,0,0,0,1,0,0,0,1,0,1,0,0
1,1,0,1,1,1,4,53.15,1,53.15,0.02,16,1,2.95,8,8,8,2,5,0
1,0,0,1,1,1,0,0,0,0,0,1,0,0,0,1,0,1,0,0
1,1,0,1,1,1,4,53.15,1,53.15,0.02,16,1,2.95,8,8,8,2,5,0
1,0,0,1,1,1,0,0,0,0,0,1,0,0,0,1,0,1,0,0
1,1,0,1,1,1,4,53.15,1,53.15,0.02,16,1,2.95,8,8,8,2,5,0
1,0,0,1,1,1,0,0,0,0,0,1,0,0,0,1,0,1,0,0
1,1,0,1,1,1,4,53.15,1,53.15,0.02,16,1,2.95,8,8,8,2,5,0
1,0,0,1,1,1,0,0,0,0,0,1,0,0,0,1,0,1,0,0
1,0,0,1,1,1,0,0,0,0,0,1,0,0,0,1,0,1,0,0
1,0,0,1,1,1,0,0,0,0,0,1,0,0,0,1,0,1,0,0
1,0,0,1,1,1,3,10.8,2.5,67.5,0.01,9,0.4,3.75,3,6,3,5,3,0
1,0,0,1,1,1,2,7.75,2,31.02,0.01,6,0.5,1.72,2,4,2,4,2,0
1,0,0,1,1,1,0,5.33,1.5,12,0,4,0.67,0.67,1,3,1,3,0,0
1,0,0,1,1,1,1,0,0,0,0,1,0,0,0,1,0,1,1,0
1,0,0,1,1,1,1,0,0,0,0,1,0,0,0,1,0,1,1,0
1,0,0,1,1,1,1,0,0,0,0,1,0,0,0,1,0,1,1,0
1,0,0,1,1,1,1,0,0,0,0,1,0,0,0,1,0,1,1,0
1,0,0,1,1,1,1,0,0,0,0,1,0,0,0,1,0,1,1,0
1,0,0,1,1,1,2,5.33,1.5,12,0,4,0.67,0.67,1,3,1,3,2,0
1,0,0,1,1,1,2,5.33,1.5,12,0,4,0.67,0.67,1,3,1,3,2,0
1,0,0,1,1,1,2,5.33,1.5,12,0,4,0.67,0.67,1,3,1,3,2,0
1,0,0,1,1,1,2,5.33,1.5,12,0,4,0.67,0.67,1,3,1,3,2,0
1,0,0,1,1,1,2,5.33,1.5,12,0,4,0.67,0.67,1,3,1,3,2,0
1,0,0,1,1,1,2,5.33,1.5,12,0,4,0.67,0.67,1,3,1,3,2,0
1,0,0,1,1,1,2,5.33,1.5,12,0,4,0.67,0.67,1,3,1,3,2,0
1,0,0,1,1,1,2,5.33,1.5,12,0,4,0.67,0.67,1,3,1,3,2,0
1,0,0,1,1,1,3,13.29,3,119.59,0.01,12,0.33,6.64,4,8,4,6,3,1
1,0,0,1,1,1,3,13.29,3,119.59,0.01,12,0.33,6.64,4,8,4,6,3,1
1,0,0,1,1,1,3,13.29,3,119.59,0.01,12,0.33,6.64,4,8,4,6,3,1
1,0,0,1,1,1,3,13.29,3,119.59,0.01,12,0.33,6.64,4,8,4,6,3,1
1,0,0,1,1,1,1,0,0,0,0,0,0,0,0,0,0,0,1,0
1,0,0,1,1,1,1,0,0,0,0,1,0,0,0,1,0,1,1,0
1,0,0,1,1,1,2,5.33,1.5,12,0,4,0.67,0.67,1,3,1,3,2,0
1,0,0,1,1,1,2,5.33,1.5,12,0,4,0.67,0.67,1,3,1,3,2,0
1,9,0,1,1,1,2,0,0,0,0,9,0,0,9,0,1,0,11,0
1,0,0,1,1,1,1,0,0,0,0,0,0,0,0,0,0,0,1,0
1,0,0,1,1,1,1,0,0,0,0,0,0,0,0,0,0,0,1,0
1,0,0,1,1,1,1,0,0,0,0,1,0,0,0,1,0,1,1,0
1,0,0,1,1,1,4,18.49,2.4,106.51,0.01,14,0.42,5.92,6,8,5,4,4,0
1,0,0,1,1,1,2,5.33,1.5,12,0,4,0.67,0.67,1,3,1,3,2,0
1,0,0,1,1,1,5,8.45,0.75,4.75,0,4,1.33,0.26,3,1,2,1,5,0
1,0,0,1,1,1,1,0,0,0,0,0,0,0,0,0,0,0,1,0
1,0,0,1,1,1,1,0,0,0,0,1,0,0,0,1,0,1,1,0
1,0,0,1,1,1,3,10.8,2.5,67.5,0.01,9,0.4,3.75,3,6,3,5,3,0
1,0,0,1,1,1,2,5.33,1.5,12,0,4,0.67,0.67,1,3,1,3,2,0
1,0,0,1,1,1,2,6.2,2.5,38.77,0.01,6,0.4,2.15,1,5,1,5,2,0
1,0,0,1,1,1,4,9.51,0.5,2.38,0,3,2,0.13,2,1,2,1,4,0
1,0,0,1,1,1,4,16.14,3.5,197.65,0.02,17,0.29,10.98,7,10,5,5,4,0
1,0,0,1,1,1,1,0,0,0,0,1,0,0,0,1,0,1,1,0
1,0,0,1,1,1,2,8.98,2.5,56.15,0.01,8,0.4,3.12,2,6,2,5,2,0
1,0,0,1,1,1,3,10.44,3.5,127.89,0.01,11,0.29,7.11,3,8,3,7,3,0
1,0,0,1,1,1,2,10.57,3,95.1,0.01,10,0.33,5.28,3,7,3,6,2,0
1,0,0,1,1,1,2,8.98,2.5,56.15,0.01,8,0.4,3.12,2,6,2,5,2,0
1,0,0,1,1,1,2,10.57,3,95.1,0.01,10,0.33,5.28,3,7,3,6,2,0
1,0,0,1,1,1,2,10.57,3,95.1,0.01,10,0.33,5.28,3,7,3,6,2,0
1,0,0,1,1,1,3,13.29,3,119.59,0.01,12,0.33,6.64,4,8,4,6,3,0
1,0,0,1,1,1,3,13.29,3,119.59,0.01,12,0.33,6.64,4,8,4,6,3,0
1,0,0,1,1,1,3,13.29,3,119.59,0.01,12,0.33,6.64,4,8,4,6,3,0
1,0,0,1,1,1,2,10.57,3,95.1,0.01,10,0.33,5.28,3,7,3,6,2,0
1,0,0,1,1,1,2,8.98,2.5,56.15,0.01,8,0.4,3.12,2,6,2,5,2,0
1,0,0,1,1,1,2,10.44,3.5,127.89,0.01,11,0.29,7.11,3,8,3,7,2,0
1,0,0,1,1,1,2,10.57,3,95.1,0.01,10,0.33,5.28,3,7,3,6,2,0
1,0,0,1,1,1,2,10.44,3.5,127.89,0.01,11,0.29,7.11,3,8,3,7,2,0
1,0,0,1,1,1,2,10.57,3,95.1,0.01,10,0.33,5.28,3,7,3,6,2,1
1,0,0,1,1,1,0,0,0,0,0,1,0,0,0,1,0,1,0,0
1,0,0,1,1,1,0,0,0,0,0,1,0,0,0,1,0,1,0,0
1,0,0,1,1,1,0,0,0,0,0,1,0,0,0,1,0,1,0,0
1,0,0,1,1,1,0,0,0,0,0,0,0,0,0,0,0,0,0,0
3,0,0,2,1,1,11,17.72,3,159.45,0.02,16,0.33,8.86,6,10,5,5,11,1
1,0,0,1,1,1,2,5.33,1.5,12,0,4,0.67,0.67,1,3,1,3,2,0
1,0,0,1,1,1,2,5.33,1.5,12,0,4,0.67,0.67,1,3,1,3,2,0
1,0,0,1,1,1,2,5.33,1.5,12,0,4,0.67,0.67,1,3,1,3,2,0
1,0,0,1,1,1,2,5.33,1.5,12,0,4,0.67,0.67,1,3,1,3,2,0
1,0,0,1,1,1,2,5.33,1.5,12,0,4,0.67,0.67,1,3,1,3,2,0
1,0,0,1,1,1,2,5.33,1.5,12,0,4,0.67,0.67,1,3,1,3,2,0
1,0,0,1,1,1,2,5.33,1.5,12,0,4,0.67,0.67,1,3,1,3,2,0
1,0,0,1,1,1,2,7.86,2.5,49.13,0.01,7,0.4,2.73,2,5,2,5,2,0
1,0,0,1,1,1,2,5.33,1.5,12,0,4,0.67,0.67,1,3,1,3,2,0
1,0,0,1,1,1,2,7.74,1.5,17.41,0,5,0.67,0.97,2,3,2,3,2,0
1,0,0,1,1,1,2,7.74,1.5,17.41,0,5,0.67,0.97,2,3,2,3,2,0
1,0,0,1,1,1,2,7.74,1.5,17.41,0,5,0.67,0.97,2,3,2,3,2,0
1,0,0,1,1,1,2,7.74,1.5,17.41,0,5,0.67,0.97,2,3,2,3,2,0
1,0,0,1,1,1,2,7.74,1.5,17.41,0,5,0.67,0.97,2,3,2,3,2,0
1,0,0,1,1,1,2,6.97,2,27.86,0,6,0.5,1.55,1,5,1,4,2,0
1,0,0,1,1,1,2,8.98,2.5,56.15,0.01,8,0.4,3.12,2,6,2,5,2,1
3,2,0,2,2,1,8,13.88,6.4,568.39,0.03,24,0.16,31.58,8,16,5,8,10,1
1,0,0,1,1,1,2,9.05,2,36.19,0.01,7,0.5,2,2,5,2,4,2,0
11,3,0,6,5,1,25,22.53,15.4,5343.69,0.12,79,0.06,296.87,28,51,10,11,28,0
1,0,0,1,1,1,2,6.2,2.5,38.77,0.01,6,0.4,2.15,1,5,1,5,2,0
1,0,0,1,1,1,2,5.33,1.5,12,0,4,0.67,0.67,1,3,1,3,2,0
1,0,0,1,1,1,2,10.8,2.5,67.5,0.01,9,0.4,3.75,3,6,3,5,2,0
1,0,0,1,1,1,2,6.2,2.5,38.77,0.01,6,0.4,2.15,1,5,1,5,2,0
1,0,0,1,1,1,2,5.33,1.5,12,0,4,0.67,0.67,1,3,1,3,2,0
1,0,0,1,1,1,2,9.6,2.5,60,0.01,8,0.4,3.33,3,5,3,5,2,0
1,0,0,1,1,1,2,9.6,2.5,60,0.01,8,0.4,3.33,3,5,3,5,2,0
1,0,0,1,1,1,2,9.05,2,36.19,0.01,7,0.5,2,2,5,2,4,2,1
1,0,0,1,1,1,2,9.05,2,36.19,0.01,7,0.5,2,2,5,2,4,2,1
5,2,0,3,2,1,11,14.77,8.75,1131.09,0.04,31,0.11,62.84,14,17,8,10,13,1
1,0,0,1,1,1,2,10.8,2.5,67.5,0.01,9,0.4,3.75,3,6,3,5,2,1
1,0,0,1,1,1,2,10.8,2.5,67.5,0.01,9,0.4,3.75,3,6,3,5,2,1
1,0,0,1,1,1,2,13.95,2.5,87.17,0.01,11,0.4,4.84,4,7,4,5,2,0
1,0,0,1,1,1,2,13.95,2.5,87.17,0.01,11,0.4,4.84,4,7,4,5,2,0
1,0,0,1,1,1,2,10.8,2.5,67.5,0.01,9,0.4,3.75,3,6,3,5,2,1
1,0,0,1,1,1,1,0,0,0,0,1,0,0,0,1,0,1,1,0
1,0,0,1,1,1,1,0,0,0,0,1,0,0,0,1,0,1,1,0
1,0,0,1,1,1,1,0,0,0,0,1,0,0,0,1,0,1,1,0
1,0,0,1,1,1,1,0,0,0,0,1,0,0,0,1,0,1,1,0
5,0,0,3,1,1,2,13.29,4.5,269.08,0.02,18,0.22,14.95,6,12,4,6,2,0
1,0,1,1,1,1,2,16.92,3.5,207.22,0.02,16,0.29,11.51,6,10,6,7,2,0
3,1,0,2,2,1,6,14.15,7.58,813.79,0.04,29,0.13,45.21,13,16,6,7,7,1
1,0,0,1,1,1,2,5.33,1.5,12,0,4,0.67,0.67,1,3,1,3,2,0
1,0,0,1,1,1,2,5.33,1.5,12,0,4,0.67,0.67,1,3,1,3,2,0
1,0,0,1,1,1,2,5.33,1.5,12,0,4,0.67,0.67,1,3,1,3,2,0
1,0,0,1,1,1,2,5.33,1.5,12,0,4,0.67,0.67,1,3,1,3,2,0
1,0,0,1,1,1,2,5.33,1.5,12,0,4,0.67,0.67,1,3,1,3,2,0
1,0,0,1,1,1,2,5.33,1.5,12,0,4,0.67,0.67,1,3,1,3,2,0
1,0,0,1,1,1,2,5.33,1.5,12,0,4,0.67,0.67,1,3,1,3,2,0
1,0,0,1,1,1,2,5.33,1.5,12,0,4,0.67,0.67,1,3,1,3,2,0
1,0,0,1,1,1,2,6.67,4.5,135,0.01,10,0.22,7.5,3,7,2,6,2,0
1,0,0,1,1,1,2,7.74,1.5,17.41,0,5,0.67,0.97,2,3,2,3,2,0
1,0,0,1,1,1,2,7.74,1.5,17.41,0,5,0.67,0.97,2,3,2,3,2,0
1,0,0,1,1,1,1,0,0,0,0,0,0,0,0,0,0,0,1,0
1,0,0,1,1,1,1,0,0,0,0,1,0,0,0,1,0,1,1,0
1,0,0,1,1,1,2,5.33,1.5,12,0,4,0.67,0.67,1,3,1,3,2,0
1,0,0,1,1,1,2,5.33,1.5,12,0,4,0.67,0.67,1,3,1,3,2,0
1,9,0,1,1,1,2,0,0,0,0,9,0,0,9,0,1,0,11,0
1,0,0,1,1,1,1,0,0,0,0,0,0,0,0,0,0,0,1,0
1,0,0,1,1,1,1,0,0,0,0,0,0,0,0,0,0,0,1,0
1,0,0,1,1,1,1,0,0,0,0,1,0,0,0,1,0,1,1,0
1,0,0,1,1,1,4,18.49,2.4,106.51,0.01,14,0.42,5.92,6,8,5,4,4,0
1,0,0,1,1,1,2,5.33,1.5,12,0,4,0.67,0.67,1,3,1,3,2,0
1,0,0,1,1,1,5,8.45,0.75,4.75,0,4,1.33,0.26,3,1,2,1,5,0
1,0,0,1,1,1,1,0,0,0,0,0,0,0,0,0,0,0,1,0
1,0,0,1,1,1,1,0,0,0,0,1,0,0,0,1,0,1,1,0
1,0,0,1,1,1,3,10.8,2.5,67.5,0.01,9,0.4,3.75,3,6,3,5,3,0
1,0,0,1,1,1,2,5.33,1.5,12,0,4,0.67,0.67,1,3,1,3,2,0
1,0,0,1,1,1,2,6.2,2.5,38.77,0.01,6,0.4,2.15,1,5,1,5,2,0
1,0,0,1,1,1,4,9.51,0.5,2.38,0,3,2,0.13,2,1,2,1,4,0
1,0,0,1,1,1,1,0,0,0,0,1,0,0,0,1,0,1,1,0
1,0,0,1,1,1,0,0,0,0,0,1,0,0,0,1,0,1,0,0
1,0,0,1,1,1,0,0,0,0,0,1,0,0,0,1,0,1,0,0
1,0,0,1,1,1,0,0,0,0,0,1,0,0,0,1,0,1,0,0
1,0,0,1,1,1,0,0,0,0,0,0,0,0,0,0,0,0,0,0
15,14,0,8,5,1,32,32.54,14.62,6962.7,0.16,98,0.07,386.82,36,62,16,13,46,0
18,15,0,11,7,1,47,33.7,20.6,14305.96,0.23,125,0.05,794.78,43,82,24,23,62,0
23,11,0,12,3,10,25,27.51,21.36,12556.75,0.2,109,0.05,697.6,47,62,22,20,36,1
1,0,0,1,1,1,2,5.8,2,23.22,0,5,0.5,1.29,1,4,1,4,2,0
3,0,0,2,2,1,6,10.3,4,164.84,0.01,13,0.25,9.16,4,9,3,6,6,0
3,2,1,2,2,1,8,15.9,5.79,532.29,0.03,23,0.17,29.57,9,14,7,9,10,0
5,2,0,3,2,1,11,20.53,6.5,867.34,0.04,32,0.15,48.19,13,19,9,9,13,0
15,7,2,8,6,1,33,40.89,12.69,6585.36,0.17,102,0.08,365.85,41,61,21,13,40,1
5,2,0,3,3,1,11,20.31,6,731.01,0.04,32,0.17,40.61,12,20,7,7,13,0
1,0,0,1,1,1,2,5.8,2,23.22,0,5,0.5,1.29,1,4,1,4,2,0
3,0,0,2,2,1,5,8,4.5,162,0.01,12,0.22,9,3,9,2,6,5,0
3,1,0,2,2,1,5,10.3,4,164.84,0.01,13,0.25,9.16,4,9,3,6,6,0
5,1,0,3,2,1,6,11.2,5.25,308.75,0.02,17,0.19,17.15,6,11,4,7,7,0
1,0,0,1,1,1,2,6.2,2.5,38.77,0.01,6,0.4,2.15,1,5,1,5,2,0
1,0,0,1,1,1,2,5.33,1.5,12,0,4,0.67,0.67,1,3,1,3,2,0
1,0,0,1,1,1,2,9.6,2.5,60,0.01,8,0.4,3.33,3,5,3,5,2,0
1,0,0,1,1,1,2,9.6,2.5,60,0.01,8,0.4,3.33,3,5,3,5,2,0
7,20,0,4,1,3,11,66.84,11.85,9380.22,0.26,152,0.08,521.12,56,96,26,11,31,0
5,0,0,3,1,1,2,13.29,4.5,269.08,0.02,18,0.22,14.95,6,12,4,6,2,0
1,0,1,1,1,1,2,16.92,3.5,207.22,0.02,16,0.29,11.51,6,10,6,7,2,0
1,0,0,1,1,1,2,0,0,0,0,5,0,0,0,5,0,5,2,0
1,0,0,1,1,1,0,0,0,0,0,1,0,0,0,1,0,1,0,0
1,0,0,1,1,1,2,0,0,0,0.01,6,0,0,0,6,0,6,2,0
1,0,0,1,1,1,0,0,0,0,0,1,0,0,0,1,0,1,0,0
5,1,1,3,1,1,10,10.16,10,1015.79,0.03,26,0.1,56.43,10,16,5,10,11,0
1,0,0,1,1,1,2,5.33,1.5,12,0,4,0.67,0.67,1,3,1,3,2,0
1,0,0,1,1,1,2,8,3,72,0.01,8,0.33,4,2,6,2,6,2,0
5,2,0,3,1,1,11,15.25,7.43,841.66,0.04,29,0.13,46.76,13,16,7,8,13,0
9,1,0,5,1,5,9,17.95,7.94,1133.07,0.05,33,0.13,62.95,13,20,9,11,10,0
17,1,0,9,1,9,13,23.84,10,2384.18,0.08,52,0.1,132.45,20,32,12,12,14,0
1,0,0,1,1,1,2,0,0,0,0,5,0,0,0,5,0,5,2,0
1,0,0,1,1,1,0,0,0,0,0,1,0,0,0,1,0,1,0,0
1,0,0,1,1,1,2,0,0,0,0.01,6,0,0,0,6,0,6,2,0
1,0,0,1,1,1,2,7.75,2,31.02,0.01,6,0.5,1.72,2,4,2,4,2,0
1,0,0,1,1,1,2,7.74,1.5,17.41,0,5,0.67,0.97,2,3,2,3,2,0
1,1,1,1,1,1,1,0,0,0,0,1,0,0,1,0,1,0,2,0
3,1,0,2,1,1,7,12.44,4.9,298.63,0.02,17,0.2,16.59,7,10,5,7,8,0
1,0,0,1,1,1,2,10.44,3.5,127.89,0.01,11,0.29,7.11,3,8,3,7,2,0
1,0,0,1,1,1,2,7.49,3,67.38,0.01,8,0.33,3.74,1,7,1,6,2,0
1,0,0,1,1,1,2,9,3,81,0.01,9,0.33,4.5,2,7,2,6,2,0
1,0,0,1,1,1,2,9,3,81,0.01,9,0.33,4.5,2,7,2,6,2,0
1,0,0,1,1,1,2,9,3,81,0.01,9,0.33,4.5,2,7,2,6,2,0
1,0,0,1,1,1,2,10.44,3.5,127.89,0.01,11,0.29,7.11,3,8,3,7,2,0
1,0,0,1,1,1,2,9,3,81,0.01,9,0.33,4.5,2,7,2,6,2,0
1,0,0,1,1,1,2,9,3,81,0.01,9,0.33,4.5,2,7,2,6,2,0
1,0,0,1,1,1,2,7.49,3,67.38,0.01,8,0.33,3.74,1,7,1,6,2,0
1,0,0,1,1,1,2,7.49,3,67.38,0.01,8,0.33,3.74,1,7,1,6,2,0
1,0,0,1,1,1,2,10,3,90,0.01,10,0.33,5,2,8,2,6,2,0
1,0,0,1,1,1,3,10.44,3.5,127.89,0.01,11,0.29,7.11,3,8,3,7,3,0
1,0,0,1,1,1,3,11.39,3.5,139.52,0.01,12,0.29,7.75,3,9,3,7,3,0
1,0,0,1,1,1,2,9,3,81,0.01,9,0.33,4.5,2,7,2,6,2,0
1,0,0,1,1,1,2,10.44,3.5,127.89,0.01,11,0.29,7.11,3,8,3,7,2,0
1,0,0,1,1,1,2,9,3,81,0.01,9,0.33,4.5,2,7,2,6,2,0
1,0,0,1,1,1,2,9,3,81,0.01,9,0.33,4.5,2,7,2,6,2,0
1,0,0,1,1,1,2,10.44,3.5,127.89,0.01,11,0.29,7.11,3,8,3,7,2,0
1,0,0,1,1,1,2,9,3,81,0.01,9,0.33,4.5,2,7,2,6,2,0
1,0,0,1,1,1,2,9,3,81,0.01,9,0.33,4.5,2,7,2,6,2,0
1,0,0,1,1,1,2,9,3,81,0.01,9,0.33,4.5,2,7,2,6,2,0
1,0,0,1,1,1,2,7.49,3,67.38,0.01,8,0.33,3.74,1,7,1,6,2,0
1,0,0,1,1,1,2,9,3,81,0.01,9,0.33,4.5,2,7,2,6,2,0
1,0,0,1,1,1,2,9,3,81,0.01,9,0.33,4.5,2,7,2,6,2,0
1,0,0,1,1,1,2,10.44,3.5,127.89,0.01,11,0.29,7.11,3,8,3,7,2,0
1,0,0,1,1,1,2,9.05,2,36.19,0.01,7,0.5,2,2,5,2,4,2,0
1,0,0,1,1,1,2,9.05,2,36.19,0.01,7,0.5,2,2,5,2,4,2,0
1,0,0,1,1,1,2,9.05,2,36.19,0.01,7,0.5,2,2,5,2,4,2,0
1,0,0,1,1,1,2,9.05,2,36.19,0.01,7,0.5,2,2,5,2,4,2,0
1,0,0,1,1,1,2,9.05,2,36.19,0.01,7,0.5,2,2,5,2,4,2,0
1,0,0,1,1,1,2,9.05,2,36.19,0.01,7,0.5,2,2,5,2,4,2,0
1,0,0,1,1,1,2,9.05,2,36.19,0.01,7,0.5,2,2,5,2,4,2,0
1,0,0,1,1,1,2,9.05,2,36.19,0.01,7,0.5,2,2,5,2,4,2,0
1,0,0,1,1,1,2,9.05,2,36.19,0.01,7,0.5,2,2,5,2,4,2,0
1,0,0,1,1,1,2,9.05,2,36.19,0.01,7,0.5,2,2,5,2,4,2,0
1,0,0,1,1,1,2,9.05,2,36.19,0.01,7,0.5,2,2,5,2,4,2,0
1,0,0,1,1,1,2,9.05,2,36.19,0.01,7,0.5,2,2,5,2,4,2,0
1,0,0,1,1,1,2,9.05,2,36.19,0.01,7,0.5,2,2,5,2,4,2,0
1,0,0,1,1,1,2,10.44,3.5,127.89,0.01,11,0.29,7.11,3,8,3,7,2,0
1,0,0,1,1,1,2,10.44,3.5,127.89,0.01,11,0.29,7.11,3,8,3,7,2,0
1,0,0,1,1,1,2,9.05,2,36.19,0.01,7,0.5,2,2,5,2,4,2,0
1,0,0,1,1,1,0,0,0,0,0,1,0,0,0,1,0,1,0,0
1,0,0,1,1,1,2,5.33,1.5,12,0,4,0.67,0.67,1,3,1,3,2,0
3,0,0,2,1,1,6,11.86,4.38,227.03,0.02,15,0.23,12.61,5,10,4,7,6,0
3,2,0,2,1,1,6,14.43,5.14,381.76,0.02,19,0.19,21.21,9,10,7,8,8,0
5,1,0,3,1,1,10,12.67,10,1267.11,0.04,31,0.1,70.4,14,17,7,10,11,0
3,1,0,2,1,1,6,11.71,4.9,281.06,0.02,16,0.2,15.61,7,9,5,7,7,0
3,1,0,2,1,1,6,11.71,4.9,281.06,0.02,16,0.2,15.61,7,9,5,7,7,0
1,0,0,1,1,1,2,5.33,1.5,12,0,4,0.67,0.67,1,3,1,3,2,0
1,0,0,1,1,1,2,5.33,1.5,12,0,4,0.67,0.67,1,3,1,3,2,0
3,1,0,2,1,1,6,11.23,5.6,352.28,0.02,17,0.18,19.57,7,10,5,8,7,0
7,1,1,4,1,3,13,18.91,10.45,2065.48,0.07,45,0.1,114.75,19,26,10,11,14,0
5,1,0,3,1,1,10,13.33,9,1080,0.04,30,0.11,60,14,16,7,9,11,0
3,1,0,2,1,1,6,11.71,4.9,281.06,0.02,16,0.2,15.61,7,9,5,7,7,0
7,1,1,4,1,3,13,18.91,10.45,2065.48,0.07,45,0.1,114.75,19,26,10,11,14,0
3,1,0,2,1,1,6,11.71,4.9,281.06,0.02,16,0.2,15.61,7,9,5,7,7,0
3,0,0,2,1,1,6,11.86,4.38,227.03,0.02,15,0.23,12.61,5,10,4,7,6,0
3,2,0,2,1,1,7,16.73,5.5,506,0.03,23,0.18,28.11,11,12,8,8,9,0
1,0,0,1,1,1,2,5.33,1.5,12,0,4,0.67,0.67,1,3,1,3,2,0
9,6,0,5,1,1,14,23.12,11.15,2875.94,0.09,57,0.09,159.77,29,28,13,10,20,0
3,1,0,2,1,1,7,14.43,5.14,381.76,0.02,19,0.19,21.21,9,10,7,8,8,0
7,1,1,4,1,3,13,19.62,10,1962.15,0.07,44,0.1,109.01,20,24,11,11,14,0
1,0,0,1,1,1,2,5.33,1.5,12,0,4,0.67,0.67,1,3,1,3,2,0
1,0,0,1,1,1,2,5.33,1.5,12,0,4,0.67,0.67,1,3,1,3,2,0
1,0,0,1,1,1,2,5.33,1.5,12,0,4,0.67,0.67,1,3,1,3,2,0
1,0,0,1,1,1,2,5.33,1.5,12,0,4,0.67,0.67,1,3,1,3,2,0
1,0,0,1,1,1,2,5.33,1.5,12,0,4,0.67,0.67,1,3,1,3,2,0
1,0,0,1,1,1,2,5.33,1.5,12,0,4,0.67,0.67,1,3,1,3,2,0
1,0,0,1,1,1,2,5.33,1.5,12,0,4,0.67,0.67,1,3,1,3,2,0
3,1,0,2,1,1,5,10.95,6,394.38,0.02,19,0.17,21.91,10,9,5,6,6,0
3,1,0,2,1,1,5,10.95,6,394.38,0.02,19,0.17,21.91,10,9,5,6,6,0
3,1,0,2,1,1,5,10.95,6,394.38,0.02,19,0.17,21.91,10,9,5,6,6,0
3,1,0,2,1,1,5,10.95,6,394.38,0.02,19,0.17,21.91,10,9,5,6,6,0
3,1,1,2,1,1,5,10.95,6,394.38,0.02,19,0.17,21.91,10,9,5,6,6,0
1,0,0,1,1,1,3,13,3,117,0.01,13,0.33,6.5,6,7,4,4,3,0
1,0,0,1,1,1,2,11.07,3,99.66,0.01,10,0.33,5.54,4,6,4,6,2,0
1,0,0,1,1,1,2,7.74,1.5,17.41,0,5,0.67,0.97,2,3,2,3,2,0
3,0,1,2,1,1,8,16.92,4.5,342.66,0.03,20,0.22,19.04,9,11,7,7,8,0
3,1,0,2,1,1,7,16.92,4.5,342.66,0.03,20,0.22,19.04,9,11,7,7,8,0
1,0,0,1,1,1,2,11.41,2.5,71.32,0.01,9,0.4,3.96,4,5,4,5,2,0
3,1,0,2,1,1,5,10.95,6,394.38,0.02,19,0.17,21.91,10,9,5,6,6,0
1,0,0,1,1,1,4,16.51,4.8,380.39,0.03,25,0.21,21.13,12,13,5,4,4,0
1,0,0,1,1,1,2,7.74,1.5,17.41,0,5,0.67,0.97,2,3,2,3,2,0
3,1,0,2,1,1,5,10.95,6,394.38,0.02,19,0.17,21.91,10,9,5,6,6,0
3,1,0,2,1,1,5,10.95,6,394.38,0.02,19,0.17,21.91,10,9,5,6,6,0
1,0,0,1,1,1,2,9.83,2,39.3,0.01,7,0.5,2.18,3,4,3,4,2,0
1,0,0,1,1,1,0,0,0,0,0,1,0,0,0,1,0,1,0,0
7,1,1,4,3,1,14,21.78,10.38,2348.77,0.08,50,0.1,130.49,27,23,13,10,15,1
5,0,0,3,1,1,2,13.29,4.5,269.08,0.02,18,0.22,14.95,6,12,4,6,2,0
1,0,1,1,1,1,2,16.92,3.5,207.22,0.02,16,0.29,11.51,6,10,6,7,2,0
13,3,0,7,2,1,28,16.85,20.68,7206.73,0.12,76,0.05,400.37,35,41,11,13,31,0
11,4,2,6,3,1,25,19.33,22.5,9787.5,0.15,87,0.04,543.75,35,52,14,18,29,1
1,0,0,1,1,1,2,0,0,0,0,5,0,0,0,5,0,5,2,0
1,0,0,1,1,1,0,0,0,0,0,5,0,0,0,5,0,5,0,0
1,0,0,1,1,1,0,0,0,0,0,5,0,0,0,5,0,5,0,0
1,0,0,1,1,1,0,0,0,0,0,1,0,0,0,1,0,1,0,0
1,0,0,1,1,1,2,0,0,0,0.01,6,0,0,0,6,0,6,2,0
29,20,9,15,15,9,114,51.66,71.68,265483.2,1.23,622,0.01,14749.07,227,395,38,24,134,1
7,0,0,4,3,4,11,19.07,10.91,2270.01,0.07,46,0.09,126.11,20,26,11,12,11,1
1,0,0,1,1,1,2,5.33,1.5,12,0,4,0.67,0.67,1,3,1,3,2,0
1,0,0,1,1,1,2,10.44,3.5,127.89,0.01,11,0.29,7.11,3,8,3,7,2,0
1,0,0,1,1,1,2,9.05,2,36.19,0.01,7,0.5,2,2,5,2,4,2,1
1,0,0,1,1,1,2,7.49,3,67.38,0.01,8,0.33,3.74,1,7,1,6,2,1
1,0,0,1,1,1,0,0,0,0,0,1,0,0,0,1,0,1,0,0
1,0,0,1,1,1,2,5.33,1.5,12,0,4,0.67,0.67,1,3,1,3,2,0
1,0,0,1,1,1,2,8,3,72,0.01,8,0.33,4,2,6,2,6,2,0
1,0,0,1,1,1,2,0,0,0,0,5,0,0,0,5,0,5,2,0
1,0,0,1,1,1,0,0,0,0,0,1,0,0,0,1,0,1,0,0
1,0,0,1,1,1,2,0,0,0,0.01,6,0,0,0,6,0,6,2,0
1,0,0,1,1,1,2,7.75,2,31.02,0.01,6,0.5,1.72,2,4,2,4,2,0
1,0,0,1,1,1,2,7.74,1.5,17.41,0,5,0.67,0.97,2,3,2,3,2,0
1,1,1,1,1,1,1,0,0,0,0,1,0,0,1,0,1,0,2,0
3,1,0,2,1,1,7,12.44,4.9,298.63,0.02,17,0.2,16.59,7,10,5,7,8,0
1,0,0,1,1,1,0,0,0,0,0,1,0,0,0,1,0,1,0,0
3,1,0,2,2,1,6,10.88,6.3,431.75,0.02,18,0.16,23.99,7,11,5,9,7,0
1,0,0,1,1,1,2,5.33,1.5,12,0,4,0.67,0.67,1,3,1,3,2,0
1,0,0,1,1,1,2,0,0,0,0,5,0,0,0,5,0,5,2,0
1,0,0,1,1,1,0,0,0,0,0,1,0,0,0,1,0,1,0,0
1,0,0,1,1,1,2,0,0,0,0.01,6,0,0,0,6,0,6,2,0
1,0,3,1,1,1,4,0,0,0,0,3,0,0,3,0,3,0,4,0
1,0,0,1,1,1,2,5.33,1.5,12,0,4,0.67,0.67,1,3,1,3,2,0
1,0,0,1,1,1,0,0,0,0,0,1,0,0,0,1,0,1,0,0
3,2,1,2,1,1,5,10.33,4.5,209.28,0.02,14,0.22,11.63,6,8,4,6,7,0
3,1,0,2,1,1,6,13.45,3.6,174.36,0.02,14,0.28,9.69,6,8,5,6,7,0
1,0,0,1,1,1,2,0,0,0,0,5,0,0,0,5,0,5,2,0
1,0,0,1,1,1,0,0,0,0,0,1,0,0,0,1,0,1,0,0
1,0,0,1,1,1,2,0,0,0,0.01,6,0,0,0,6,0,6,2,0
1,0,0,1,1,1,0,0,0,0,0,1,0,0,0,1,0,1,0,0
1,0,0,1,1,1,2,6.55,3,58.95,0.01,7,0.33,3.28,1,6,1,6,2,0
1,0,0,1,1,1,2,5.33,1.5,12,0,4,0.67,0.67,1,3,1,3,2,0
1,0,0,1,1,1,2,8,3,72,0.01,8,0.33,4,2,6,2,6,2,0
1,0,0,1,1,1,2,9,3,81,0.01,9,0.33,4.5,2,7,2,6,2,0
1,0,0,1,1,1,2,8,3,72,0.01,8,0.33,4,2,6,2,6,2,0
1,0,0,1,1,1,2,9.49,3.5,116.27,0.01,10,0.29,6.46,3,7,3,7,2,0
1,0,0,1,1,1,2,11.86,3.5,145.3,0.01,12,0.29,8.07,4,8,4,7,2,0
1,0,0,1,1,1,2,0,0,0,0,5,0,0,0,5,0,5,2,0
1,0,0,1,1,1,0,0,0,0,0,1,0,0,0,1,0,1,0,0
1,0,0,1,1,1,2,0,0,0,0.01,6,0,0,0,6,0,6,2,0
1,0,0,1,1,1,2,7.75,2,31.02,0.01,6,0.5,1.72,2,4,2,4,2,0
1,0,0,1,1,1,3,10.8,3.33,120,0.01,12,0.3,6.67,4,8,3,5,3,0
1,0,0,1,1,1,2,7.75,2,31.02,0.01,6,0.5,1.72,2,4,2,4,2,0
1,0,0,1,1,1,3,12.68,2.5,79.25,0.01,10,0.4,4.4,4,6,4,5,3,0
1,3,1,1,1,1,1,0,0,0,0,1,0,0,1,0,1,0,4,0
1,0,0,1,1,1,2,6.55,3,58.95,0.01,7,0.33,3.28,1,6,1,6,2,0
1,0,0,1,1,1,0,0,0,0,0,1,0,0,0,1,0,1,0,0
1,0,0,1,1,1,2,8,3,72,0.01,8,0.33,4,2,6,2,6,2,0
1,0,0,1,1,1,2,9,3,81,0.01,9,0.33,4.5,2,7,2,6,2,0
1,0,0,1,1,1,2,5.33,1.5,12,0,4,0.67,0.67,1,3,1,3,2,0
1,0,0,1,1,1,2,5.33,1.5,12,0,4,0.67,0.67,1,3,1,3,2,0
1,0,0,1,1,1,2,6.55,3,58.95,0.01,7,0.33,3.28,1,6,1,6,2,0
1,0,0,1,1,1,2,5.33,1.5,12,0,4,0.67,0.67,1,3,1,3,2,0
1,0,0,1,1,1,2,5.33,1.5,12,0,4,0.67,0.67,1,3,1,3,2,0
1,0,0,1,1,1,2,6.55,3,58.95,0.01,7,0.33,3.28,1,6,1,6,2,0
1,0,0,1,1,1,2,0,0,0,0,5,0,0,0,5,0,5,2,0
1,0,0,1,1,1,0,0,0,0,0,1,0,0,0,1,0,1,0,0
1,0,0,1,1,1,2,0,0,0,0.01,6,0,0,0,6,0,6,2,0
1,0,0,1,1,1,0,0,0,0,0,1,0,0,0,1,0,1,0,0
1,0,1,1,1,1,2,9.51,3,85.59,0.01,9,0.33,4.75,3,6,3,6,2,0
1,0,0,1,1,1,2,0,0,0,0,5,0,0,0,5,0,5,2,0
1,0,0,1,1,1,0,0,0,0,0,1,0,0,0,1,0,1,0,0
1,0,0,1,1,1,2,0,0,0,0.01,6,0,0,0,6,0,6,2,0
1,0,0,1,1,1,0,0,0,0,0,1,0,0,0,1,0,1,0,0
1,0,1,1,1,1,2,5.33,1.5,12,0,4,0.67,0.67,1,3,1,3,2,0
1,0,0,1,1,1,2,0,0,0,0,5,0,0,0,5,0,5,2,0
1,0,0,1,1,1,0,0,0,0,0,1,0,0,0,1,0,1,0,0
1,0,0,1,1,1,2,0,0,0,0.01,6,0,0,0,6,0,6,2,0
1,0,0,1,1,1,2,9.83,2,39.3,0.01,7,0.5,2.18,3,4,3,4,2,0
1,0,0,1,1,1,2,10.44,3.5,127.89,0.01,11,0.29,7.11,3,8,3,7,2,0
1,0,0,1,1,1,2,7.49,3,67.38,0.01,8,0.33,3.74,1,7,1,6,2,0
1,0,0,1,1,1,2,9,3,81,0.01,9,0.33,4.5,2,7,2,6,2,0
1,0,0,1,1,1,2,9,3,81,0.01,9,0.33,4.5,2,7,2,6,2,0
1,0,0,1,1,1,2,9,3,81,0.01,9,0.33,4.5,2,7,2,6,2,0
1,0,0,1,1,1,2,10.44,3.5,127.89,0.01,11,0.29,7.11,3,8,3,7,2,0
1,0,0,1,1,1,2,9,3,81,0.01,9,0.33,4.5,2,7,2,6,2,0
1,0,0,1,1,1,2,9,3,81,0.01,9,0.33,4.5,2,7,2,6,2,0
1,0,0,1,1,1,2,7.49,3,67.38,0.01,8,0.33,3.74,1,7,1,6,2,0
1,0,0,1,1,1,2,7.49,3,67.38,0.01,8,0.33,3.74,1,7,1,6,2,0
1,0,0,1,1,1,2,10,3,90,0.01,10,0.33,5,2,8,2,6,2,0
1,0,0,1,1,1,3,10.44,3.5,127.89,0.01,11,0.29,7.11,3,8,3,7,3,0
1,0,0,1,1,1,3,11.39,3.5,139.52,0.01,12,0.29,7.75,3,9,3,7,3,0
1,0,0,1,1,1,2,9,3,81,0.01,9,0.33,4.5,2,7,2,6,2,0
1,0,0,1,1,1,2,10.44,3.5,127.89,0.01,11,0.29,7.11,3,8,3,7,2,0
1,0,0,1,1,1,2,9,3,81,0.01,9,0.33,4.5,2,7,2,6,2,0
1,0,0,1,1,1,2,9,3,81,0.01,9,0.33,4.5,2,7,2,6,2,0
1,0,0,1,1,1,2,10.44,3.5,127.89,0.01,11,0.29,7.11,3,8,3,7,2,0
1,0,0,1,1,1,2,9,3,81,0.01,9,0.33,4.5,2,7,2,6,2,0
1,0,0,1,1,1,2,9,3,81,0.01,9,0.33,4.5,2,7,2,6,2,0
1,0,0,1,1,1,2,9,3,81,0.01,9,0.33,4.5,2,7,2,6,2,0
1,0,0,1,1,1,2,7.49,3,67.38,0.01,8,0.33,3.74,1,7,1,6,2,0
1,0,0,1,1,1,2,9,3,81,0.01,9,0.33,4.5,2,7,2,6,2,0
1,0,0,1,1,1,2,9,3,81,0.01,9,0.33,4.5,2,7,2,6,2,0
1,0,0,1,1,1,2,10.44,3.5,127.89,0.01,11,0.29,7.11,3,8,3,7,2,0
1,0,0,1,1,1,2,9.05,2,36.19,0.01,7,0.5,2,2,5,2,4,2,0
1,0,0,1,1,1,2,9.05,2,36.19,0.01,7,0.5,2,2,5,2,4,2,0
1,0,0,1,1,1,2,9.05,2,36.19,0.01,7,0.5,2,2,5,2,4,2,0
1,0,0,1,1,1,2,9.05,2,36.19,0.01,7,0.5,2,2,5,2,4,2,0
1,0,0,1,1,1,2,9.05,2,36.19,0.01,7,0.5,2,2,5,2,4,2,0
1,0,0,1,1,1,2,9.05,2,36.19,0.01,7,0.5,2,2,5,2,4,2,0
1,0,0,1,1,1,2,9.05,2,36.19,0.01,7,0.5,2,2,5,2,4,2,0
1,0,0,1,1,1,2,9.05,2,36.19,0.01,7,0.5,2,2,5,2,4,2,0
1,0,0,1,1,1,2,9.05,2,36.19,0.01,7,0.5,2,2,5,2,4,2,0
1,0,0,1,1,1,2,9.05,2,36.19,0.01,7,0.5,2,2,5,2,4,2,0
1,0,0,1,1,1,2,9.05,2,36.19,0.01,7,0.5,2,2,5,2,4,2,0
1,0,0,1,1,1,2,9.05,2,36.19,0.01,7,0.5,2,2,5,2,4,2,0
1,0,0,1,1,1,2,9.05,2,36.19,0.01,7,0.5,2,2,5,2,4,2,0
1,0,0,1,1,1,2,10.44,3.5,127.89,0.01,11,0.29,7.11,3,8,3,7,2,0
1,0,0,1,1,1,2,10.44,3.5,127.89,0.01,11,0.29,7.11,3,8,3,7,2,0
1,0,0,1,1,1,2,9.05,2,36.19,0.01,7,0.5,2,2,5,2,4,2,0
1,0,0,1,1,1,0,0,0,0,0,1,0,0,0,1,0,1,0,0
1,0,0,1,1,1,2,5.33,1.5,12,0,4,0.67,0.67,1,3,1,3,2,0
3,0,0,2,1,1,6,11.86,4.38,227.03,0.02,15,0.23,12.61,5,10,4,7,6,0
3,2,0,2,1,1,6,14.43,5.14,381.76,0.02,19,0.19,21.21,9,10,7,8,8,0
5,1,0,3,1,1,10,12.67,10,1267.11,0.04,31,0.1,70.4,14,17,7,10,11,0
3,1,0,2,1,1,6,11.71,4.9,281.06,0.02,16,0.2,15.61,7,9,5,7,7,0
3,1,0,2,1,1,6,11.71,4.9,281.06,0.02,16,0.2,15.61,7,9,5,7,7,0
1,0,0,1,1,1,2,5.33,1.5,12,0,4,0.67,0.67,1,3,1,3,2,0
1,0,0,1,1,1,2,5.33,1.5,12,0,4,0.67,0.67,1,3,1,3,2,0
3,1,0,2,1,1,6,11.23,5.6,352.28,0.02,17,0.18,19.57,7,10,5,8,7,0
7,1,1,4,1,3,13,18.91,10.45,2065.48,0.07,45,0.1,114.75,19,26,10,11,14,0
5,1,0,3,1,1,10,13.33,9,1080,0.04,30,0.11,60,14,16,7,9,11,0
3,1,0,2,1,1,6,11.71,4.9,281.06,0.02,16,0.2,15.61,7,9,5,7,7,0
7,1,1,4,1,3,13,18.91,10.45,2065.48,0.07,45,0.1,114.75,19,26,10,11,14,0
3,1,0,2,1,1,6,11.71,4.9,281.06,0.02,16,0.2,15.61,7,9,5,7,7,0
3,0,0,2,1,1,6,11.86,4.38,227.03,0.02,15,0.23,12.61,5,10,4,7,6,0
3,2,0,2,1,1,7,16.73,5.5,506,0.03,23,0.18,28.11,11,12,8,8,9,0
1,0,0,1,1,1,2,5.33,1.5,12,0,4,0.67,0.67,1,3,1,3,2,0
9,6,0,5,1,1,14,23.12,11.15,2875.94,0.09,57,0.09,159.77,29,28,13,10,20,0
3,1,0,2,1,1,7,14.43,5.14,381.76,0.02,19,0.19,21.21,9,10,7,8,8,0
7,1,1,4,1,3,13,19.62,10,1962.15,0.07,44,0.1,109.01,20,24,11,11,14,0
1,0,0,1,1,1,2,5.33,1.5,12,0,4,0.67,0.67,1,3,1,3,2,0
1,0,0,1,1,1,2,5.33,1.5,12,0,4,0.67,0.67,1,3,1,3,2,0
1,0,0,1,1,1,2,5.33,1.5,12,0,4,0.67,0.67,1,3,1,3,2,0
1,0,0,1,1,1,2,5.33,1.5,12,0,4,0.67,0.67,1,3,1,3,2,0
1,0,0,1,1,1,2,5.33,1.5,12,0,4,0.67,0.67,1,3,1,3,2,0
1,0,0,1,1,1,2,5.33,1.5,12,0,4,0.67,0.67,1,3,1,3,2,0
3,1,0,2,1,1,5,10.95,6,394.38,0.02,19,0.17,21.91,10,9,5,6,6,0
3,1,0,2,1,1,5,10.95,6,394.38,0.02,19,0.17,21.91,10,9,5,6,6,0
3,1,0,2,1,1,5,10.95,6,394.38,0.02,19,0.17,21.91,10,9,5,6,6,0
3,1,0,2,1,1,5,10.95,6,394.38,0.02,19,0.17,21.91,10,9,5,6,6,0
3,1,1,2,1,1,5,10.95,6,394.38,0.02,19,0.17,21.91,10,9,5,6,6,0
1,0,0,1,1,1,3,13,3,117,0.01,13,0.33,6.5,6,7,4,4,3,0
1,0,0,1,1,1,2,11.07,3,99.66,0.01,10,0.33,5.54,4,6,4,6,2,0
1,0,0,1,1,1,2,7.74,1.5,17.41,0,5,0.67,0.97,2,3,2,3,2,0
3,0,1,2,1,1,8,16.92,4.5,342.66,0.03,20,0.22,19.04,9,11,7,7,8,0
3,1,0,2,1,1,7,16.92,4.5,342.66,0.03,20,0.22,19.04,9,11,7,7,8,0
1,0,0,1,1,1,2,11.41,2.5,71.32,0.01,9,0.4,3.96,4,5,4,5,2,0
3,1,0,2,1,1,5,10.95,6,394.38,0.02,19,0.17,21.91,10,9,5,6,6,0
1,0,0,1,1,1,4,16.51,4.8,380.39,0.03,25,0.21,21.13,12,13,5,4,4,0
1,0,0,1,1,1,2,7.74,1.5,17.41,0,5,0.67,0.97,2,3,2,3,2,0
3,1,0,2,1,1,5,10.95,6,394.38,0.02,19,0.17,21.91,10,9,5,6,6,0
3,1,0,2,1,1,5,10.95,6,394.38,0.02,19,0.17,21.91,10,9,5,6,6,0
1,0,0,1,1,1,2,9.83,2,39.3,0.01,7,0.5,2.18,3,4,3,4,2,0
5,0,0,3,1,1,2,13.29,4.5,269.08,0.02,18,0.22,14.95,6,12,4,6,2,0
1,0,1,1,1,1,2,16.92,3.5,207.22,0.02,16,0.29,11.51,6,10,6,7,2,0
1,0,0,1,1,1,2,0,0,0,0,5,0,0,0,5,0,5,2,0
1,0,0,1,1,1,0,0,0,0,0,1,0,0,0,1,0,1,0,0
1,0,0,1,1,1,2,0,0,0,0.01,6,0,0,0,6,0,6,2,0
1,0,0,1,1,1,2,20.97,3,188.72,0.02,17,0.33,10.48,7,10,7,6,2,0
1,0,0,1,1,1,2,20.97,3,188.72,0.02,17,0.33,10.48,7,10,7,6,2,0
1,0,0,1,1,1,2,27.35,3,246.13,0.03,21,0.33,13.67,9,12,9,6,2,0
1,0,0,1,1,1,3,30.67,3,276,0.03,23,0.33,15.33,10,13,10,6,3,0
1,0,0,1,1,1,3,30.67,3,276,0.03,23,0.33,15.33,10,13,10,6,3,0
1,0,0,1,1,1,3,30.67,3,276,0.03,23,0.33,15.33,10,13,10,6,3,0
1,0,0,1,1,1,2,27.35,3,246.13,0.03,21,0.33,13.67,9,12,9,6,2,0
1,0,0,1,1,1,3,27.35,3,246.13,0.03,21,0.33,13.67,9,12,9,6,3,0
1,0,0,1,1,1,2,20.97,3,188.72,0.02,17,0.33,10.48,7,10,7,6,2,0
1,0,0,1,1,1,2,20.97,3,188.72,0.02,17,0.33,10.48,7,10,7,6,2,0
1,0,0,1,1,1,2,20.97,3,188.72,0.02,17,0.33,10.48,7,10,7,6,2,0
1,0,0,1,1,1,2,17.92,3,161.32,0.02,15,0.33,8.96,6,9,6,6,2,0
1,0,0,1,1,1,2,17.92,3,161.32,0.02,15,0.33,8.96,6,9,6,6,2,0
1,0,0,1,1,1,2,14.99,3,134.92,0.01,13,0.33,7.5,5,8,5,6,2,0
1,0,0,1,1,1,2,14.99,3,134.92,0.01,13,0.33,7.5,5,8,5,6,2,0
1,0,0,1,1,1,2,14.99,3,134.92,0.01,13,0.33,7.5,5,8,5,6,2,0
1,0,0,1,1,1,2,14.99,3,134.92,0.01,13,0.33,7.5,5,8,5,6,2,0
1,0,0,1,1,1,2,14.99,3,134.92,0.01,13,0.33,7.5,5,8,5,6,2,0
1,0,0,1,1,1,2,17.92,3,161.32,0.02,15,0.33,8.96,6,9,6,6,2,0
1,0,0,1,1,1,2,17.92,3,161.32,0.02,15,0.33,8.96,6,9,6,6,2,0
1,0,0,1,1,1,2,20.97,3,188.72,0.02,17,0.33,10.48,7,10,7,6,2,0
1,0,0,1,1,1,2,20.97,3,188.72,0.02,17,0.33,10.48,7,10,7,6,2,0
1,0,0,1,1,1,0,0,0,0,0,1,0,0,0,1,0,1,0,0
1,0,0,1,1,1,2,5.33,1.5,12,0,4,0.67,0.67,1,3,1,3,2,0
1,0,0,1,1,1,2,8,3,72,0.01,8,0.33,4,2,6,2,6,2,0
1,0,0,1,1,1,2,0,0,0,0,5,0,0,0,5,0,5,2,0
1,0,0,1,1,1,0,0,0,0,0,1,0,0,0,1,0,1,0,0
1,0,0,1,1,1,2,0,0,0,0.01,6,0,0,0,6,0,6,2,0
1,0,0,1,1,1,2,7.75,2,31.02,0.01,6,0.5,1.72,2,4,2,4,2,0
1,0,0,1,1,1,2,7.74,1.5,17.41,0,5,0.67,0.97,2,3,2,3,2,0
1,1,1,1,1,1,1,0,0,0,0,1,0,0,1,0,1,0,2,0
3,1,0,2,1,1,7,12.44,4.9,298.63,0.02,17,0.2,16.59,7,10,5,7,8,0
1,0,0,1,1,1,0,0,0,0,0,1,0,0,0,1,0,1,0,0
5,2,5,3,2,1,15,28.11,7.62,1630.09,0.07,48,0.13,90.56,22,26,13,9,17,1
3,2,1,2,1,1,5,10.33,4.5,209.28,0.02,14,0.22,11.63,6,8,4,6,7,0
33,11,18,17,14,11,53,52.98,30.46,49160.83,0.54,270,0.03,2731.16,99,171,39,24,64,1
3,1,0,2,1,1,6,13.45,3.6,174.36,0.02,14,0.28,9.69,6,8,5,6,7,0
1,0,0,1,1,1,2,0,0,0,0,5,0,0,0,5,0,5,2,0
1,0,0,1,1,1,0,0,0,0,0,1,0,0,0,1,0,1,0,0
1,0,0,1,1,1,2,0,0,0,0.01,6,0,0,0,6,0,6,2,0
79,28,74,43,34,21,208,60.95,117.61,843015.6,2.39,1072,0.01,46834.2,386,686,64,39,236,1
5,3,2,3,3,1,24,31.69,15.17,7288.45,0.16,97,0.07,404.91,42,55,18,13,27,1
33,8,16,17,14,11,53,45.65,31.09,44130.73,0.47,249,0.03,2451.71,108,141,33,19,61,1
7,6,3,4,4,1,32,33.45,22.05,16265.89,0.25,145,0.05,903.66,63,82,20,14,38,1
17,6,1,9,4,1,29,37.43,14.58,7959.36,0.18,104,0.07,442.19,50,54,24,14,35,1
1,0,0,1,1,1,0,0,0,0,0,1,0,0,0,1,0,1,0,0
1,0,0,1,1,1,2,6.55,3,58.95,0.01,7,0.33,3.28,1,6,1,6,2,0
1,0,0,1,1,1,2,5.33,1.5,12,0,4,0.67,0.67,1,3,1,3,2,0
1,0,0,1,1,1,2,8,3,72,0.01,8,0.33,4,2,6,2,6,2,0
1,0,0,1,1,1,2,9,3,81,0.01,9,0.33,4.5,2,7,2,6,2,0
1,0,0,1,1,1,2,8,3,72,0.01,8,0.33,4,2,6,2,6,2,0
1,0,0,1,1,1,2,9.49,3.5,116.27,0.01,10,0.29,6.46,3,7,3,7,2,0
1,0,0,1,1,1,2,11.86,3.5,145.3,0.01,12,0.29,8.07,4,8,4,7,2,0
1,0,0,1,1,1,2,0,0,0,0,5,0,0,0,5,0,5,2,0
1,0,0,1,1,1,0,0,0,0,0,1,0,0,0,1,0,1,0,0
1,0,0,1,1,1,2,0,0,0,0.01,6,0,0,0,6,0,6,2,0
1,0,0,1,1,1,2,7.75,2,31.02,0.01,6,0.5,1.72,2,4,2,4,2,0
1,0,0,1,1,1,3,10.8,3.33,120,0.01,12,0.3,6.67,4,8,3,5,3,0
1,0,0,1,1,1,2,7.75,2,31.02,0.01,6,0.5,1.72,2,4,2,4,2,0
1,0,0,1,1,1,3,12.68,2.5,79.25,0.01,10,0.4,4.4,4,6,4,5,3,0
1,3,1,1,1,1,1,0,0,0,0,1,0,0,1,0,1,0,4,0
1,0,0,1,1,1,2,6.55,3,58.95,0.01,7,0.33,3.28,1,6,1,6,2,0
1,0,0,1,1,1,0,0,0,0,0,1,0,0,0,1,0,1,0,0
1,0,0,1,1,1,2,8,3,72,0.01,8,0.33,4,2,6,2,6,2,0
1,0,0,1,1,1,2,9,3,81,0.01,9,0.33,4.5,2,7,2,6,2,0
1,0,0,1,1,1,2,5.33,1.5,12,0,4,0.67,0.67,1,3,1,3,2,0
1,0,0,1,1,1,2,5.33,1.5,12,0,4,0.67,0.67,1,3,1,3,2,0
1,0,0,1,1,1,2,6.55,3,58.95,0.01,7,0.33,3.28,1,6,1,6,2,0
1,0,0,1,1,1,2,5.33,1.5,12,0,4,0.67,0.67,1,3,1,3,2,0
1,0,0,1,1,1,2,5.33,1.5,12,0,4,0.67,0.67,1,3,1,3,2,0
1,0,0,1,1,1,2,6.55,3,58.95,0.01,7,0.33,3.28,1,6,1,6,2,0
1,0,0,1,1,1,2,0,0,0,0,5,0,0,0,5,0,5,2,0
1,0,0,1,1,1,0,0,0,0,0,1,0,0,0,1,0,1,0,0
1,0,0,1,1,1,2,0,0,0,0.01,6,0,0,0,6,0,6,2,0
1,0,0,1,1,1,0,0,0,0,0,1,0,0,0,1,0,1,0,0
1,0,1,1,1,1,2,9.51,3,85.59,0.01,9,0.33,4.75,3,6,3,6,2,0
1,0,0,1,1,1,2,0,0,0,0,5,0,0,0,5,0,5,2,0
1,0,0,1,1,1,0,0,0,0,0,1,0,0,0,1,0,1,0,0
1,0,0,1,1,1,2,0,0,0,0.01,6,0,0,0,6,0,6,2,0
1,0,0,1,1,1,0,0,0,0,0,1,0,0,0,1,0,1,0,0
1,0,1,1,1,1,2,5.33,1.5,12,0,4,0.67,0.67,1,3,1,3,2,0
1,0,0,1,1,1,2,0,0,0,0,5,0,0,0,5,0,5,2,0
1,0,0,1,1,1,0,0,0,0,0,1,0,0,0,1,0,1,0,0
1,0,0,1,1,1,2,0,0,0,0.01,6,0,0,0,6,0,6,2,0
1,0,0,1,1,1,2,9.83,2,39.3,0.01,7,0.5,2.18,3,4,3,4,2,0
1,0,0,1,1,1,2,10.44,3.5,127.89,0.01,11,0.29,7.11,3,8,3,7,2,0
1,0,0,1,1,1,2,7.49,3,67.38,0.01,8,0.33,3.74,1,7,1,6,2,0
1,0,0,1,1,1,2,9,3,81,0.01,9,0.33,4.5,2,7,2,6,2,0
1,0,0,1,1,1,2,9,3,81,0.01,9,0.33,4.5,2,7,2,6,2,0
1,0,0,1,1,1,2,9,3,81,0.01,9,0.33,4.5,2,7,2,6,2,0
1,0,0,1,1,1,2,10.44,3.5,127.89,0.01,11,0.29,7.11,3,8,3,7,2,0
1,0,0,1,1,1,2,9,3,81,0.01,9,0.33,4.5,2,7,2,6,2,0
1,0,0,1,1,1,2,9,3,81,0.01,9,0.33,4.5,2,7,2,6,2,0
1,0,0,1,1,1,2,7.49,3,67.38,0.01,8,0.33,3.74,1,7,1,6,2,0
1,0,0,1,1,1,2,7.49,3,67.38,0.01,8,0.33,3.74,1,7,1,6,2,0
1,0,0,1,1,1,2,10,3,90,0.01,10,0.33,5,2,8,2,6,2,0
1,0,0,1,1,1,3,10.44,3.5,127.89,0.01,11,0.29,7.11,3,8,3,7,3,0
1,0,0,1,1,1,3,11.39,3.5,139.52,0.01,12,0.29,7.75,3,9,3,7,3,0
1,0,0,1,1,1,2,9,3,81,0.01,9,0.33,4.5,2,7,2,6,2,0
1,0,0,1,1,1,2,10.44,3.5,127.89,0.01,11,0.29,7.11,3,8,3,7,2,0
1,0,0,1,1,1,2,9,3,81,0.01,9,0.33,4.5,2,7,2,6,2,0
1,0,0,1,1,1,2,9,3,81,0.01,9,0.33,4.5,2,7,2,6,2,0
1,0,0,1,1,1,2,10.44,3.5,127.89,0.01,11,0.29,7.11,3,8,3,7,2,0
1,0,0,1,1,1,2,9,3,81,0.01,9,0.33,4.5,2,7,2,6,2,0
1,0,0,1,1,1,2,9,3,81,0.01,9,0.33,4.5,2,7,2,6,2,0
1,0,0,1,1,1,2,9,3,81,0.01,9,0.33,4.5,2,7,2,6,2,0
1,0,0,1,1,1,2,7.49,3,67.38,0.01,8,0.33,3.74,1,7,1,6,2,0
1,0,0,1,1,1,2,9,3,81,0.01,9,0.33,4.5,2,7,2,6,2,0
1,0,0,1,1,1,2,9,3,81,0.01,9,0.33,4.5,2,7,2,6,2,0
1,0,0,1,1,1,2,10.44,3.5,127.89,0.01,11,0.29,7.11,3,8,3,7,2,0
1,0,0,1,1,1,2,9.05,2,36.19,0.01,7,0.5,2,2,5,2,4,2,0
1,0,0,1,1,1,2,9.05,2,36.19,0.01,7,0.5,2,2,5,2,4,2,0
1,0,0,1,1,1,2,9.05,2,36.19,0.01,7,0.5,2,2,5,2,4,2,0
1,0,0,1,1,1,2,9.05,2,36.19,0.01,7,0.5,2,2,5,2,4,2,0
1,0,0,1,1,1,2,9.05,2,36.19,0.01,7,0.5,2,2,5,2,4,2,0
1,0,0,1,1,1,2,9.05,2,36.19,0.01,7,0.5,2,2,5,2,4,2,0
1,0,0,1,1,1,2,9.05,2,36.19,0.01,7,0.5,2,2,5,2,4,2,0
1,0,0,1,1,1,2,9.05,2,36.19,0.01,7,0.5,2,2,5,2,4,2,0
1,0,0,1,1,1,2,9.05,2,36.19,0.01,7,0.5,2,2,5,2,4,2,0
1,0,0,1,1,1,2,9.05,2,36.19,0.01,7,0.5,2,2,5,2,4,2,0
1,0,0,1,1,1,2,9.05,2,36.19,0.01,7,0.5,2,2,5,2,4,2,0
1,0,0,1,1,1,2,9.05,2,36.19,0.01,7,0.5,2,2,5,2,4,2,0
1,0,0,1,1,1,2,9.05,2,36.19,0.01,7,0.5,2,2,5,2,4,2,0
1,0,0,1,1,1,2,10.44,3.5,127.89,0.01,11,0.29,7.11,3,8,3,7,2,0
1,0,0,1,1,1,2,10.44,3.5,127.89,0.01,11,0.29,7.11,3,8,3,7,2,0
1,0,0,1,1,1,2,9.05,2,36.19,0.01,7,0.5,2,2,5,2,4,2,0
1,0,0,1,1,1,0,0,0,0,0,1,0,0,0,1,0,1,0,0
1,0,0,1,1,1,2,5.33,1.5,12,0,4,0.67,0.67,1,3,1,3,2,0
3,0,0,2,1,1,6,11.86,4.38,227.03,0.02,15,0.23,12.61,5,10,4,7,6,0
3,2,0,2,1,1,6,14.43,5.14,381.76,0.02,19,0.19,21.21,9,10,7,8,8,0
5,1,0,3,1,1,10,12.67,10,1267.11,0.04,31,0.1,70.4,14,17,7,10,11,0
3,1,0,2,1,1,6,11.71,4.9,281.06,0.02,16,0.2,15.61,7,9,5,7,7,0
3,1,0,2,1,1,6,11.71,4.9,281.06,0.02,16,0.2,15.61,7,9,5,7,7,0
1,0,0,1,1,1,2,5.33,1.5,12,0,4,0.67,0.67,1,3,1,3,2,0
1,0,0,1,1,1,2,5.33,1.5,12,0,4,0.67,0.67,1,3,1,3,2,0
3,1,0,2,1,1,6,11.23,5.6,352.28,0.02,17,0.18,19.57,7,10,5,8,7,0
7,1,1,4,1,3,13,18.91,10.45,2065.48,0.07,45,0.1,114.75,19,26,10,11,14,0
5,1,0,3,1,1,10,13.33,9,1080,0.04,30,0.11,60,14,16,7,9,11,0
3,1,0,2,1,1,6,11.71,4.9,281.06,0.02,16,0.2,15.61,7,9,5,7,7,0
7,1,1,4,1,3,13,18.91,10.45,2065.48,0.07,45,0.1,114.75,19,26,10,11,14,0
3,1,0,2,1,1,6,11.71,4.9,281.06,0.02,16,0.2,15.61,7,9,5,7,7,0
3,0,0,2,1,1,6,11.86,4.38,227.03,0.02,15,0.23,12.61,5,10,4,7,6,0
3,2,0,2,1,1,7,16.73,5.5,506,0.03,23,0.18,28.11,11,12,8,8,9,0
1,0,0,1,1,1,2,5.33,1.5,12,0,4,0.67,0.67,1,3,1,3,2,0
9,6,0,5,1,1,14,23.12,11.15,2875.94,0.09,57,0.09,159.77,29,28,13,10,20,0
3,1,0,2,1,1,7,14.43,5.14,381.76,0.02,19,0.19,21.21,9,10,7,8,8,0
7,1,1,4,1,3,13,19.62,10,1962.15,0.07,44,0.1,109.01,20,24,11,11,14,0
1,0,0,1,1,1,2,5.33,1.5,12,0,4,0.67,0.67,1,3,1,3,2,0
1,0,0,1,1,1,2,5.33,1.5,12,0,4,0.67,0.67,1,3,1,3,2,0
1,0,0,1,1,1,2,5.33,1.5,12,0,4,0.67,0.67,1,3,1,3,2,0
1,0,0,1,1,1,2,5.33,1.5,12,0,4,0.67,0.67,1,3,1,3,2,0
1,0,0,1,1,1,2,5.33,1.5,12,0,4,0.67,0.67,1,3,1,3,2,0
1,0,0,1,1,1,2,5.33,1.5,12,0,4,0.67,0.67,1,3,1,3,2,0
1,0,0,1,1,1,2,5.33,1.5,12,0,4,0.67,0.67,1,3,1,3,2,0
3,1,0,2,1,1,5,10.95,6,394.38,0.02,19,0.17,21.91,10,9,5,6,6,0
3,1,0,2,1,1,5,10.95,6,394.38,0.02,19,0.17,21.91,10,9,5,6,6,0
3,1,0,2,1,1,5,10.95,6,394.38,0.02,19,0.17,21.91,10,9,5,6,6,0
3,1,0,2,1,1,5,10.95,6,394.38,0.02,19,0.17,21.91,10,9,5,6,6,0
3,1,1,2,1,1,5,10.95,6,394.38,0.02,19,0.17,21.91,10,9,5,6,6,0
1,0,0,1,1,1,3,13,3,117,0.01,13,0.33,6.5,6,7,4,4,3,0
1,0,0,1,1,1,2,11.07,3,99.66,0.01,10,0.33,5.54,4,6,4,6,2,0
1,0,0,1,1,1,2,7.74,1.5,17.41,0,5,0.67,0.97,2,3,2,3,2,0
3,0,1,2,1,1,8,16.92,4.5,342.66,0.03,20,0.22,19.04,9,11,7,7,8,0
3,1,0,2,1,1,7,16.92,4.5,342.66,0.03,20,0.22,19.04,9,11,7,7,8,0
1,0,0,1,1,1,2,11.41,2.5,71.32,0.01,9,0.4,3.96,4,5,4,5,2,0
3,1,0,2,1,1,5,10.95,6,394.38,0.02,19,0.17,21.91,10,9,5,6,6,0
1,0,0,1,1,1,4,16.51,4.8,380.39,0.03,25,0.21,21.13,12,13,5,4,4,0
1,0,0,1,1,1,2,7.74,1.5,17.41,0,5,0.67,0.97,2,3,2,3,2,0
3,1,0,2,1,1,5,10.95,6,394.38,0.02,19,0.17,21.91,10,9,5,6,6,0
3,1,0,2,1,1,5,10.95,6,394.38,0.02,19,0.17,21.91,10,9,5,6,6,0
1,0,0,1,1,1,2,9.83,2,39.3,0.01,7,0.5,2.18,3,4,3,4,2,0
1,0,0,1,1,1,0,0,0,0,0,1,0,0,0,1,0,1,0,0
1,0,0,1,1,1,2,5.33,1.5,12,0,4,0.67,0.67,1,3,1,3,2,0
1,0,0,1,1,1,2,8,3,72,0.01,8,0.33,4,2,6,2,6,2,0
1,0,0,1,1,1,2,0,0,0,0,5,0,0,0,5,0,5,2,0
1,0,0,1,1,1,0,0,0,0,0,1,0,0,0,1,0,1,0,0
1,0,0,1,1,1,2,0,0,0,0.01,6,0,0,0,6,0,6,2,0
1,0,0,1,1,1,2,7.75,2,31.02,0.01,6,0.5,1.72,2,4,2,4,2,0
1,0,0,1,1,1,2,7.74,1.5,17.41,0,5,0.67,0.97,2,3,2,3,2,0
1,1,1,1,1,1,1,0,0,0,0,1,0,0,1,0,1,0,2,0
3,1,0,2,1,1,7,12.44,4.9,298.63,0.02,17,0.2,16.59,7,10,5,7,8,0
1,0,0,1,1,1,0,0,0,0,0,1,0,0,0,1,0,1,0,0
3,2,0,2,1,1,6,10.58,9,856.65,0.03,25,0.11,47.59,10,15,5,9,8,0
1,0,0,1,1,1,2,6.55,3,58.95,0.01,7,0.33,3.28,1,6,1,6,2,0
1,0,0,1,1,1,2,5.33,1.5,12,0,4,0.67,0.67,1,3,1,3,2,0
1,0,0,1,1,1,2,8,3,72,0.01,8,0.33,4,2,6,2,6,2,0
1,0,0,1,1,1,2,9,3,81,0.01,9,0.33,4.5,2,7,2,6,2,0
1,0,0,1,1,1,2,8,3,72,0.01,8,0.33,4,2,6,2,6,2,0
1,0,0,1,1,1,2,9.49,3.5,116.27,0.01,10,0.29,6.46,3,7,3,7,2,0
1,0,0,1,1,1,2,11.86,3.5,145.3,0.01,12,0.29,8.07,4,8,4,7,2,0
1,0,0,1,1,1,2,0,0,0,0,5,0,0,0,5,0,5,2,0
1,0,0,1,1,1,0,0,0,0,0,1,0,0,0,1,0,1,0,0
1,0,0,1,1,1,2,0,0,0,0.01,6,0,0,0,6,0,6,2,0
1,0,0,1,1,1,2,7.75,2,31.02,0.01,6,0.5,1.72,2,4,2,4,2,0
1,0,0,1,1,1,3,10.8,3.33,120,0.01,12,0.3,6.67,4,8,3,5,3,0
1,0,0,1,1,1,2,7.75,2,31.02,0.01,6,0.5,1.72,2,4,2,4,2,0
1,0,0,1,1,1,3,12.68,2.5,79.25,0.01,10,0.4,4.4,4,6,4,5,3,0
1,3,1,1,1,1,1,0,0,0,0,1,0,0,1,0,1,0,4,0
1,0,0,1,1,1,2,6.55,3,58.95,0.01,7,0.33,3.28,1,6,1,6,2,0
5,0,0,3,1,1,2,13.29,4.5,269.08,0.02,18,0.22,14.95,6,12,4,6,2,0
1,0,1,1,1,1,2,16.92,3.5,207.22,0.02,16,0.29,11.51,6,10,6,7,2,0
1,0,0,1,1,1,0,0,0,0,0,1,0,0,0,1,0,1,0,0
1,0,0,1,1,1,2,5.33,1.5,12,0,4,0.67,0.67,1,3,1,3,2,0
1,0,0,1,1,1,2,8,3,72,0.01,8,0.33,4,2,6,2,6,2,0
1,0,0,1,1,1,2,0,0,0,0,5,0,0,0,5,0,5,2,0
1,0,0,1,1,1,0,0,0,0,0,1,0,0,0,1,0,1,0,0
1,0,0,1,1,1,2,0,0,0,0.01,6,0,0,0,6,0,6,2,0
1,0,0,1,1,1,2,7.75,2,31.02,0.01,6,0.5,1.72,2,4,2,4,2,0
1,0,0,1,1,1,2,7.74,1.5,17.41,0,5,0.67,0.97,2,3,2,3,2,0
1,1,1,1,1,1,1,0,0,0,0,1,0,0,1,0,1,0,2,0
3,1,0,2,1,1,7,12.44,4.9,298.63,0.02,17,0.2,16.59,7,10,5,7,8,0
1,0,0,1,1,1,0,0,0,0,0,1,0,0,0,1,0,1,0,0
1,0,0,1,1,1,2,6.55,3,58.95,0.01,7,0.33,3.28,1,6,1,6,2,0
1,0,0,1,1,1,2,5.33,1.5,12,0,4,0.67,0.67,1,3,1,3,2,0
1,0,0,1,1,1,2,8,3,72,0.01,8,0.33,4,2,6,2,6,2,0
1,0,0,1,1,1,2,9,3,81,0.01,9,0.33,4.5,2,7,2,6,2,0
1,0,0,1,1,1,2,8,3,72,0.01,8,0.33,4,2,6,2,6,2,0
1,0,0,1,1,1,2,9.49,3.5,116.27,0.01,10,0.29,6.46,3,7,3,7,2,0
1,0,0,1,1,1,2,11.86,3.5,145.3,0.01,12,0.29,8.07,4,8,4,7,2,0
1,0,0,1,1,1,2,0,0,0,0,5,0,0,0,5,0,5,2,0
1,0,0,1,1,1,0,0,0,0,0,1,0,0,0,1,0,1,0,0
1,0,0,1,1,1,2,0,0,0,0.01,6,0,0,0,6,0,6,2,0
1,0,0,1,1,1,2,7.75,2,31.02,0.01,6,0.5,1.72,2,4,2,4,2,0
1,0,0,1,1,1,3,10.8,3.33,120,0.01,12,0.3,6.67,4,8,3,5,3,0
1,0,0,1,1,1,2,7.75,2,31.02,0.01,6,0.5,1.72,2,4,2,4,2,0
1,0,0,1,1,1,3,12.68,2.5,79.25,0.01,10,0.4,4.4,4,6,4,5,3,0
1,3,1,1,1,1,1,0,0,0,0,1,0,0,1,0,1,0,4,0
1,0,0,1,1,1,2,6.55,3,58.95,0.01,7,0.33,3.28,1,6,1,6,2,0
1,0,0,1,1,1,0,0,0,0,0,1,0,0,0,1,0,1,0,0
3,1,1,2,2,1,14,40.28,7.2,2088,0.1,58,0.14,116,24,34,20,12,15,1
1,0,0,1,1,1,2,8,3,72,0.01,8,0.33,4,2,6,2,6,2,0
1,0,0,1,1,1,2,9,3,81,0.01,9,0.33,4.5,2,7,2,6,2,0
1,0,0,1,1,1,2,5.33,1.5,12,0,4,0.67,0.67,1,3,1,3,2,0
1,0,0,1,1,1,2,5.33,1.5,12,0,4,0.67,0.67,1,3,1,3,2,0
1,0,0,1,1,1,2,6.55,3,58.95,0.01,7,0.33,3.28,1,6,1,6,2,0
1,0,0,1,1,1,2,5.33,1.5,12,0,4,0.67,0.67,1,3,1,3,2,0
1,0,0,1,1,1,2,5.33,1.5,12,0,4,0.67,0.67,1,3,1,3,2,0
3,0,2,2,2,1,9,17.85,9.35,1560.59,0.06,38,0.11,86.7,17,21,10,11,9,1
1,0,0,1,1,1,2,6.55,3,58.95,0.01,7,0.33,3.28,1,6,1,6,2,0
1,0,0,1,1,1,2,0,0,0,0,5,0,0,0,5,0,5,2,0
1,0,0,1,1,1,0,0,0,0,0,1,0,0,0,1,0,1,0,0
1,0,0,1,1,1,2,0,0,0,0.01,6,0,0,0,6,0,6,2,0
3,1,0,2,1,1,11,25.59,8.8,1981.55,0.08,54,0.11,110.09,22,32,10,8,12,0
5,1,1,3,2,1,14,17.31,12.55,2724.01,0.07,48,0.08,151.33,23,25,11,12,15,1
3,1,0,2,1,1,11,23.47,9.55,2138.26,0.07,51,0.1,118.79,21,30,11,10,12,1
3,1,0,2,1,1,11,21.89,11,2648.9,0.08,54,0.09,147.16,22,32,11,11,12,0
1,0,0,1,1,1,7,32.17,3.5,394.06,0.04,27,0.29,21.89,11,16,11,7,7,0
3,2,0,2,1,1,10,15.95,5.25,439.75,0.03,22,0.19,24.43,14,8,8,6,12,0
13,2,1,7,3,7,24,38.49,14.98,8638.58,0.19,105,0.07,479.92,41,64,26,19,26,1
1,0,0,1,1,1,0,0,0,0,0,1,0,0,0,1,0,1,0,0
1,0,0,1,1,1,2,5.33,1.5,12,0,4,0.67,0.67,1,3,1,3,2,0
1,0,0,1,1,1,2,8,3,72,0.01,8,0.33,4,2,6,2,6,2,0
1,0,0,1,1,1,2,0,0,0,0,5,0,0,0,5,0,5,2,0
1,0,0,1,1,1,0,0,0,0,0,1,0,0,0,1,0,1,0,0
1,0,0,1,1,1,2,0,0,0,0.01,6,0,0,0,6,0,6,2,0
1,0,0,1,1,1,2,7.75,2,31.02,0.01,6,0.5,1.72,2,4,2,4,2,0
1,0,0,1,1,1,2,7.74,1.5,17.41,0,5,0.67,0.97,2,3,2,3,2,0
1,1,1,1,1,1,1,0,0,0,0,1,0,0,1,0,1,0,2,0
3,1,0,2,1,1,7,12.44,4.9,298.63,0.02,17,0.2,16.59,7,10,5,7,8,0
1,0,0,1,1,1,0,0,0,0,0,1,0,0,0,1,0,1,0,0
1,0,0,1,1,1,2,6.55,3,58.95,0.01,7,0.33,3.28,1,6,1,6,2,0
1,0,0,1,1,1,2,5.33,1.5,12,0,4,0.67,0.67,1,3,1,3,2,0
1,0,0,1,1,1,2,8,3,72,0.01,8,0.33,4,2,6,2,6,2,0
1,0,0,1,1,1,2,9,3,81,0.01,9,0.33,4.5,2,7,2,6,2,0
1,0,0,1,1,1,2,8,3,72,0.01,8,0.33,4,2,6,2,6,2,0
1,0,0,1,1,1,2,9.49,3.5,116.27,0.01,10,0.29,6.46,3,7,3,7,2,0
1,0,0,1,1,1,2,11.86,3.5,145.3,0.01,12,0.29,8.07,4,8,4,7,2,0
1,0,0,1,1,1,2,0,0,0,0,5,0,0,0,5,0,5,2,0
1,0,0,1,1,1,0,0,0,0,0,1,0,0,0,1,0,1,0,0
1,0,0,1,1,1,2,0,0,0,0.01,6,0,0,0,6,0,6,2,0
1,0,0,1,1,1,2,7.75,2,31.02,0.01,6,0.5,1.72,2,4,2,4,2,0
1,0,0,1,1,1,3,10.8,3.33,120,0.01,12,0.3,6.67,4,8,3,5,3,0
1,0,0,1,1,1,2,7.75,2,31.02,0.01,6,0.5,1.72,2,4,2,4,2,0
1,0,0,1,1,1,3,12.68,2.5,79.25,0.01,10,0.4,4.4,4,6,4,5,3,0
1,3,1,1,1,1,1,0,0,0,0,1,0,0,1,0,1,0,4,0
1,0,0,1,1,1,2,6.55,3,58.95,0.01,7,0.33,3.28,1,6,1,6,2,0
1,0,0,1,1,1,0,0,0,0,0,1,0,0,0,1,0,1,0,0
1,0,0,1,1,1,2,8,3,72,0.01,8,0.33,4,2,6,2,6,2,0
1,0,0,1,1,1,2,9,3,81,0.01,9,0.33,4.5,2,7,2,6,2,0
1,0,0,1,1,1,2,5.33,1.5,12,0,4,0.67,0.67,1,3,1,3,2,0
1,0,0,1,1,1,2,5.33,1.5,12,0,4,0.67,0.67,1,3,1,3,2,0
1,0,0,1,1,1,2,6.55,3,58.95,0.01,7,0.33,3.28,1,6,1,6,2,0
1,0,0,1,1,1,2,5.33,1.5,12,0,4,0.67,0.67,1,3,1,3,2,0
1,0,0,1,1,1,2,5.33,1.5,12,0,4,0.67,0.67,1,3,1,3,2,0
1,0,0,1,1,1,2,6.55,3,58.95,0.01,7,0.33,3.28,1,6,1,6,2,0
1,0,0,1,1,1,2,0,0,0,0,5,0,0,0,5,0,5,2,0
1,0,0,1,1,1,0,0,0,0,0,1,0,0,0,1,0,1,0,0
1,0,0,1,1,1,2,0,0,0,0.01,6,0,0,0,6,0,6,2,0
1,0,0,1,1,1,0,0,0,0,0,1,0,0,0,1,0,1,0,0
25,21,16,13,8,9,35,26.86,41.89,47125.76,0.38,210,0.02,2618.1,97,113,22,19,56,1
3,2,0,2,2,1,5,14.31,6.43,591.43,0.03,23,0.16,32.86,10,13,7,9,7,0
1,0,1,1,1,1,2,9.51,3,85.59,0.01,9,0.33,4.75,3,6,3,6,2,0
1,0,0,1,1,1,2,0,0,0,0,5,0,0,0,5,0,5,2,0
1,0,0,1,1,1,0,0,0,0,0,1,0,0,0,1,0,1,0,0
1,0,0,1,1,1,2,0,0,0,0.01,6,0,0,0,6,0,6,2,0
7,3,7,4,3,1,17,12.1,19.64,4668.83,0.08,57,0.05,259.38,25,32,7,11,20,0
5,4,5,3,2,1,10,14.71,15.28,3433.53,0.07,52,0.07,190.75,25,27,9,11,14,0
3,2,0,2,2,1,5,9.67,8.8,748.97,0.03,23,0.11,41.61,11,12,5,8,7,0
1,0,0,1,1,1,0,0,0,0,0,1,0,0,0,1,0,1,0,0
5,0,0,3,1,1,2,13.29,4.5,269.08,0.02,18,0.22,14.95,6,12,4,6,2,0
1,0,1,1,1,1,2,16.92,3.5,207.22,0.02,16,0.29,11.51,6,10,6,7,2,0
1,0,0,1,1,1,2,0,0,0,0,5,0,0,0,5,0,5,2,0
1,0,0,1,1,1,0,0,0,0,0,5,0,0,0,5,0,5,0,0
1,0,0,1,1,1,0,0,0,0,0,5,0,0,0,5,0,5,0,0
1,0,0,1,1,1,0,0,0,0,0,1,0,0,0,1,0,1,0,0
1,0,0,1,1,1,2,0,0,0,0.01,6,0,0,0,6,0,6,2,0
1,0,0,1,1,1,2,5.33,1.5,12,0,4,0.67,0.67,1,3,1,3,2,0
1,0,0,1,1,1,2,10.44,3.5,127.89,0.01,11,0.29,7.11,3,8,3,7,2,0
1,0,0,1,1,1,0,0,0,0,0,1,0,0,0,1,0,1,0,0
1,0,0,1,1,1,2,5.33,1.5,12,0,4,0.67,0.67,1,3,1,3,2,0
1,0,0,1,1,1,2,8,3,72,0.01,8,0.33,4,2,6,2,6,2,0
1,0,0,1,1,1,2,0,0,0,0,5,0,0,0,5,0,5,2,0
1,0,0,1,1,1,0,0,0,0,0,1,0,0,0,1,0,1,0,0
1,0,0,1,1,1,2,0,0,0,0.01,6,0,0,0,6,0,6,2,0
1,0,0,1,1,1,2,7.75,2,31.02,0.01,6,0.5,1.72,2,4,2,4,2,0
1,0,0,1,1,1,2,7.74,1.5,17.41,0,5,0.67,0.97,2,3,2,3,2,0
1,1,1,1,1,1,1,0,0,0,0,1,0,0,1,0,1,0,2,0
3,1,0,2,1,1,7,12.44,4.9,298.63,0.02,17,0.2,16.59,7,10,5,7,8,0
1,0,0,1,1,1,0,0,0,0,0,1,0,0,0,1,0,1,0,0
1,0,0,1,1,1,2,6.55,3,58.95,0.01,7,0.33,3.28,1,6,1,6,2,0
1,0,0,1,1,1,2,5.33,1.5,12,0,4,0.67,0.67,1,3,1,3,2,0
1,0,0,1,1,1,2,8,3,72,0.01,8,0.33,4,2,6,2,6,2,0
1,0,0,1,1,1,2,9,3,81,0.01,9,0.33,4.5,2,7,2,6,2,0
1,0,0,1,1,1,2,8,3,72,0.01,8,0.33,4,2,6,2,6,2,0
1,0,0,1,1,1,2,9.49,3.5,116.27,0.01,10,0.29,6.46,3,7,3,7,2,0
1,0,0,1,1,1,2,11.86,3.5,145.3,0.01,12,0.29,8.07,4,8,4,7,2,0
1,0,0,1,1,1,2,0,0,0,0,5,0,0,0,5,0,5,2,0
1,0,0,1,1,1,0,0,0,0,0,1,0,0,0,1,0,1,0,0
1,0,0,1,1,1,2,0,0,0,0.01,6,0,0,0,6,0,6,2,0
1,0,0,1,1,1,2,7.75,2,31.02,0.01,6,0.5,1.72,2,4,2,4,2,0
1,0,0,1,1,1,3,10.8,3.33,120,0.01,12,0.3,6.67,4,8,3,5,3,0
1,0,0,1,1,1,2,7.75,2,31.02,0.01,6,0.5,1.72,2,4,2,4,2,0
1,0,0,1,1,1,3,12.68,2.5,79.25,0.01,10,0.4,4.4,4,6,4,5,3,0
1,3,1,1,1,1,1,0,0,0,0,1,0,0,1,0,1,0,4,0
1,0,0,1,1,1,2,6.55,3,58.95,0.01,7,0.33,3.28,1,6,1,6,2,0
1,0,0,1,1,1,0,0,0,0,0,1,0,0,0,1,0,1,0,0
1,0,0,1,1,1,2,8,3,72,0.01,8,0.33,4,2,6,2,6,2,0
1,0,0,1,1,1,2,9,3,81,0.01,9,0.33,4.5,2,7,2,6,2,0
1,0,0,1,1,1,2,5.33,1.5,12,0,4,0.67,0.67,1,3,1,3,2,0
1,0,0,1,1,1,2,5.33,1.5,12,0,4,0.67,0.67,1,3,1,3,2,0
1,0,0,1,1,1,2,6.55,3,58.95,0.01,7,0.33,3.28,1,6,1,6,2,0
1,0,0,1,1,1,2,5.33,1.5,12,0,4,0.67,0.67,1,3,1,3,2,0
1,0,0,1,1,1,2,5.33,1.5,12,0,4,0.67,0.67,1,3,1,3,2,0
1,0,0,1,1,1,2,6.55,3,58.95,0.01,7,0.33,3.28,1,6,1,6,2,0
1,0,0,1,1,1,2,0,0,0,0,5,0,0,0,5,0,5,2,0
1,0,0,1,1,1,0,0,0,0,0,1,0,0,0,1,0,1,0,0
1,0,0,1,1,1,2,0,0,0,0.01,6,0,0,0,6,0,6,2,0
1,0,0,1,1,1,0,0,0,0,0,1,0,0,0,1,0,1,0,0
1,0,1,1,1,1,2,9.51,3,85.59,0.01,9,0.33,4.75,3,6,3,6,2,0
1,0,0,1,1,1,2,0,0,0,0,5,0,0,0,5,0,5,2,0
1,0,0,1,1,1,0,0,0,0,0,1,0,0,0,1,0,1,0,0
1,0,0,1,1,1,2,0,0,0,0.01,6,0,0,0,6,0,6,2,0
1,0,0,1,1,1,0,0,0,0,0,1,0,0,0,1,0,1,0,0
7,3,5,4,2,1,16,18.3,10.39,1975.6,0.06,44,0.1,109.76,17,27,9,11,19,1
33,15,21,17,12,6,69,51.75,55.4,158856.26,0.96,471,0.02,8825.35,179,292,42,26,84,1
1,0,1,1,1,1,2,5.33,1.5,12,0,4,0.67,0.67,1,3,1,3,2,0
7,0,3,4,3,3,10,24.94,10.68,2843.42,0.09,56,0.09,157.97,23,33,14,13,10,1
1,0,0,1,1,1,2,0,0,0,0,5,0,0,0,5,0,5,2,0
1,0,0,1,1,1,0,0,0,0,0,1,0,0,0,1,0,1,0,0
1,0,0,1,1,1,2,0,0,0,0.01,6,0,0,0,6,0,6,2,0
15,10,23,8,6,1,47,55.92,56.28,177090.67,1.05,573,0.02,9838.37,204,369,29,16,57,1
99,32,51,50,21,31,152,66.03,112,828245.12,2.47,1160,0.01,46013.62,440,720,55,28,184,1
11,5,9,6,5,1,39,42.63,26,28814.88,0.37,203,0.04,1600.83,91,112,28,16,44,1
1,0,0,1,1,1,2,9.83,2,39.3,0.01,7,0.5,2.18,3,4,3,4,2,0
3,1,2,2,1,1,12,29.86,6.57,1289.41,0.07,44,0.15,71.63,23,21,14,8,13,0
1,0,0,1,1,1,2,10.44,3.5,127.89,0.01,11,0.29,7.11,3,8,3,7,2,0
1,0,0,1,1,1,2,7.49,3,67.38,0.01,8,0.33,3.74,1,7,1,6,2,0
1,0,0,1,1,1,2,9,3,81,0.01,9,0.33,4.5,2,7,2,6,2,0
1,0,0,1,1,1,2,9,3,81,0.01,9,0.33,4.5,2,7,2,6,2,0
1,0,0,1,1,1,2,9,3,81,0.01,9,0.33,4.5,2,7,2,6,2,0
1,0,0,1,1,1,2,10.44,3.5,127.89,0.01,11,0.29,7.11,3,8,3,7,2,0
1,0,0,1,1,1,2,9,3,81,0.01,9,0.33,4.5,2,7,2,6,2,0
1,0,0,1,1,1,2,9,3,81,0.01,9,0.33,4.5,2,7,2,6,2,0
1,0,0,1,1,1,2,7.49,3,67.38,0.01,8,0.33,3.74,1,7,1,6,2,0
1,0,0,1,1,1,2,7.49,3,67.38,0.01,8,0.33,3.74,1,7,1,6,2,0
1,0,0,1,1,1,2,10,3,90,0.01,10,0.33,5,2,8,2,6,2,0
1,0,0,1,1,1,3,10.44,3.5,127.89,0.01,11,0.29,7.11,3,8,3,7,3,0
1,0,0,1,1,1,3,11.39,3.5,139.52,0.01,12,0.29,7.75,3,9,3,7,3,0
1,0,0,1,1,1,2,9,3,81,0.01,9,0.33,4.5,2,7,2,6,2,0
1,0,0,1,1,1,2,10.44,3.5,127.89,0.01,11,0.29,7.11,3,8,3,7,2,0
1,0,0,1,1,1,2,9,3,81,0.01,9,0.33,4.5,2,7,2,6,2,0
1,0,0,1,1,1,2,9,3,81,0.01,9,0.33,4.5,2,7,2,6,2,0
1,0,0,1,1,1,2,10.44,3.5,127.89,0.01,11,0.29,7.11,3,8,3,7,2,0
1,0,0,1,1,1,2,9,3,81,0.01,9,0.33,4.5,2,7,2,6,2,0
1,0,0,1,1,1,2,9,3,81,0.01,9,0.33,4.5,2,7,2,6,2,0
1,0,0,1,1,1,2,9,3,81,0.01,9,0.33,4.5,2,7,2,6,2,0
1,0,0,1,1,1,2,7.49,3,67.38,0.01,8,0.33,3.74,1,7,1,6,2,0
1,0,0,1,1,1,2,9,3,81,0.01,9,0.33,4.5,2,7,2,6,2,0
1,0,0,1,1,1,2,9,3,81,0.01,9,0.33,4.5,2,7,2,6,2,0
1,0,0,1,1,1,2,10.44,3.5,127.89,0.01,11,0.29,7.11,3,8,3,7,2,0
1,0,0,1,1,1,2,9.05,2,36.19,0.01,7,0.5,2,2,5,2,4,2,0
1,0,0,1,1,1,2,9.05,2,36.19,0.01,7,0.5,2,2,5,2,4,2,0
1,0,0,1,1,1,2,9.05,2,36.19,0.01,7,0.5,2,2,5,2,4,2,0
1,0,0,1,1,1,2,9.05,2,36.19,0.01,7,0.5,2,2,5,2,4,2,0
1,0,0,1,1,1,2,9.05,2,36.19,0.01,7,0.5,2,2,5,2,4,2,0
1,0,0,1,1,1,2,9.05,2,36.19,0.01,7,0.5,2,2,5,2,4,2,0
1,0,0,1,1,1,2,9.05,2,36.19,0.01,7,0.5,2,2,5,2,4,2,0
1,0,0,1,1,1,2,9.05,2,36.19,0.01,7,0.5,2,2,5,2,4,2,0
1,0,0,1,1,1,2,9.05,2,36.19,0.01,7,0.5,2,2,5,2,4,2,0
1,0,0,1,1,1,2,9.05,2,36.19,0.01,7,0.5,2,2,5,2,4,2,0
1,0,0,1,1,1,2,9.05,2,36.19,0.01,7,0.5,2,2,5,2,4,2,0
1,0,0,1,1,1,2,9.05,2,36.19,0.01,7,0.5,2,2,5,2,4,2,0
1,0,0,1,1,1,2,9.05,2,36.19,0.01,7,0.5,2,2,5,2,4,2,0
1,0,0,1,1,1,2,10.44,3.5,127.89,0.01,11,0.29,7.11,3,8,3,7,2,0
1,0,0,1,1,1,2,10.44,3.5,127.89,0.01,11,0.29,7.11,3,8,3,7,2,0
1,0,0,1,1,1,2,9.05,2,36.19,0.01,7,0.5,2,2,5,2,4,2,0
1,0,0,1,1,1,0,0,0,0,0,1,0,0,0,1,0,1,0,0
1,0,0,1,1,1,2,5.33,1.5,12,0,4,0.67,0.67,1,3,1,3,2,0
3,0,0,2,1,1,6,11.86,4.38,227.03,0.02,15,0.23,12.61,5,10,4,7,6,0
3,2,0,2,1,1,6,14.43,5.14,381.76,0.02,19,0.19,21.21,9,10,7,8,8,0
5,1,0,3,1,1,10,12.67,10,1267.11,0.04,31,0.1,70.4,14,17,7,10,11,0
3,1,0,2,1,1,6,11.71,4.9,281.06,0.02,16,0.2,15.61,7,9,5,7,7,0
3,1,0,2,1,1,6,11.71,4.9,281.06,0.02,16,0.2,15.61,7,9,5,7,7,0
1,0,0,1,1,1,2,5.33,1.5,12,0,4,0.67,0.67,1,3,1,3,2,0
1,0,0,1,1,1,2,5.33,1.5,12,0,4,0.67,0.67,1,3,1,3,2,0
3,1,0,2,1,1,6,11.23,5.6,352.28,0.02,17,0.18,19.57,7,10,5,8,7,0
7,1,1,4,1,3,13,18.91,10.45,2065.48,0.07,45,0.1,114.75,19,26,10,11,14,0
5,1,0,3,1,1,10,13.33,9,1080,0.04,30,0.11,60,14,16,7,9,11,0
3,1,0,2,1,1,6,11.71,4.9,281.06,0.02,16,0.2,15.61,7,9,5,7,7,0
7,1,1,4,1,3,13,18.91,10.45,2065.48,0.07,45,0.1,114.75,19,26,10,11,14,0
3,1,0,2,1,1,6,11.71,4.9,281.06,0.02,16,0.2,15.61,7,9,5,7,7,0
3,0,0,2,1,1,6,11.86,4.38,227.03,0.02,15,0.23,12.61,5,10,4,7,6,0
3,2,0,2,1,1,7,16.73,5.5,506,0.03,23,0.18,28.11,11,12,8,8,9,0
1,0,0,1,1,1,2,5.33,1.5,12,0,4,0.67,0.67,1,3,1,3,2,0
9,6,0,5,1,1,14,23.12,11.15,2875.94,0.09,57,0.09,159.77,29,28,13,10,20,0
3,1,0,2,1,1,7,14.43,5.14,381.76,0.02,19,0.19,21.21,9,10,7,8,8,0
7,1,1,4,1,3,13,19.62,10,1962.15,0.07,44,0.1,109.01,20,24,11,11,14,0
1,0,0,1,1,1,2,5.33,1.5,12,0,4,0.67,0.67,1,3,1,3,2,0
1,0,0,1,1,1,2,5.33,1.5,12,0,4,0.67,0.67,1,3,1,3,2,0
1,0,0,1,1,1,2,5.33,1.5,12,0,4,0.67,0.67,1,3,1,3,2,0
1,0,0,1,1,1,2,5.33,1.5,12,0,4,0.67,0.67,1,3,1,3,2,0
1,0,0,1,1,1,2,5.33,1.5,12,0,4,0.67,0.67,1,3,1,3,2,0
1,0,0,1,1,1,2,5.33,1.5,12,0,4,0.67,0.67,1,3,1,3,2,0
1,0,0,1,1,1,2,5.33,1.5,12,0,4,0.67,0.67,1,3,1,3,2,0
3,1,0,2,1,1,5,10.95,6,394.38,0.02,19,0.17,21.91,10,9,5,6,6,0
3,1,0,2,1,1,5,10.95,6,394.38,0.02,19,0.17,21.91,10,9,5,6,6,0
3,1,0,2,1,1,5,10.95,6,394.38,0.02,19,0.17,21.91,10,9,5,6,6,0
3,1,0,2,1,1,5,10.95,6,394.38,0.02,19,0.17,21.91,10,9,5,6,6,0
3,1,1,2,1,1,5,10.95,6,394.38,0.02,19,0.17,21.91,10,9,5,6,6,0
1,0,0,1,1,1,3,13,3,117,0.01,13,0.33,6.5,6,7,4,4,3,0
1,0,0,1,1,1,2,11.07,3,99.66,0.01,10,0.33,5.54,4,6,4,6,2,0
1,0,0,1,1,1,2,7.74,1.5,17.41,0,5,0.67,0.97,2,3,2,3,2,0
3,0,1,2,1,1,8,16.92,4.5,342.66,0.03,20,0.22,19.04,9,11,7,7,8,0
3,1,0,2,1,1,7,16.92,4.5,342.66,0.03,20,0.22,19.04,9,11,7,7,8,0
1,0,0,1,1,1,2,11.41,2.5,71.32,0.01,9,0.4,3.96,4,5,4,5,2,0
3,1,0,2,1,1,5,10.95,6,394.38,0.02,19,0.17,21.91,10,9,5,6,6,0
1,0,0,1,1,1,4,16.51,4.8,380.39,0.03,25,0.21,21.13,12,13,5,4,4,0
1,0,0,1,1,1,2,7.74,1.5,17.41,0,5,0.67,0.97,2,3,2,3,2,0
3,1,0,2,1,1,5,10.95,6,394.38,0.02,19,0.17,21.91,10,9,5,6,6,0
3,1,0,2,1,1,5,10.95,6,394.38,0.02,19,0.17,21.91,10,9,5,6,6,0
1,0,0,1,1,1,2,9.83,2,39.3,0.01,7,0.5,2.18,3,4,3,4,2,0
5,3,2,3,3,1,13,42.66,7.29,2269.48,0.1,67,0.14,126.08,31,36,17,8,16,1
7,17,3,4,3,1,11,56.43,8.56,4130.7,0.16,92,0.12,229.48,42,50,27,11,28,1
5,3,1,3,2,1,9,30.59,5.83,1040.74,0.06,42,0.17,57.82,20,22,12,7,12,1
54,34,15,33,30,9,218,99.63,63,395422.98,2.09,891,0.02,21967.94,378,513,99,33,252,1
1,0,0,1,1,1,1,0,0,0,0,1,0,0,0,1,0,1,1,0
25,15,7,1,1,1,48,49.38,24.24,29021.46,0.4,209,0.04,1612.3,80,129,33,20,63,0
3,2,0,2,2,1,6,21.94,5.83,746.67,0.04,32,0.17,41.48,15,17,9,7,8,0
55,37,19,28,15,23,116,96.28,43.05,178420.08,1.38,628,0.02,9912.23,277,351,74,23,153,1
3,10,4,2,2,1,13,32.04,14.95,7164.3,0.16,95,0.07,398.02,46,49,20,13,23,1
32,25,5,19,16,16,112,55.88,57.3,183485.55,1.07,519,0.02,10193.64,191,328,45,27,137,1
5,18,5,3,3,1,19,47.29,18,15322.27,0.28,155,0.06,851.24,72,83,30,15,37,1
3,2,1,2,2,1,7,19.92,5.69,644.39,0.04,29,0.18,35.8,13,16,8,7,9,1
11,11,1,1,1,1,34,50.41,21.37,23025.22,0.36,189,0.05,1279.18,88,101,35,17,45,1
3,4,2,1,1,1,12,37.74,5.91,1316.53,0.07,48,0.17,73.14,21,27,16,9,16,1
5,3,1,3,3,1,15,46.15,7.33,2481.83,0.11,72,0.14,137.88,33,39,18,8,18,1
1,0,0,1,1,1,2,7.86,2.5,49.13,0.01,7,0.4,2.73,2,5,2,5,2,0
1,0,0,1,1,1,2,7.49,3,67.38,0.01,8,0.33,3.74,1,7,1,6,2,0
1,0,0,1,1,1,2,7.49,3,67.38,0.01,8,0.33,3.74,1,7,1,6,2,0
1,0,0,1,1,1,2,7.49,3,67.38,0.01,8,0.33,3.74,1,7,1,6,2,0
1,0,0,1,1,1,2,7.49,3,67.38,0.01,8,0.33,3.74,1,7,1,6,2,0
1,0,0,1,1,1,2,7.49,3,67.38,0.01,8,0.33,3.74,1,7,1,6,2,0
1,0,0,1,1,1,2,7.49,3,67.38,0.01,8,0.33,3.74,1,7,1,6,2,0
1,0,0,1,1,1,2,7.49,3,67.38,0.01,8,0.33,3.74,1,7,1,6,2,0
1,0,0,1,1,1,2,10.57,3,95.1,0.01,10,0.33,5.28,3,7,3,6,2,0
1,0,0,1,1,1,0,0,0,0,0,1,0,0,0,1,0,1,0,0
1,0,0,1,1,1,2,5.33,1.5,12,0,4,0.67,0.67,1,3,1,3,2,0
1,0,0,1,1,1,2,5.33,1.5,12,0,4,0.67,0.67,1,3,1,3,2,0
1,0,0,1,1,1,2,5.33,1.5,12,0,4,0.67,0.67,1,3,1,3,2,0
1,0,0,1,1,1,2,5.33,1.5,12,0,4,0.67,0.67,1,3,1,3,2,0
1,0,0,1,1,1,2,5.33,1.5,12,0,4,0.67,0.67,1,3,1,3,2,0
1,0,0,1,1,1,2,5.33,1.5,12,0,4,0.67,0.67,1,3,1,3,2,0
1,0,0,1,1,1,2,5.33,1.5,12,0,4,0.67,0.67,1,3,1,3,2,0
1,0,0,1,1,1,2,13.95,2.5,87.17,0.01,11,0.4,4.84,4,7,4,5,2,0
13,0,3,7,3,6,25,33.09,17,9563.23,0.19,105,0.06,531.29,48,57,24,17,25,0
11,0,1,6,3,5,26,37.03,12.75,6019.08,0.16,87,0.08,334.39,39,48,26,17,26,0
5,0,0,3,1,1,2,13.29,4.5,269.08,0.02,18,0.22,14.95,6,12,4,6,2,0
1,0,1,1,1,1,2,16.92,3.5,207.22,0.02,16,0.29,11.51,6,10,6,7,2,0
1,0,0,1,1,1,2,0,0,0,0,5,0,0,0,5,0,5,2,0
1,0,0,1,1,1,0,0,0,0,0,1,0,0,0,1,0,1,0,0
1,0,0,1,1,1,2,0,0,0,0.01,6,0,0,0,6,0,6,2,0
1,0,0,1,1,1,0,0,0,0,0,1,0,0,0,1,0,1,0,0
1,0,3,1,1,1,2,5.33,1.5,12,0,4,0.67,0.67,1,3,1,3,2,0
1,0,0,1,1,1,2,5.33,1.5,12,0,4,0.67,0.67,1,3,1,3,2,0
3,1,0,2,1,1,6,11.71,4.9,281.06,0.02,16,0.2,15.61,7,9,5,7,7,0
1,0,1,1,1,1,2,5.33,1.5,12,0,4,0.67,0.67,1,3,1,3,2,0
1,0,0,1,1,1,2,5.33,1.5,12,0,4,0.67,0.67,1,3,1,3,2,0
1,0,0,1,1,1,2,6.97,2,27.86,0,6,0.5,1.55,1,5,1,4,2,0
1,0,1,1,1,1,2,10.8,2.5,67.5,0.01,9,0.4,3.75,3,6,3,5,2,0
1,0,0,1,1,1,2,9.05,2,36.19,0.01,7,0.5,2,2,5,2,4,2,0
1,0,0,1,1,1,2,7.49,3,67.38,0.01,8,0.33,3.74,1,7,1,6,2,0
1,0,0,1,1,1,2,9,3,81,0.01,9,0.33,4.5,2,7,2,6,2,0
1,0,0,1,1,1,2,9,3,81,0.01,9,0.33,4.5,2,7,2,6,2,0
1,0,0,1,1,1,2,7.49,3,67.38,0.01,8,0.33,3.74,1,7,1,6,2,0
1,0,0,1,1,1,2,10.8,2.5,67.5,0.01,9,0.4,3.75,3,6,3,5,2,0
1,0,0,1,1,1,2,9,3,81,0.01,9,0.33,4.5,2,7,2,6,2,0
1,0,0,1,1,1,2,9.05,2,36.19,0.01,7,0.5,2,2,5,2,4,2,0
1,0,0,1,1,1,2,9.05,2,36.19,0.01,7,0.5,2,2,5,2,4,2,0
1,0,0,1,1,1,0,0,0,0,0,1,0,0,0,1,0,1,0,0
1,0,0,1,1,1,2,5.33,1.5,12,0,4,0.67,0.67,1,3,1,3,2,0
1,0,0,1,1,1,2,8,3,72,0.01,8,0.33,4,2,6,2,6,2,0
1,0,0,1,1,1,2,0,0,0,0,5,0,0,0,5,0,5,2,0
1,0,0,1,1,1,0,0,0,0,0,1,0,0,0,1,0,1,0,0
1,0,0,1,1,1,2,0,0,0,0.01,6,0,0,0,6,0,6,2,0
1,0,0,1,1,1,2,7.75,2,31.02,0.01,6,0.5,1.72,2,4,2,4,2,0
1,0,0,1,1,1,2,7.74,1.5,17.41,0,5,0.67,0.97,2,3,2,3,2,0
1,1,1,1,1,1,1,0,0,0,0,1,0,0,1,0,1,0,2,0
3,1,0,2,1,1,7,12.44,4.9,298.63,0.02,17,0.2,16.59,7,10,5,7,8,0
1,0,0,1,1,1,0,0,0,0,0,1,0,0,0,1,0,1,0,0
3,1,0,2,2,1,6,10.88,6.3,431.75,0.02,18,0.16,23.99,7,11,5,9,7,0
1,0,0,1,1,1,2,5.33,1.5,12,0,4,0.67,0.67,1,3,1,3,2,0
1,0,0,1,1,1,2,0,0,0,0,5,0,0,0,5,0,5,2,0
1,0,0,1,1,1,0,0,0,0,0,1,0,0,0,1,0,1,0,0
1,0,0,1,1,1,2,0,0,0,0.01,6,0,0,0,6,0,6,2,0
1,0,3,1,1,1,4,0,0,0,0,3,0,0,3,0,2,0,4,0
1,0,0,1,1,1,0,0,0,0,0,1,0,0,0,1,0,1,0,0
3,2,1,2,1,1,5,10.33,4.5,209.28,0.02,14,0.22,11.63,6,8,4,6,7,0
3,1,0,2,1,1,6,13.45,3.6,174.36,0.02,14,0.28,9.69,6,8,5,6,7,0
1,0,0,1,1,1,2,0,0,0,0,5,0,0,0,5,0,5,2,0
1,0,0,1,1,1,0,0,0,0,0,1,0,0,0,1,0,1,0,0
1,0,0,1,1,1,2,0,0,0,0.01,6,0,0,0,6,0,6,2,0
1,0,0,1,1,1,0,0,0,0,0,1,0,0,0,1,0,1,0,0
1,0,0,1,1,1,2,6.55,3,58.95,0.01,7,0.33,3.28,1,6,1,6,2,0
1,0,0,1,1,1,2,5.33,1.5,12,0,4,0.67,0.67,1,3,1,3,2,0
1,0,0,1,1,1,2,8,3,72,0.01,8,0.33,4,2,6,2,6,2,0
1,0,0,1,1,1,2,9,3,81,0.01,9,0.33,4.5,2,7,2,6,2,0
1,0,0,1,1,1,2,8,3,72,0.01,8,0.33,4,2,6,2,6,2,0
1,0,0,1,1,1,2,9.49,3.5,116.27,0.01,10,0.29,6.46,3,7,3,7,2,0
1,0,0,1,1,1,2,11.86,3.5,145.3,0.01,12,0.29,8.07,4,8,4,7,2,0
1,0,0,1,1,1,2,0,0,0,0,5,0,0,0,5,0,5,2,0
1,0,0,1,1,1,0,0,0,0,0,1,0,0,0,1,0,1,0,0
1,0,0,1,1,1,2,0,0,0,0.01,6,0,0,0,6,0,6,2,0
1,0,0,1,1,1,2,7.75,2,31.02,0.01,6,0.5,1.72,2,4,2,4,2,0
1,0,0,1,1,1,3,10.8,3.33,120,0.01,12,0.3,6.67,4,8,3,5,3,0
1,0,0,1,1,1,2,7.75,2,31.02,0.01,6,0.5,1.72,2,4,2,4,2,0
1,0,0,1,1,1,3,12.68,2.5,79.25,0.01,10,0.4,4.4,4,6,4,5,3,0
1,3,1,1,1,1,1,0,0,0,0,1,0,0,1,0,1,0,4,0
1,0,0,1,1,1,2,6.55,3,58.95,0.01,7,0.33,3.28,1,6,1,6,2,0
1,0,0,1,1,1,0,0,0,0,0,1,0,0,0,1,0,1,0,0
1,0,0,1,1,1,2,8,3,72,0.01,8,0.33,4,2,6,2,6,2,0
1,0,0,1,1,1,2,9,3,81,0.01,9,0.33,4.5,2,7,2,6,2,0
1,0,0,1,1,1,2,5.33,1.5,12,0,4,0.67,0.67,1,3,1,3,2,0
1,0,0,1,1,1,2,5.33,1.5,12,0,4,0.67,0.67,1,3,1,3,2,0
1,0,0,1,1,1,2,6.55,3,58.95,0.01,7,0.33,3.28,1,6,1,6,2,0
1,0,0,1,1,1,2,5.33,1.5,12,0,4,0.67,0.67,1,3,1,3,2,0
1,0,0,1,1,1,2,5.33,1.5,12,0,4,0.67,0.67,1,3,1,3,2,0
1,0,0,1,1,1,2,6.55,3,58.95,0.01,7,0.33,3.28,1,6,1,6,2,0
1,0,0,1,1,1,2,0,0,0,0,5,0,0,0,5,0,5,2,0
1,0,0,1,1,1,0,0,0,0,0,1,0,0,0,1,0,1,0,0
1,0,0,1,1,1,2,0,0,0,0.01,6,0,0,0,6,0,6,2,0
1,0,0,1,1,1,0,0,0,0,0,1,0,0,0,1,0,1,0,0
1,0,1,1,1,1,2,9.51,3,85.59,0.01,9,0.33,4.75,3,6,3,6,2,0
1,0,0,1,1,1,2,0,0,0,0,5,0,0,0,5,0,5,2,0
1,0,0,1,1,1,0,0,0,0,0,1,0,0,0,1,0,1,0,0
1,0,0,1,1,1,2,0,0,0,0.01,6,0,0,0,6,0,6,2,0
1,0,0,1,1,1,2,5.33,1.5,12,0,4,0.67,0.67,1,3,1,3,2,0
15,2,4,8,1,8,22,25.47,20.5,10704.33,0.17,101,0.05,594.68,41,60,18,18,24,0
5,0,0,3,2,3,11,22.01,8.18,1473.42,0.06,41,0.12,81.86,18,23,11,10,11,0
5,0,0,3,2,3,11,22.01,8.18,1473.42,0.06,41,0.12,81.86,18,23,11,10,11,0
12,0,1,9,8,3,37,32.34,19.58,12402.01,0.21,116,0.05,689,47,69,24,20,37,0
3,0,0,2,1,1,6,13.67,6.29,540.27,0.03,22,0.16,30.01,11,11,7,8,6,0
3,0,0,2,1,1,8,16.21,7.31,866.8,0.04,29,0.14,48.16,13,16,8,9,8,0
11,0,0,6,1,6,18,34.6,17.18,10215.3,0.2,115,0.06,567.52,54,61,22,14,18,0
3,0,0,2,1,1,10,28.55,7.38,1556.91,0.07,48,0.14,86.49,24,24,13,8,10,0
3,0,0,2,1,1,10,28.55,7.38,1556.91,0.07,48,0.14,86.49,24,24,13,8,10,0
3,0,0,2,1,1,8,16.21,7.31,866.8,0.04,29,0.14,48.16,13,16,8,9,8,0
3,0,0,2,1,1,6,13.67,6.29,540.27,0.03,22,0.16,30.01,11,11,7,8,6,0
3,0,0,2,1,1,6,13.67,6.29,540.27,0.03,22,0.16,30.01,11,11,7,8,6,0
3,0,0,2,1,1,8,16.21,7.31,866.8,0.04,29,0.14,48.16,13,16,8,9,8,0
3,0,0,2,1,1,8,16.21,7.31,866.8,0.04,29,0.14,48.16,13,16,8,9,8,0
3,0,0,2,1,1,8,16.21,7.31,866.8,0.04,29,0.14,48.16,13,16,8,9,8,0
3,0,0,2,1,1,6,13.67,6.29,540.27,0.03,22,0.16,30.01,11,11,7,8,6,0
3,0,0,2,1,1,8,16.21,7.31,866.8,0.04,29,0.14,48.16,13,16,8,9,8,0
3,0,0,2,1,1,8,16.21,7.31,866.8,0.04,29,0.14,48.16,13,16,8,9,8,0
3,0,0,2,1,1,6,13.67,6.29,540.27,0.03,22,0.16,30.01,11,11,7,8,6,0
3,0,0,2,1,1,8,16.21,7.31,866.8,0.04,29,0.14,48.16,13,16,8,9,8,0
3,0,0,2,1,1,8,16.21,7.31,866.8,0.04,29,0.14,48.16,13,16,8,9,8,0
1,0,0,1,1,1,2,7.74,1.5,17.41,0,5,0.67,0.97,2,3,2,3,2,0
1,0,0,1,1,1,2,5.8,2,23.22,0,5,0.5,1.29,1,4,1,4,2,0
1,0,0,1,1,1,2,5.33,1.5,12,0,4,0.67,0.67,1,3,1,3,2,0
19,13,17,10,8,1,59,108.55,16.12,28223.56,0.58,281,0.06,1567.98,129,152,60,15,72,1
7,2,6,4,2,1,16,25,11.6,3364.56,0.1,61,0.09,186.92,29,32,15,12,18,1
5,3,5,3,1,1,13,24.01,10.93,2867.29,0.09,58,0.09,159.29,34,24,14,9,16,0
1,0,0,1,1,1,1,0,0,0,0,1,0,0,0,1,0,1,1,0
1,0,2,1,1,1,1535,14763.91,11.83,2066032.71,58.22,15682,0.08,114779.6,4820,10862,2241,11,1535,0
1,0,0,1,1,1,5,6.18,15,1389.64,0.03,33,0.07,77.2,12,21,2,5,5,0
1,0,0,1,1,1,3,6.36,7.5,357.94,0.02,17,0.13,19.89,6,11,2,5,3,0
1,0,0,1,1,1,1,0,0,0,0,1,0,0,0,1,0,1,1,0
1,0,0,1,1,1,5,6.18,15,1389.64,0.03,33,0.07,77.2,12,21,2,5,5,0
1,0,0,1,1,1,3,6.36,7.5,357.94,0.02,17,0.13,19.89,6,11,2,5,3,0
1,0,0,1,1,1,1,0,0,0,0,1,0,0,0,1,0,1,1,0
1,0,0,1,1,1,5,6.18,15,1389.64,0.03,33,0.07,77.2,12,21,2,5,5,0
1,18,0,1,1,1,1,50.11,12.46,7781.55,0.21,147,0.08,432.31,54,93,13,6,19,0
1,0,0,1,1,1,1,0,0,0,0,1,0,0,0,1,0,1,1,0
1,0,0,1,1,1,1,0,0,0,0,1,0,0,0,1,0,1,1,0
31,11,11,16,1,12,34,18.94,38.08,27457.39,0.24,150,0.03,1525.41,66,84,13,15,45,1
5,0,0,3,1,1,2,13.29,4.5,269.08,0.02,18,0.22,14.95,6,12,4,6,2,0
1,0,1,1,1,1,2,16.92,3.5,207.22,0.02,16,0.29,11.51,6,10,6,7,2,0
7,1,0,4,1,1,14,26.1,5.95,924.18,0.05,38,0.17,51.34,17,21,10,7,15,0
7,6,0,4,1,1,7,17.58,10.83,2062.65,0.06,41,0.09,114.59,20,21,12,13,13,0
1,0,0,1,1,1,2,0,0,0,0,5,0,0,0,5,0,5,2,0
1,0,0,1,1,1,0,0,0,0,0,1,0,0,0,1,0,1,0,0
1,0,0,1,1,1,2,0,0,0,0.01,6,0,0,0,6,0,6,2,0
1,0,0,1,1,1,2,0,0,0,0.01,6,0,0,0,6,0,6,2,0
1,0,0,1,1,1,2,0,0,0,0.01,6,0,0,0,6,0,6,2,0
1,0,0,1,1,1,0,0,0,0,0,1,0,0,0,1,0,1,0,0
1,0,3,1,1,1,2,5.33,1.5,12,0,4,0.67,0.67,1,3,1,3,2,0
1,0,0,1,1,1,2,5.33,1.5,12,0,4,0.67,0.67,1,3,1,3,2,0
3,1,0,2,1,1,6,11.71,4.9,281.06,0.02,16,0.2,15.61,7,9,5,7,7,0
1,0,1,1,1,1,2,5.33,1.5,12,0,4,0.67,0.67,1,3,1,3,2,0
1,0,0,1,1,1,2,5.33,1.5,12,0,4,0.67,0.67,1,3,1,3,2,0
1,0,0,1,1,1,2,6.97,2,27.86,0,6,0.5,1.55,1,5,1,4,2,0
1,0,1,1,1,1,2,10.8,2.5,67.5,0.01,9,0.4,3.75,3,6,3,5,2,0
1,0,0,1,1,1,2,9.05,2,36.19,0.01,7,0.5,2,2,5,2,4,2,0
1,0,0,1,1,1,2,7.49,3,67.38,0.01,8,0.33,3.74,1,7,1,6,2,0
1,0,0,1,1,1,2,9,3,81,0.01,9,0.33,4.5,2,7,2,6,2,0
1,0,0,1,1,1,2,9,3,81,0.01,9,0.33,4.5,2,7,2,6,2,0
1,0,0,1,1,1,2,7.49,3,67.38,0.01,8,0.33,3.74,1,7,1,6,2,0
1,0,0,1,1,1,2,10.8,2.5,67.5,0.01,9,0.4,3.75,3,6,3,5,2,0
1,0,0,1,1,1,2,9,3,81,0.01,9,0.33,4.5,2,7,2,6,2,0
1,0,0,1,1,1,2,9.05,2,36.19,0.01,7,0.5,2,2,5,2,4,2,0
1,0,0,1,1,1,2,9.05,2,36.19,0.01,7,0.5,2,2,5,2,4,2,0
1,0,1,1,1,1,2,7.24,2.5,45.24,0.01,7,0.4,2.51,1,6,1,5,2,0
1,0,1,1,1,1,2,10.8,2.5,67.5,0.01,9,0.4,3.75,3,6,3,5,2,0
1,0,1,1,1,1,2,8.98,2.5,56.15,0.01,8,0.4,3.12,2,6,2,5,2,0
1,0,0,1,1,1,0,0,0,0,0,1,0,0,0,1,0,1,0,0
1,0,2,1,1,1,3,4.14,5,103.4,0.01,8,0.2,5.74,2,6,1,5,3,0
1,0,1,1,1,1,2,5.33,1.5,12,0,4,0.67,0.67,1,3,1,3,2,0
1,0,1,1,1,1,2,6.2,2.5,38.77,0.01,6,0.4,2.15,1,5,1,5,2,0
1,0,1,1,1,1,2,7.74,1.5,17.41,0,5,0.67,0.97,2,3,2,3,2,0
1,0,1,1,1,1,2,9.05,2,36.19,0.01,7,0.5,2,2,5,2,4,2,0
1,0,1,1,1,1,2,9.05,2,36.19,0.01,7,0.5,2,2,5,2,4,2,0
1,0,1,1,1,1,2,9.05,2,36.19,0.01,7,0.5,2,2,5,2,4,2,0
1,0,1,1,1,1,2,10.8,2.5,67.5,0.01,9,0.4,3.75,3,6,3,5,2,0
1,0,1,1,1,1,2,6.97,2,27.86,0,6,0.5,1.55,1,5,1,4,2,0
1,0,1,1,1,1,2,6.97,2,27.86,0,6,0.5,1.55,1,5,1,4,2,0
1,0,0,1,1,1,1,0,0,0,0,1,0,0,0,1,0,1,1,0
1,0,0,1,1,1,0,0,0,0,0,1,0,0,0,1,0,1,0,0
3,1,0,2,1,1,6,11.71,4.9,281.06,0.02,16,0.2,15.61,7,9,5,7,7,0
3,1,0,2,1,1,6,11.71,4.9,281.06,0.02,16,0.2,15.61,7,9,5,7,7,0
1,0,0,1,1,1,2,5.33,1.5,12,0,4,0.67,0.67,1,3,1,3,2,0
3,1,0,2,1,1,6,11.71,4.9,281.06,0.02,16,0.2,15.61,7,9,5,7,7,0
1,0,0,1,1,1,2,6.97,2,27.86,0,6,0.5,1.55,1,5,1,4,2,0
1,0,0,1,1,1,0,0,0,0,0,1,0,0,0,1,0,1,0,0
1,0,0,1,1,1,2,5.33,1.5,12,0,4,0.67,0.67,1,3,1,3,2,0
1,0,0,1,1,1,2,8,3,72,0.01,8,0.33,4,2,6,2,6,2,0
1,0,0,1,1,1,2,0,0,0,0,5,0,0,0,5,0,5,2,0
1,0,0,1,1,1,0,0,0,0,0,1,0,0,0,1,0,1,0,0
1,0,0,1,1,1,2,0,0,0,0.01,6,0,0,0,6,0,6,2,0
1,0,0,1,1,1,2,7.75,2,31.02,0.01,6,0.5,1.72,2,4,2,4,2,0
1,0,0,1,1,1,2,7.74,1.5,17.41,0,5,0.67,0.97,2,3,2,3,2,0
1,1,1,1,1,1,1,0,0,0,0,1,0,0,1,0,1,0,2,0
3,1,0,2,1,1,7,12.44,4.9,298.63,0.02,17,0.2,16.59,7,10,5,7,8,0
1,0,0,1,1,1,0,0,0,0,0,1,0,0,0,1,0,1,0,0
3,1,0,2,2,1,6,10.88,6.3,431.75,0.02,18,0.16,23.99,7,11,5,9,7,0
1,0,0,1,1,1,2,5.33,1.5,12,0,4,0.67,0.67,1,3,1,3,2,0
1,0,0,1,1,1,2,0,0,0,0,5,0,0,0,5,0,5,2,0
1,0,0,1,1,1,0,0,0,0,0,1,0,0,0,1,0,1,0,0
1,0,0,1,1,1,2,0,0,0,0.01,6,0,0,0,6,0,6,2,0
1,0,3,1,1,1,4,0,0,0,0,3,0,0,3,0,3,0,4,0
1,0,0,1,1,1,0,0,0,0,0,1,0,0,0,1,0,1,0,0
3,2,1,2,1,1,5,10.33,4.5,209.28,0.02,14,0.22,11.63,6,8,4,6,7,0
3,1,0,2,1,1,6,13.45,3.6,174.36,0.02,14,0.28,9.69,6,8,5,6,7,0
1,0,0,1,1,1,2,0,0,0,0,5,0,0,0,5,0,5,2,0
1,0,0,1,1,1,0,0,0,0,0,1,0,0,0,1,0,1,0,0
1,0,0,1,1,1,2,0,0,0,0.01,6,0,0,0,6,0,6,2,0
1,0,0,1,1,1,0,0,0,0,0,1,0,0,0,1,0,1,0,0
1,0,0,1,1,1,2,6.55,3,58.95,0.01,7,0.33,3.28,1,6,1,6,2,0
1,0,0,1,1,1,2,5.33,1.5,12,0,4,0.67,0.67,1,3,1,3,2,0
1,0,0,1,1,1,2,8,3,72,0.01,8,0.33,4,2,6,2,6,2,0
1,0,0,1,1,1,2,9,3,81,0.01,9,0.33,4.5,2,7,2,6,2,0
1,0,0,1,1,1,2,8,3,72,0.01,8,0.33,4,2,6,2,6,2,0
1,0,0,1,1,1,2,9.49,3.5,116.27,0.01,10,0.29,6.46,3,7,3,7,2,0
1,0,0,1,1,1,2,11.86,3.5,145.3,0.01,12,0.29,8.07,4,8,4,7,2,0
1,0,0,1,1,1,2,0,0,0,0,5,0,0,0,5,0,5,2,0
1,0,0,1,1,1,0,0,0,0,0,1,0,0,0,1,0,1,0,0
1,0,0,1,1,1,2,0,0,0,0.01,6,0,0,0,6,0,6,2,0
1,0,0,1,1,1,2,7.75,2,31.02,0.01,6,0.5,1.72,2,4,2,4,2,0
1,0,0,1,1,1,3,10.8,3.33,120,0.01,12,0.3,6.67,4,8,3,5,3,0
1,0,0,1,1,1,2,7.75,2,31.02,0.01,6,0.5,1.72,2,4,2,4,2,0
1,0,0,1,1,1,3,12.68,2.5,79.25,0.01,10,0.4,4.4,4,6,4,5,3,0
1,3,1,1,1,1,1,0,0,0,0,1,0,0,1,0,1,0,4,0
1,0,0,1,1,1,2,6.55,3,58.95,0.01,7,0.33,3.28,1,6,1,6,2,0
1,0,0,1,1,1,0,0,0,0,0,1,0,0,0,1,0,1,0,0
1,0,0,1,1,1,2,8,3,72,0.01,8,0.33,4,2,6,2,6,2,0
1,0,0,1,1,1,2,9,3,81,0.01,9,0.33,4.5,2,7,2,6,2,0
1,0,0,1,1,1,2,5.33,1.5,12,0,4,0.67,0.67,1,3,1,3,2,0
1,0,0,1,1,1,2,5.33,1.5,12,0,4,0.67,0.67,1,3,1,3,2,0
1,0,0,1,1,1,2,6.55,3,58.95,0.01,7,0.33,3.28,1,6,1,6,2,0
1,0,0,1,1,1,2,5.33,1.5,12,0,4,0.67,0.67,1,3,1,3,2,0
1,0,0,1,1,1,2,5.33,1.5,12,0,4,0.67,0.67,1,3,1,3,2,0
1,0,0,1,1,1,2,6.55,3,58.95,0.01,7,0.33,3.28,1,6,1,6,2,0
1,0,0,1,1,1,2,0,0,0,0,5,0,0,0,5,0,5,2,0
1,0,0,1,1,1,0,0,0,0,0,1,0,0,0,1,0,1,0,0
1,0,0,1,1,1,2,0,0,0,0.01,6,0,0,0,6,0,6,2,0
1,0,0,1,1,1,0,0,0,0,0,1,0,0,0,1,0,1,0,0
1,0,1,1,1,1,2,9.51,3,85.59,0.01,9,0.33,4.75,3,6,3,6,2,0
1,0,0,1,1,1,2,0,0,0,0,5,0,0,0,5,0,5,2,0
1,0,0,1,1,1,0,0,0,0,0,1,0,0,0,1,0,1,0,0
1,0,0,1,1,1,2,0,0,0,0.01,6,0,0,0,6,0,6,2,0
1,0,0,1,1,1,2,9.05,2,36.19,0.01,7,0.5,2,2,5,2,4,2,1
1,0,0,1,1,1,2,10.44,3.5,127.89,0.01,11,0.29,7.11,3,8,3,7,2,0
1,0,0,1,1,1,2,7.49,3,67.38,0.01,8,0.33,3.74,1,7,1,6,2,0
1,0,0,1,1,1,2,7.49,3,67.38,0.01,8,0.33,3.74,1,7,1,6,2,0
1,0,0,1,1,1,2,9,3,81,0.01,9,0.33,4.5,2,7,2,6,2,0
1,0,0,1,1,1,2,9,3,81,0.01,9,0.33,4.5,2,7,2,6,2,0
1,0,0,1,1,1,2,9,3,81,0.01,9,0.33,4.5,2,7,2,6,2,0
1,0,0,1,1,1,2,10.44,3.5,127.89,0.01,11,0.29,7.11,3,8,3,7,2,0
1,0,0,1,1,1,2,9,3,81,0.01,9,0.33,4.5,2,7,2,6,2,0
1,0,0,1,1,1,2,9,3,81,0.01,9,0.33,4.5,2,7,2,6,2,0
1,0,0,1,1,1,2,7.49,3,67.38,0.01,8,0.33,3.74,1,7,1,6,2,0
1,0,0,1,1,1,2,7.49,3,67.38,0.01,8,0.33,3.74,1,7,1,6,2,0
1,0,0,1,1,1,2,10,3,90,0.01,10,0.33,5,2,8,2,6,2,0
1,0,0,1,1,1,3,10.44,3.5,127.89,0.01,11,0.29,7.11,3,8,3,7,3,0
1,0,0,1,1,1,3,11.39,3.5,139.52,0.01,12,0.29,7.75,3,9,3,7,3,0
1,0,0,1,1,1,2,9,3,81,0.01,9,0.33,4.5,2,7,2,6,2,0
1,0,0,1,1,1,2,10.44,3.5,127.89,0.01,11,0.29,7.11,3,8,3,7,2,0
1,0,0,1,1,1,2,9,3,81,0.01,9,0.33,4.5,2,7,2,6,2,0
1,0,0,1,1,1,2,9,3,81,0.01,9,0.33,4.5,2,7,2,6,2,0
1,0,0,1,1,1,2,10.44,3.5,127.89,0.01,11,0.29,7.11,3,8,3,7,2,0
1,0,0,1,1,1,2,9,3,81,0.01,9,0.33,4.5,2,7,2,6,2,0
1,0,0,1,1,1,2,9,3,81,0.01,9,0.33,4.5,2,7,2,6,2,0
1,0,0,1,1,1,2,9,3,81,0.01,9,0.33,4.5,2,7,2,6,2,0
1,0,0,1,1,1,2,7.49,3,67.38,0.01,8,0.33,3.74,1,7,1,6,2,0
1,0,0,1,1,1,2,9,3,81,0.01,9,0.33,4.5,2,7,2,6,2,0
1,0,0,1,1,1,2,9,3,81,0.01,9,0.33,4.5,2,7,2,6,2,0
1,0,0,1,1,1,2,10.44,3.5,127.89,0.01,11,0.29,7.11,3,8,3,7,2,0
1,1,1,1,1,1,3,9,3.33,100,0.01,10,0.3,5.56,4,6,3,5,4,1
1,0,0,1,1,1,2,9.05,2,36.19,0.01,7,0.5,2,2,5,2,4,2,0
1,0,0,1,1,1,2,9.05,2,36.19,0.01,7,0.5,2,2,5,2,4,2,0
1,0,0,1,1,1,2,9.05,2,36.19,0.01,7,0.5,2,2,5,2,4,2,0
1,0,0,1,1,1,2,9.05,2,36.19,0.01,7,0.5,2,2,5,2,4,2,0
1,0,0,1,1,1,2,9.05,2,36.19,0.01,7,0.5,2,2,5,2,4,2,0
1,0,0,1,1,1,2,9.05,2,36.19,0.01,7,0.5,2,2,5,2,4,2,0
1,0,0,1,1,1,2,9.05,2,36.19,0.01,7,0.5,2,2,5,2,4,2,0
1,0,0,1,1,1,2,9.05,2,36.19,0.01,7,0.5,2,2,5,2,4,2,0
1,0,0,1,1,1,2,9.05,2,36.19,0.01,7,0.5,2,2,5,2,4,2,0
1,0,0,1,1,1,2,9.05,2,36.19,0.01,7,0.5,2,2,5,2,4,2,0
1,0,0,1,1,1,2,9.05,2,36.19,0.01,7,0.5,2,2,5,2,4,2,0
1,0,0,1,1,1,2,9.05,2,36.19,0.01,7,0.5,2,2,5,2,4,2,0
1,0,0,1,1,1,2,9.05,2,36.19,0.01,7,0.5,2,2,5,2,4,2,0
1,0,0,1,1,1,2,10.44,3.5,127.89,0.01,11,0.29,7.11,3,8,3,7,2,0
1,0,0,1,1,1,2,10.44,3.5,127.89,0.01,11,0.29,7.11,3,8,3,7,2,0
1,0,0,1,1,1,2,9.05,2,36.19,0.01,7,0.5,2,2,5,2,4,2,0
1,0,0,1,1,1,0,0,0,0,0,1,0,0,0,1,0,1,0,0
13,13,7,7,3,1,47,76.35,23.76,43102.16,0.6,298,0.04,2394.56,132,166,50,18,60,1
1,0,0,1,1,1,2,5.33,1.5,12,0,4,0.67,0.67,1,3,1,3,2,0
17,2,8,9,2,8,32,36.47,15.75,9048.06,0.19,112,0.06,502.67,42,70,20,15,34,0
3,0,0,2,1,1,6,11.86,4.38,227.03,0.02,15,0.23,12.61,5,10,4,7,6,0
3,2,0,2,1,1,6,14.43,5.14,381.76,0.02,19,0.19,21.21,9,10,7,8,8,0
5,1,0,3,1,1,10,12.67,10,1267.11,0.04,31,0.1,70.4,14,17,7,10,11,0
3,1,0,2,1,1,6,11.71,4.9,281.06,0.02,16,0.2,15.61,7,9,5,7,7,0
3,1,0,2,1,1,6,11.71,4.9,281.06,0.02,16,0.2,15.61,7,9,5,7,7,0
1,0,0,1,1,1,2,5.33,1.5,12,0,4,0.67,0.67,1,3,1,3,2,0
1,0,0,1,1,1,2,5.33,1.5,12,0,4,0.67,0.67,1,3,1,3,2,0
3,1,0,2,1,1,6,11.23,5.6,352.28,0.02,17,0.18,19.57,7,10,5,8,7,0
7,1,1,4,1,3,13,18.91,10.45,2065.48,0.07,45,0.1,114.75,19,26,10,11,14,0
5,1,0,3,1,1,10,13.33,9,1080,0.04,30,0.11,60,14,16,7,9,11,0
3,1,0,2,1,1,6,11.71,4.9,281.06,0.02,16,0.2,15.61,7,9,5,7,7,0
7,1,1,4,1,3,13,18.91,10.45,2065.48,0.07,45,0.1,114.75,19,26,10,11,14,0
3,1,0,2,1,1,6,11.71,4.9,281.06,0.02,16,0.2,15.61,7,9,5,7,7,0
3,0,0,2,1,1,6,11.86,4.38,227.03,0.02,15,0.23,12.61,5,10,4,7,6,0
3,2,0,2,1,1,7,16.73,5.5,506,0.03,23,0.18,28.11,11,12,8,8,9,0
1,0,0,1,1,1,2,5.33,1.5,12,0,4,0.67,0.67,1,3,1,3,2,0
9,6,0,5,1,1,14,23.12,11.15,2875.94,0.09,57,0.09,159.77,29,28,13,10,20,0
3,1,0,2,1,1,7,14.43,5.14,381.76,0.02,19,0.19,21.21,9,10,7,8,8,0
7,1,1,4,1,3,13,19.62,10,1962.15,0.07,44,0.1,109.01,20,24,11,11,14,0
1,0,0,1,1,1,2,5.33,1.5,12,0,4,0.67,0.67,1,3,1,3,2,0
1,0,0,1,1,1,2,5.33,1.5,12,0,4,0.67,0.67,1,3,1,3,2,0
1,0,0,1,1,1,2,5.33,1.5,12,0,4,0.67,0.67,1,3,1,3,2,0
1,0,0,1,1,1,2,5.33,1.5,12,0,4,0.67,0.67,1,3,1,3,2,0
1,0,0,1,1,1,2,5.33,1.5,12,0,4,0.67,0.67,1,3,1,3,2,0
1,0,0,1,1,1,2,5.33,1.5,12,0,4,0.67,0.67,1,3,1,3,2,0
1,0,0,1,1,1,2,5.33,1.5,12,0,4,0.67,0.67,1,3,1,3,2,0
5,3,18,3,2,1,76,96.3,34,111321.75,1.09,536,0.03,6184.54,208,328,52,17,79,1
109,48,107,55,11,27,273,137.85,81.44,914339.73,3.74,1568,0.01,50796.65,669,899,115,28,321,1
37,21,18,19,1,6,48,53.41,27.11,39254.49,0.48,254,0.04,2180.81,122,132,36,16,69,1
3,1,0,2,1,1,5,10.95,6,394.38,0.02,19,0.17,21.91,10,9,5,6,6,0
3,1,0,2,1,1,5,10.95,6,394.38,0.02,19,0.17,21.91,10,9,5,6,6,0
3,1,0,2,1,1,5,10.95,6,394.38,0.02,19,0.17,21.91,10,9,5,6,6,0
3,1,0,2,1,1,5,10.95,6,394.38,0.02,19,0.17,21.91,10,9,5,6,6,0
7,2,3,4,2,1,14,20.82,13.38,3729.37,0.09,60,0.07,207.19,29,31,13,12,16,0
3,1,1,2,1,1,5,10.95,6,394.38,0.02,19,0.17,21.91,10,9,5,6,6,0
1,0,0,1,1,1,3,13,3,117,0.01,13,0.33,6.5,6,7,4,4,3,0
1,0,0,1,1,1,2,11.07,3,99.66,0.01,10,0.33,5.54,4,6,4,6,2,0
1,0,0,1,1,1,2,7.74,1.5,17.41,0,5,0.67,0.97,2,3,2,3,2,0
3,0,1,2,1,1,8,16.92,4.5,342.66,0.03,20,0.22,19.04,9,11,7,7,8,0
3,1,0,2,1,1,7,16.92,4.5,342.66,0.03,20,0.22,19.04,9,11,7,7,8,0
1,0,0,1,1,1,2,11.41,2.5,71.32,0.01,9,0.4,3.96,4,5,4,5,2,0
3,1,0,2,1,1,5,10.95,6,394.38,0.02,19,0.17,21.91,10,9,5,6,6,0
1,0,0,1,1,1,4,16.51,4.8,380.39,0.03,25,0.21,21.13,12,13,5,4,4,0
1,0,0,1,1,1,2,7.74,1.5,17.41,0,5,0.67,0.97,2,3,2,3,2,0
3,1,0,2,1,1,5,10.95,6,394.38,0.02,19,0.17,21.91,10,9,5,6,6,0
3,1,0,2,1,1,5,10.95,6,394.38,0.02,19,0.17,21.91,10,9,5,6,6,0
1,0,0,1,1,1,2,9.83,2,39.3,0.01,7,0.5,2.18,3,4,3,4,2,0
26,7,18,15,1,1,89,84.34,26.33,58449.54,0.74,342,0.04,3247.2,173,169,69,21,96,0
24,5,20,13,13,3,76,64.2,30.43,59441.48,0.65,309,0.03,3302.3,142,167,56,24,81,0
23,5,22,12,9,3,66,60.24,18.64,20938.3,0.37,199,0.05,1163.24,87,112,35,15,71,0
15,4,8,8,2,8,30,32.25,11.37,4167.41,0.12,78,0.09,231.52,31,47,15,11,34,0
31,4,42,16,15,8,109,64.09,47.05,141868.38,1.01,477,0.02,7881.58,207,270,55,25,113,1
99,39,54,56,46,23,386,96.04,91.93,811661.81,2.94,1215,0.01,45092.32,524,691,114,40,425,1
41,5,26,1,1,1,122,100.63,22.88,52701.3,0.77,381,0.04,2927.85,170,211,52,14,127,1
252,80,179,133,119,22,969,297.26,101.19,3043469.75,10.03,3490,0.01,169081.64,1565,1925,348,45,1049,1
1,0,0,1,1,1,2,7.86,2.5,49.13,0.01,7,0.4,2.73,2,5,2,5,2,0
1,0,0,1,1,1,2,7.49,3,67.38,0.01,8,0.33,3.74,1,7,1,6,2,0
1,0,0,1,1,1,2,7.49,3,67.38,0.01,8,0.33,3.74,1,7,1,6,2,0
1,0,0,1,1,1,2,7.49,3,67.38,0.01,8,0.33,3.74,1,7,1,6,2,0
1,0,0,1,1,1,2,7.49,3,67.38,0.01,8,0.33,3.74,1,7,1,6,2,0
1,0,0,1,1,1,2,7.49,3,67.38,0.01,8,0.33,3.74,1,7,1,6,2,0
1,0,0,1,1,1,2,7.49,3,67.38,0.01,8,0.33,3.74,1,7,1,6,2,0
1,0,0,1,1,1,2,7.49,3,67.38,0.01,8,0.33,3.74,1,7,1,6,2,0
1,0,0,1,1,1,2,10.57,3,95.1,0.01,10,0.33,5.28,3,7,3,6,2,0
1,0,0,1,1,1,0,0,0,0,0,1,0,0,0,1,0,1,0,0
1,0,0,1,1,1,2,5.33,1.5,12,0,4,0.67,0.67,1,3,1,3,2,0
1,0,0,1,1,1,2,5.33,1.5,12,0,4,0.67,0.67,1,3,1,3,2,0
1,0,0,1,1,1,2,5.33,1.5,12,0,4,0.67,0.67,1,3,1,3,2,0
1,0,0,1,1,1,2,5.33,1.5,12,0,4,0.67,0.67,1,3,1,3,2,0
1,0,0,1,1,1,2,5.33,1.5,12,0,4,0.67,0.67,1,3,1,3,2,0
1,0,0,1,1,1,2,5.33,1.5,12,0,4,0.67,0.67,1,3,1,3,2,0
1,0,0,1,1,1,2,5.33,1.5,12,0,4,0.67,0.67,1,3,1,3,2,0
1,0,0,1,1,1,2,13.95,2.5,87.17,0.01,11,0.4,4.84,4,7,4,5,2,0
3,0,1,2,2,1,13,51.53,6.92,2469.63,0.12,69,0.14,137.2,36,33,26,10,13,1
53,9,14,27,27,11,127,121.76,24.32,72041.28,0.99,454,0.04,4002.29,200,254,74,18,136,0
27,14,15,14,7,8,67,35.09,38.15,51071.11,0.45,236,0.03,2837.28,109,127,30,21,81,0
3,0,2,1,1,1,9,33.89,4.85,795.9,0.05,38,0.21,44.22,18,20,13,7,9,1
39,7,18,20,15,18,102,77.64,27.59,59110.55,0.71,345,0.04,3283.92,149,196,54,20,109,1
37,8,43,19,18,7,111,63.03,46.12,134073.67,0.97,456,0.02,7448.54,214,242,58,25,119,0
54,20,36,32,29,6,284,79.88,79.43,503991.97,2.12,905,0.01,27999.55,395,510,92,37,304,1
9,1,4,5,4,1,41,70.43,16,18029.44,0.38,190,0.06,1001.64,90,100,45,16,42,0
19,8,15,1,1,1,62,59.96,20.52,25237.81,0.41,224,0.05,1402.1,101,123,32,13,70,0
7,0,0,4,2,3,19,13.26,19,4788.17,0.08,53,0.05,266.01,19,34,9,18,19,0
35,0,23,18,16,1,113,68.57,52.29,187492.59,1.2,589,0.02,10416.25,251,338,48,20,113,0
3,0,0,2,2,1,12,12.88,11.43,1681.7,0.05,36,0.09,93.43,16,20,7,10,12,0
7,3,5,4,4,1,38,56.4,9.9,5533.47,0.19,115,0.1,307.42,52,63,21,8,41,1
1,0,0,1,1,1,5,12.69,8.1,832.67,0.03,27,0.12,46.26,9,18,5,9,5,0
25,0,10,13,12,9,85,71.32,33.52,80130.7,0.8,385,0.03,4451.71,181,204,54,20,85,0
15,5,15,8,8,1,52,62,20.97,27269.86,0.43,227,0.05,1514.99,97,130,37,16,57,1
1,0,0,1,1,1,1,0,0,0,0,1,0,0,0,1,0,1,1,0
1,0,0,1,1,1,1,0,0,0,0,1,0,0,0,1,0,1,1,0
1,0,0,1,1,1,2,5.33,1.5,12,0,4,0.67,0.67,1,3,1,3,2,0
1,0,0,1,1,1,2,5.33,1.5,12,0,4,0.67,0.67,1,3,1,3,2,0
1,0,0,1,1,1,2,5.33,1.5,12,0,4,0.67,0.67,1,3,1,3,2,0
1,0,0,1,1,1,2,5.33,1.5,12,0,4,0.67,0.67,1,3,1,3,2,0
1,0,0,1,1,1,4,39.26,3.2,402.06,0.04,33,0.31,22.34,16,17,10,4,4,0
1,0,0,1,1,1,3,16.84,1.5,37.9,0.01,9,0.67,2.11,4,5,4,3,3,0
1,0,0,1,1,1,2,7.74,1.5,17.41,0,5,0.67,0.97,2,3,2,3,2,0
1,0,0,1,1,1,2,7.74,1.5,17.41,0,5,0.67,0.97,2,3,2,3,2,0
1,0,0,1,1,1,9,21.23,0.88,16.25,0.01,8,1.14,0.9,7,1,4,1,9,0
1,0,3,1,1,1,3,21.45,4.95,525.68,0.04,25,0.2,29.2,11,14,10,9,3,0
1,0,0,1,1,1,0,0,0,0,0,1,0,0,0,1,0,1,0,0
5,0,0,3,1,1,2,13.29,4.5,269.08,0.02,18,0.22,14.95,6,12,4,6,2,0
1,0,1,1,1,1,2,16.92,3.5,207.22,0.02,16,0.29,11.51,6,10,6,7,2,0
1,0,0,1,1,1,2,0,0,0,0,5,0,0,0,5,0,5,2,0
1,0,0,1,1,1,0,0,0,0,0,5,0,0,0,5,0,5,0,0
1,0,0,1,1,1,0,0,0,0,0,5,0,0,0,5,0,5,0,0
1,0,0,1,1,1,0,0,0,0,0,1,0,0,0,1,0,1,0,0
1,0,0,1,1,1,2,0,0,0,0.01,6,0,0,0,6,0,6,2,0
1,0,0,1,1,1,2,0,0,0,0.01,6,0,0,0,6,0,6,2,0
1,0,0,1,1,1,2,0,0,0,0.01,6,0,0,0,6,0,6,2,0
1,0,0,1,1,1,0,0,0,0,0,1,0,0,0,1,0,1,0,0
3,1,0,2,1,1,6,11.71,4.9,281.06,0.02,16,0.2,15.61,7,9,5,7,7,0
3,1,0,2,1,1,6,11.71,4.9,281.06,0.02,16,0.2,15.61,7,9,5,7,7,0
3,1,0,2,1,1,6,11.71,4.9,281.06,0.02,16,0.2,15.61,7,9,5,7,7,0
1,0,0,1,1,1,0,0,0,0,0,1,0,0,0,1,0,1,0,0
1,0,0,1,1,1,2,5.33,1.5,12,0,4,0.67,0.67,1,3,1,3,2,0
1,0,0,1,1,1,2,7.86,2.5,49.13,0.01,7,0.4,2.73,2,5,2,5,2,0
1,0,0,1,1,1,2,6.97,2,27.86,0,6,0.5,1.55,1,5,1,4,2,0
1,0,0,1,1,1,2,9,3,81,0.01,9,0.33,4.5,2,7,2,6,2,0
1,0,0,1,1,1,2,9,3,81,0.01,9,0.33,4.5,2,7,2,6,2,0
1,0,0,1,1,1,2,5.33,1.5,12,0,4,0.67,0.67,1,3,1,3,2,0
1,0,0,1,1,1,2,10.44,3.5,127.89,0.01,11,0.29,7.11,3,8,3,7,2,0
1,0,0,1,1,1,2,6.97,2,27.86,0,6,0.5,1.55,1,5,1,4,2,0
1,0,0,1,1,1,2,6.97,2,27.86,0,6,0.5,1.55,1,5,1,4,2,0
1,0,0,1,1,1,0,0,0,0,0,1,0,0,0,1,0,1,0,0
1,0,0,1,1,1,2,5.33,1.5,12,0,4,0.67,0.67,1,3,1,3,2,0
1,0,0,1,1,1,2,10.44,3.5,127.89,0.01,11,0.29,7.11,3,8,3,7,2,0
1,0,0,1,1,1,2,7.49,3,67.38,0.01,8,0.33,3.74,1,7,1,6,2,0
1,0,0,1,1,1,2,9,3,81,0.01,9,0.33,4.5,2,7,2,6,2,0
1,0,0,1,1,1,2,9,3,81,0.01,9,0.33,4.5,2,7,2,6,2,0
1,0,0,1,1,1,2,9,3,81,0.01,9,0.33,4.5,2,7,2,6,2,0
1,0,0,1,1,1,2,10.44,3.5,127.89,0.01,11,0.29,7.11,3,8,3,7,2,0
1,0,0,1,1,1,2,9,3,81,0.01,9,0.33,4.5,2,7,2,6,2,0
1,0,0,1,1,1,2,9,3,81,0.01,9,0.33,4.5,2,7,2,6,2,0
1,0,0,1,1,1,2,7.49,3,67.38,0.01,8,0.33,3.74,1,7,1,6,2,0
1,0,0,1,1,1,2,7.49,3,67.38,0.01,8,0.33,3.74,1,7,1,6,2,0
1,0,0,1,1,1,2,10,3,90,0.01,10,0.33,5,2,8,2,6,2,0
1,0,0,1,1,1,3,10.44,3.5,127.89,0.01,11,0.29,7.11,3,8,3,7,3,0
1,0,0,1,1,1,3,11.39,3.5,139.52,0.01,12,0.29,7.75,3,9,3,7,3,0
1,0,0,1,1,1,2,9,3,81,0.01,9,0.33,4.5,2,7,2,6,2,0
1,0,0,1,1,1,2,10.44,3.5,127.89,0.01,11,0.29,7.11,3,8,3,7,2,0
1,0,0,1,1,1,2,9,3,81,0.01,9,0.33,4.5,2,7,2,6,2,0
1,0,0,1,1,1,2,9,3,81,0.01,9,0.33,4.5,2,7,2,6,2,0
1,0,0,1,1,1,2,10.44,3.5,127.89,0.01,11,0.29,7.11,3,8,3,7,2,0
1,0,0,1,1,1,2,9,3,81,0.01,9,0.33,4.5,2,7,2,6,2,0
1,0,0,1,1,1,2,9,3,81,0.01,9,0.33,4.5,2,7,2,6,2,0
1,0,0,1,1,1,2,9,3,81,0.01,9,0.33,4.5,2,7,2,6,2,0
1,0,0,1,1,1,2,7.49,3,67.38,0.01,8,0.33,3.74,1,7,1,6,2,0
1,0,0,1,1,1,2,9,3,81,0.01,9,0.33,4.5,2,7,2,6,2,0
1,0,0,1,1,1,2,9,3,81,0.01,9,0.33,4.5,2,7,2,6,2,0
1,0,0,1,1,1,2,10.44,3.5,127.89,0.01,11,0.29,7.11,3,8,3,7,2,0
1,0,0,1,1,1,2,9.05,2,36.19,0.01,7,0.5,2,2,5,2,4,2,0
1,0,0,1,1,1,2,9.05,2,36.19,0.01,7,0.5,2,2,5,2,4,2,0
1,0,0,1,1,1,2,9.05,2,36.19,0.01,7,0.5,2,2,5,2,4,2,0
1,0,0,1,1,1,2,9.05,2,36.19,0.01,7,0.5,2,2,5,2,4,2,0
1,0,0,1,1,1,2,9.05,2,36.19,0.01,7,0.5,2,2,5,2,4,2,0
1,0,0,1,1,1,2,9.05,2,36.19,0.01,7,0.5,2,2,5,2,4,2,0
1,0,0,1,1,1,2,9.05,2,36.19,0.01,7,0.5,2,2,5,2,4,2,0
1,0,0,1,1,1,2,9.05,2,36.19,0.01,7,0.5,2,2,5,2,4,2,0
1,0,0,1,1,1,2,9.05,2,36.19,0.01,7,0.5,2,2,5,2,4,2,0
1,0,0,1,1,1,2,9.05,2,36.19,0.01,7,0.5,2,2,5,2,4,2,0
1,0,0,1,1,1,2,9.05,2,36.19,0.01,7,0.5,2,2,5,2,4,2,0
1,0,0,1,1,1,2,9.05,2,36.19,0.01,7,0.5,2,2,5,2,4,2,0
1,0,0,1,1,1,2,9.05,2,36.19,0.01,7,0.5,2,2,5,2,4,2,0
1,0,0,1,1,1,2,10.44,3.5,127.89,0.01,11,0.29,7.11,3,8,3,7,2,0
1,0,0,1,1,1,2,10.44,3.5,127.89,0.01,11,0.29,7.11,3,8,3,7,2,0
1,0,0,1,1,1,2,9.05,2,36.19,0.01,7,0.5,2,2,5,2,4,2,0
1,0,0,1,1,1,0,0,0,0,0,1,0,0,0,1,0,1,0,0
1,0,0,1,1,1,2,5.33,1.5,12,0,4,0.67,0.67,1,3,1,3,2,0
3,0,0,2,1,1,6,11.86,4.38,227.03,0.02,15,0.23,12.61,5,10,4,7,6,0
3,2,0,2,1,1,6,14.43,5.14,381.76,0.02,19,0.19,21.21,9,10,7,8,8,0
5,1,0,3,1,1,10,12.67,10,1267.11,0.04,31,0.1,70.4,14,17,7,10,11,0
3,1,0,2,1,1,6,11.71,4.9,281.06,0.02,16,0.2,15.61,7,9,5,7,7,0
3,1,0,2,1,1,6,11.71,4.9,281.06,0.02,16,0.2,15.61,7,9,5,7,7,0
1,0,0,1,1,1,2,5.33,1.5,12,0,4,0.67,0.67,1,3,1,3,2,0
1,0,0,1,1,1,2,5.33,1.5,12,0,4,0.67,0.67,1,3,1,3,2,0
3,1,0,2,1,1,6,11.23,5.6,352.28,0.02,17,0.18,19.57,7,10,5,8,7,0
7,1,1,4,1,3,13,18.91,10.45,2065.48,0.07,45,0.1,114.75,19,26,10,11,14,0
5,1,0,3,1,1,10,13.33,9,1080,0.04,30,0.11,60,14,16,7,9,11,0
3,1,0,2,1,1,6,11.71,4.9,281.06,0.02,16,0.2,15.61,7,9,5,7,7,0
7,1,1,4,1,3,13,18.91,10.45,2065.48,0.07,45,0.1,114.75,19,26,10,11,14,0
3,1,0,2,1,1,6,11.71,4.9,281.06,0.02,16,0.2,15.61,7,9,5,7,7,0
3,0,0,2,1,1,6,11.86,4.38,227.03,0.02,15,0.23,12.61,5,10,4,7,6,0
3,2,0,2,1,1,7,16.73,5.5,506,0.03,23,0.18,28.11,11,12,8,8,9,0
1,0,0,1,1,1,2,5.33,1.5,12,0,4,0.67,0.67,1,3,1,3,2,0
9,6,0,5,1,1,14,23.12,11.15,2875.94,0.09,57,0.09,159.77,29,28,13,10,20,0
3,1,0,2,1,1,7,14.43,5.14,381.76,0.02,19,0.19,21.21,9,10,7,8,8,0
7,1,1,4,1,3,13,19.62,10,1962.15,0.07,44,0.1,109.01,20,24,11,11,14,0
1,0,0,1,1,1,2,5.33,1.5,12,0,4,0.67,0.67,1,3,1,3,2,0
1,0,0,1,1,1,2,5.33,1.5,12,0,4,0.67,0.67,1,3,1,3,2,0
1,0,0,1,1,1,2,5.33,1.5,12,0,4,0.67,0.67,1,3,1,3,2,0
1,0,0,1,1,1,2,5.33,1.5,12,0,4,0.67,0.67,1,3,1,3,2,0
1,0,0,1,1,1,2,5.33,1.5,12,0,4,0.67,0.67,1,3,1,3,2,0
1,0,0,1,1,1,2,5.33,1.5,12,0,4,0.67,0.67,1,3,1,3,2,0
1,0,0,1,1,1,2,5.33,1.5,12,0,4,0.67,0.67,1,3,1,3,2,0
3,1,0,2,1,1,5,10.95,6,394.38,0.02,19,0.17,21.91,10,9,5,6,6,0
3,1,0,2,1,1,5,10.95,6,394.38,0.02,19,0.17,21.91,10,9,5,6,6,0
3,1,0,2,1,1,5,10.95,6,394.38,0.02,19,0.17,21.91,10,9,5,6,6,0
3,1,0,2,1,1,5,10.95,6,394.38,0.02,19,0.17,21.91,10,9,5,6,6,0
3,1,1,2,1,1,5,10.95,6,394.38,0.02,19,0.17,21.91,10,9,5,6,6,0
1,0,0,1,1,1,3,13,3,117,0.01,13,0.33,6.5,6,7,4,4,3,0
1,0,0,1,1,1,2,11.07,3,99.66,0.01,10,0.33,5.54,4,6,4,6,2,0
1,0,0,1,1,1,2,7.74,1.5,17.41,0,5,0.67,0.97,2,3,2,3,2,0
3,0,1,2,1,1,8,16.92,4.5,342.66,0.03,20,0.22,19.04,9,11,7,7,8,0
3,1,0,2,1,1,7,16.92,4.5,342.66,0.03,20,0.22,19.04,9,11,7,7,8,0
1,0,0,1,1,1,2,11.41,2.5,71.32,0.01,9,0.4,3.96,4,5,4,5,2,0
3,1,0,2,1,1,5,10.95,6,394.38,0.02,19,0.17,21.91,10,9,5,6,6,0
1,0,0,1,1,1,4,16.51,4.8,380.39,0.03,25,0.21,21.13,12,13,5,4,4,0
1,0,0,1,1,1,2,7.74,1.5,17.41,0,5,0.67,0.97,2,3,2,3,2,0
3,1,0,2,1,1,5,10.95,6,394.38,0.02,19,0.17,21.91,10,9,5,6,6,0
3,1,0,2,1,1,5,10.95,6,394.38,0.02,19,0.17,21.91,10,9,5,6,6,0
1,0,0,1,1,1,2,9.83,2,39.3,0.01,7,0.5,2.18,3,4,3,4,2,0
3,0,0,2,2,1,13,14.02,7.33,753.86,0.03,27,0.14,41.88,11,16,6,8,13,0
1,0,0,1,1,1,2,6.97,2,27.86,0,6,0.5,1.55,1,5,1,4,2,0
1,0,0,1,1,1,2,6.97,2,27.86,0,6,0.5,1.55,1,5,1,4,2,0
1,0,0,1,1,1,2,5.33,1.5,12,0,4,0.67,0.67,1,3,1,3,2,0
1,0,0,1,1,1,2,6.97,2,27.86,0,6,0.5,1.55,1,5,1,4,2,0
3,0,0,2,2,1,8,27.03,5.09,700.55,0.05,33,0.2,38.92,16,17,11,7,8,0
1,0,0,1,1,1,2,6.97,2,27.86,0,6,0.5,1.55,1,5,1,4,2,0
1,0,0,1,1,1,2,6.97,2,27.86,0,6,0.5,1.55,1,5,1,4,2,0
1,0,0,1,1,1,3,10.8,2.5,67.5,0.01,9,0.4,3.75,3,6,3,5,3,0
1,0,0,1,1,1,3,10.8,2.5,67.5,0.01,9,0.4,3.75,3,6,3,5,3,0
1,0,0,1,1,1,3,10.8,2.5,67.5,0.01,9,0.4,3.75,3,6,3,5,3,0
3,0,0,1,1,1,8,27.85,5.09,721.78,0.05,34,0.2,40.1,16,18,11,7,8,0
1,0,0,1,1,1,0,0,0,0,0,1,0,0,0,1,0,1,0,0
11,8,2,6,6,1,44,61.3,21.53,28424,0.44,220,0.05,1579.11,102,118,45,19,52,0
5,0,1,1,1,1,16,43.24,7.22,2253.16,0.1,69,0.14,125.18,33,36,16,7,16,0
1,2,0,1,1,1,1,4.14,5,103.4,0.01,8,0.2,5.74,2,6,1,5,3,0
1,0,0,1,1,1,3,16.84,1.5,37.9,0.01,9,0.67,2.11,4,5,4,3,3,0
1,0,0,1,1,1,2,5.33,1.5,12,0,4,0.67,0.67,1,3,1,3,2,0
11,3,2,6,3,6,24,19.24,26.13,13132.25,0.17,98,0.04,729.57,44,54,16,19,27,0
1,0,0,1,1,1,2,5.33,1.5,12,0,4,0.67,0.67,1,3,1,3,2,0
1,0,0,1,1,1,2,5.33,1.5,12,0,4,0.67,0.67,1,3,1,3,2,0
1,0,0,1,1,1,2,5.33,1.5,12,0,4,0.67,0.67,1,3,1,3,2,0
1,0,1,1,1,1,2,5.33,1.5,12,0,4,0.67,0.67,1,3,1,3,2,0
1,0,0,1,1,1,2,5.33,1.5,12,0,4,0.67,0.67,1,3,1,3,2,0
1,0,0,1,1,1,2,5.33,1.5,12,0,4,0.67,0.67,1,3,1,3,2,0
1,0,0,1,1,1,2,5.33,1.5,12,0,4,0.67,0.67,1,3,1,3,2,0
5,0,0,4,2,1,19,25.15,10.15,2593.42,0.09,55,0.1,144.08,22,33,13,12,19,0
7,9,0,4,2,1,24,37.85,14.77,8259.3,0.19,109,0.07,458.85,50,59,22,13,33,0
15,3,2,8,6,1,43,35.03,27.5,26492.79,0.32,169,0.04,1471.82,75,94,30,22,46,0
8,0,0,5,2,1,27,25.15,13.59,4646.88,0.11,69,0.07,258.16,29,40,16,15,27,0
15,5,5,9,7,1,64,72.51,21.67,34038.15,0.52,253,0.05,1891.01,117,136,54,20,69,0
21,1,4,11,7,1,62,81.25,15.53,19594.18,0.42,208,0.06,1088.57,99,109,51,16,63,0
59,6,9,32,17,16,169,62.44,58,210060.3,1.21,550,0.02,11670.02,232,318,64,32,175,0
15,0,3,1,1,1,40,58.7,12.56,9258.55,0.25,132,0.08,514.36,61,71,34,14,40,0
15,8,2,8,7,1,44,56.98,20.85,24780.28,0.4,202,0.05,1376.68,95,107,41,18,52,0
3,0,0,2,2,1,9,39.96,5.13,1053.02,0.07,46,0.19,58.5,22,24,15,7,9,0
3,0,0,1,1,1,8,33.71,5.38,977.42,0.06,42,0.19,54.3,20,22,13,7,8,0
3,0,0,2,1,1,7,16.55,5.14,437.71,0.03,23,0.19,24.32,12,11,7,6,7,0
7,8,2,4,1,1,34,60.95,13.17,10566.73,0.27,147,0.08,587.04,79,68,33,11,42,0
7,7,2,4,2,1,16,30.27,9.58,2777.89,0.1,58,0.1,154.33,28,30,19,13,23,0
15,4,3,1,1,1,53,61.35,18.11,20109.39,0.37,193,0.06,1117.19,86,107,38,16,57,0
41,4,12,21,19,11,115,178.87,22.63,91570.83,1.35,581,0.04,5087.27,269,312,107,18,119,0
3,0,0,2,2,1,13,14.02,7.33,753.86,0.03,27,0.14,41.88,11,16,6,8,13,0
3,0,0,2,2,1,8,27.03,5.09,700.55,0.05,33,0.2,38.92,16,17,11,7,8,0
1,0,0,1,1,1,2,6.97,2,27.86,0,6,0.5,1.55,1,5,1,4,2,0
1,0,0,1,1,1,2,6.97,2,27.86,0,6,0.5,1.55,1,5,1,4,2,0
3,0,0,1,1,1,8,27.85,5.09,721.78,0.05,34,0.2,40.1,16,18,11,7,8,0
1,0,0,1,1,1,0,0,0,0,0,1,0,0,0,1,0,1,0,0
5,0,1,1,1,1,16,43.24,7.22,2253.16,0.1,69,0.14,125.18,33,36,16,7,16,0
1,2,0,1,1,1,1,4.14,5,103.4,0.01,8,0.2,5.74,2,6,1,5,3,0
1,0,0,1,1,1,2,5.33,1.5,12,0,4,0.67,0.67,1,3,1,3,2,0
1,0,0,1,1,1,2,5.33,1.5,12,0,4,0.67,0.67,1,3,1,3,2,0
1,0,0,1,1,1,2,5.33,1.5,12,0,4,0.67,0.67,1,3,1,3,2,0
1,0,0,1,1,1,2,5.33,1.5,12,0,4,0.67,0.67,1,3,1,3,2,0
1,0,1,1,1,1,2,5.33,1.5,12,0,4,0.67,0.67,1,3,1,3,2,0
1,0,0,1,1,1,2,5.33,1.5,12,0,4,0.67,0.67,1,3,1,3,2,0
1,0,0,1,1,1,2,5.33,1.5,12,0,4,0.67,0.67,1,3,1,3,2,0
1,0,0,1,1,1,2,5.33,1.5,12,0,4,0.67,0.67,1,3,1,3,2,0
8,0,0,5,2,1,27,25.15,13.59,4646.88,0.11,69,0.07,258.16,29,40,16,15,27,0
13,1,3,8,7,1,50,45.67,22.07,22252.63,0.34,176,0.05,1236.26,79,97,34,19,51,0
11,0,3,1,1,1,39,68.62,11.66,9324.09,0.27,144,0.09,518.01,68,76,35,12,39,0
3,0,0,1,1,1,8,33.71,5.38,977.42,0.06,42,0.19,54.3,20,22,13,7,8,0
1,0,0,1,1,1,6,7.61,1.25,11.89,0,6,0.8,0.66,5,1,2,1,6,0
1,3,0,1,1,1,7,43.9,3.64,582.53,0.05,37,0.27,32.36,17,20,14,6,10,0
17,3,9,9,8,1,47,113.06,10.77,13115.72,0.41,207,0.09,728.65,94,113,48,11,50,0